WWWWWWWWWWW
WWWWDDDWWWW
WWBBBFBBBWW
WWBBBFBBBWW
WWBBBFBBBWW
WWBBBFBBBWW
WWBBBFBBBWW
WDFBBFBBFDW
WDFFFBFFFDW
WWBBBFBBBWW
WWBBBFBBBWW
WWBBBFBBBWW
WWBBBFBBBWW
WWBBBFBBBWW
WWWWWWWWWWW
WWWWWWWWWWW
