WWWWWWWWWWW
WWWWWWWWWWW
WWFFFFFFFWW
WWFPPPPPFWW
WWFPFFFPFWW
WWFPFFFPFWW
WWFPFFFPFWW
WDFPFFFPFDW
WDFPFFFPFDW
WWFPFFFPFWW
WWFPFFFPFWW
WWFPFFFPFWW
WWFPPPPPFWW
WWFFFFFFFWW
WWWWWWWWWWW
WWWWWWWWWWW
