WWWWWWWWWWW
WWWWDDDWWWW
WWFFFFFFFWW
WWFFFFFFFWW
WWFBFFFBFWW
WWFFFFFFFWW
WWFFFFFFFWW
WDFFFFFFFDW
WDFFFFFFFDW
WWFFFFFFFWW
WWFFFFFFFWW
WWFBFFFBFWW
WWFFFFFFFWW
WWFFFFFFFWW
WWWWWWWWWWW
WWWWWWWWWWW
