WWWWWWWWWWW
WWWWDDDWWWW
WWFFFFFFFWW
WWFBBBBBFWW
WWFBFFFBFWW
WWFBFMFBFWW
WWFBMFFBFWW
WWFBFFFFFWW
WWFBFFFFFWW
WWFBMFFBFWW
WWFBFMFBFWW
WWFBFFFBFWW
WWFBBBBBFWW
WWFFFFFFFWW
WWWWWWWWWWW
WWWWWWWWWWW
