WWWWWWWWWWW
WWWWWWWWWWW
WWFFFFFFMWW
WWFFFBFFFWW
WWFFFFFFFWW
WWFFFFFBFWW
WWFFFFFFFWW
WDFFFFFFFDW
WDFFFFFFFDW
WWFFFFFFFWW
WWFFFFFBFWW
WWFFFFFFFWW
WWFFFBFFFWW
WWFFFFFFMWW
WWWWWWWWWWW
WWWWWWWWWWW
