WWWWWWWWWWW
WWWWDDDWWWW
WWFFFFFFFWW
WWFPPPPPFWW
WWFPFFFPFWW
WWFPFFFPFWW
WWFPFFFPFWW
WWFPFFFPFWW
WWFPFFFPFWW
WWFPFFFPFWW
WWFPFFFPFWW
WWFPFFFPFWW
WWFPPPPPFWW
WWFFFFFFFWW
WWWWDDDWWWW
WWWWWWWWWWW
