WWWWWWWWWWW
WWWWWWWWWWW
WWFFFFFFFWW
WWFBFBFBFWW
WWFBFBFBFWW
WWFBFBFBFWW
WWFBFBFBFWW
WDFBFBFBFWW
WDFBFBFBFWW
WWFBFBFBFWW
WWFBFBFBFWW
WWFBFBFBFWW
WWFBFBFBFWW
WWFFFFFFFWW
WWWWWWWWWWW
WWWWWWWWWWW
