WWWWWWWWWWW
WWWWDDDWWWW
WWFFFFFFFWW
WWFIFIFIFWW
WWFFFFFFFWW
WWFIFIFIFWW
WWFFFFFFFWW
WDFIFIFIFDW
WDFIFIFIFDW
WWFFFFFFFWW
WWFIFIFIFWW
WWFFFFFFFWW
WWFIFIFIFWW
WWFFFFFFFWW
WWWWWWWWWWW
WWWWWWWWWWW
