WWWWWWWWWWW
WWWWWWWWWWW
WWMFFFFFMWW
WWFFFFFFFWW
WWFFFFFFFWW
WWFFFFFFFWW
WWFFFFFFFWW
WDFFFFFFFDW
WDFFFFFFFDW
WWFFFFFFFWW
WWFFFFFFFWW
WWFFFFFFFWW
WWFFFFFFFWW
WWMFFFFFMWW
WWWWDDDWWWW
WWWWWWWWWWW
