WWWWWWWWWWW
WWWWDDDWWWW
WWBBBFFFFWW
WWBBBFFFFWW
WWBBFFFBFWW
WWBBFFFFFWW
WWBFFFFFFWW
WWFFFFFFFWW
WWFFFFFFFWW
WWBFFFFFFWW
WWBBFFFFFWW
WWBBFFFBFWW
WWBBBFFFFWW
WWBBBFFFFWW
WWWWDDDWWWW
WWWWWWWWWWW
