WWWWWWWWWWW
WWWWWWWWWWW
WWFFFFFFFWW
WWFIFFFIFWW
WWFIFFFIFWW
WWFFFFFFFWW
WWFFFFFFFWW
WDFFFIFFFDW
WDFFFIFFFDW
WWFFFFFFFWW
WWFFFFFFFWW
WWFIFFFIFWW
WWFIFFFIFWW
WWFFFFFFFWW
WWWWDDDWWWW
WWWWWWWWWWW
