WWWWWWWWWWW
WWWWDDDWWWW
WWFFFFFFFWW
WWFBFBFBFWW
WWFFFFFFFWW
WWFBFBFBFWW
WWFFFFFFFWW
WWFBFBFBFWW
WWFBFBFBFWW
WWFFFFFFFWW
WWFBFBFBFWW
WWFFFFFFFWW
WWFBFBFBFWW
WWFFFFFFFWW
WWWWWWWWWWW
WWWWWWWWWWW
