WWWWWWWWWWW
WWWWDDDWWWW
WWFFFFFFFWW
WWFFFFFFFWW
WWFFFFFFFWW
WWFFFFFFFWW
WWFFFFFFFWW
WWFFFFFFFWW
WWFFFFFFFWW
WWBFFFFFBWW
WWBFFFFFBWW
WWBBFFFBBWW
WWBBBFBBBWW
WWBBBFBBBWW
WWWWDDDWWWW
WWWWWWWWWWW
