WWWWWWWWWWW
WWWWWWWWWWW
WWFFFFFFFWW
WWFFFFFFFWW
WWFBFFFBFWW
WWFFFFFFFWW
WWFFFFFFFWW
WDFFFFFFFWW
WDFFFFFFFWW
WWFFFFFFFWW
WWFFFFFFFWW
WWFBFFFBFWW
WWFFFFFFFWW
WWFFFFFFFWW
WWWWDDDWWWW
WWWWWWWWWWW
