WWWWWWWWWWW
WWWWWWWWWWW
WWBBBBBBBWW
WWBFFFFFFWW
WWBFBBFFMWW
WWBFBBFFFWW
WWBB--MFFWW
WWB---FFFDW
WWB---FFFDW
WWBB--MFFWW
WWBFBBFFFWW
WWBFBBFFMWW
WWBFFFFFFWW
WWBBBBBBBWW
WWWWWWWWWWW
WWWWWWWWWWW
