WWWWWWWWWWW
WWWWWWWWWWW
WWFFFFFFFWW
WWFFFFFFFWW
WWFFFFFFFWW
WWFFFFFFFWW
WWBBBBBBBWW
WDFFFFFFFWW
WDFFFFFFFWW
WWBBBBBBBWW
WWFFFFFFFWW
WWFFFFFFFWW
WWFFFFFFFWW
WWFFFFFFFWW
WWWWWWWWWWW
WWWWWWWWWWW
