WWWWWWWWWWW
WWWWWWWWWWW
WWFFFFFFFWW
WWFFFBFFFWW
WWFFBFBFFWW
WWFFFFFFFWW
WWFFFFFFFWW
WWFFFFFFFDW
WWFFFFFFFDW
WWFFFFFFFWW
WWFFFFFFFWW
WWFFBFBFFWW
WWFFFBFFFWW
WWFFFFFFFWW
WWWWDDDWWWW
WWWWWWWWWWW
