WWWWWWWWWWW
WWWWDDDWWWW
WWPPPFPPPWW
WWPFFFFFPWW
WWPFPPPFPWW
WWPFPFPFPWW
WWPPPFPPPWW
WDFPFFFPFDW
WDFPFFFPFDW
WWPPPFPPPWW
WWPFPFPFPWW
WWPFPPPFPWW
WWPFFFFFPWW
WWPPPFPPPWW
WWWWDDDWWWW
WWWWWWWWWWW
