WWWWWWWWWWW
WWWWWWWWWWW
WWPPPPPPPWW
WWPPPPPPPWW
WWPPPPPPPWW
WWPPPPPPPWW
WWPPPPPPPWW
WWPPPPPPPDW
WWPPPPPPPDW
WWPPPPPPPWW
WWPPPPPPPWW
WWPPPPPPPWW
WWPPPPPPPWW
WWPPPPPPPWW
WWWWWWWWWWW
WWWWWWWWWWW
