WWWWWWWWWWW
WWWWDDDWWWW
WWFFFFFFFWW
WWFFFFFFFWW
WWFFFFFFFWW
WWFFFFFFFWW
WWFFFFFFFWW
WDFFBBBFFWW
WDFFBBBFFWW
WWFFFFFFFWW
WWFFFFFFFWW
WWFFFFFFFWW
WWFFFFFFFWW
WWFFFFFFFWW
WWWWWWWWWWW
WWWWWWWWWWW
