WWWWWWWWWWW
WWWWDDDWWWW
WWFFFFFFFWW
WWFFFFFFFWW
WWFFBBBFFWW
WWFFBBBFFWW
WWFFFFFFFWW
WWFFFFFFFDW
WWFFFFFFFDW
WWFFFFFFFWW
WWFFBBBFFWW
WWFFBBBFFWW
WWFFFFFFFWW
WWFFFFFFFWW
WWWWDDDWWWW
WWWWWWWWWWW
