WWWWWWWWWWW
WWWWWWWWWWW
WWFFFFFFFWW
WWFFFFFFFWW
WWFFFFFFFWW
WWFFFFFFFWW
WWFFFBFFFWW
WDFFFFFFFWW
WDFFFFFFFWW
WWFFFBFFFWW
WWFFFFFFFWW
WWFFFFFFFWW
WWFFFFFFFWW
WWFFFFFFFWW
WWWWDDDWWWW
WWWWWWWWWWW
