WWWWWWWWWWW
WWWWDDDWWWW
WWFFFFFFFWW
WWPPPPPPPWW
WWPPPFPPPWW
WWFPPFFFFWW
WWFPPFFFFWW
WWFPPFFFFDW
WWFPPFFFFDW
WWFPPFFFFWW
WWFPPFFFFWW
WWFPPPPPPWW
WWFPPPPPPWW
WWFFFFFFFWW
WWWWWWWWWWW
WWWWWWWWWWW
