WWWWWWWWWWW
WWWWWWWWWWW
WWBBBFBBBWW
WWBBBFBBBWW
WWBBBFBBBWW
WWBBBFBBBWW
WWBBBFBBBWW
WDFBBFBBFDW
WDFFFBFFFDW
WWBBBFBBBWW
WWBBBFBBBWW
WWBBBFBBBWW
WWBBBFBBBWW
WWBBBFBBBWW
WWWWDDDWWWW
WWWWWWWWWWW
