----------------------------------------------------------------------------------------------------------------------------------------------------------------------------------------------------------------------------------------------------------------------------------------
----------------------------------------------------------------------------------------------------------------------------------------------------------------------------------------------------------------------------------------------------------------------------------------
----------------------------------------------------------------------------------------------------------------------------------------------------------------------------------------------------------------------------------------------------------------------------------------
-------------------------------------------------------------------------------------------------------------------------------------------------------------------------------------------------------------E--------------------------------------------------------------------------
-------------------------------------------------------------------------------------------------------------------------------------------------------------------------------------------------------------XXX---------------------------------------------------XX-------------------
--------S--------SSSS--------------------S-----XXXX-----SSS-----S------------------------------------------XX-------------------------------SS-------------------------------------------------------------------QQ--------------------------------S--SSSS--X-----------------XX--------
----------------------------------------------------------------------------------------------------------------------------------------------------------------------------------------------------------------------------------------------------------------------------------------
----------------------------------------------------------------------------------------------------------------------------------------------------------------------------------------------------------------------------------------------------------------------------------------
--XX---------------------------XXX---------------------X-----------------------E------------------------------------------------------------------------------------------------------------------------SSSSS-----------------------------------------------XXXXXX--------------------E-
--XXX-------XXX----------XX-------------S---------------SSSS--------------XX--<>-----------------XXXX---------------------------------------SQQQ--------------XXX-----XX---------Q------------------------------QQQQ----------E--XXXX-------------XX-X------------------XXX----------<>-
-------------------------XX----------------------------------------------XXX--[]----------------XXXXXX---------------------------------------------E---------XXX-------------------------------------------------------------<>---------------X--------------------------------------[]-
-------------------------XX-----------------------------------<>--------XXXX--[]---------------XXXXXXX--------------------------------------------<>---------XXX---------------------------X---------------------------------[]------------------------------------------------------[]-
--------------------E-E--X------------------------------------[]-------XXXXX--[]--------------XXXXXXXX------E-------------------------------------[]-------XX-XXX------X-------------------------------------E---------------[]------------------------------------------------E--E--[]-
XXX---XXX----XXXXXXXXXXXXXXX------XXXXX-----------------XXXXXXXXXXXXXXXXXXXXXXXXXXXXXXXXXX--XXXXXXX--XXXXX--XXXXXXXXXXXXXXXXX-XXX--------X--XXXXXXXXXXXXX--XXXX------XX-XXXXXXXXXXXXXXXXXXXXXXXXXXXXXXXXXXXXXXXXXXXXXXX----XXXXXX-------XXX-----------------------XX-------XXXXXXXXXXXXX
