----------------------------------------------------------------------------------------------------------------------------------------------------------------------------------------------------------------------------------------------------------------------------------------
----------------------------------------------------------------------------------------------------------------------------------------------------------------------------------------------------------------------------------------------------------------------------------------
----------------------------------------------------------------------------------------------------------------------------------------------------------------------------------------------------------------------------------------------------------------------------------------
----------------------------------------------------------------------------------------------------------------------------------------------------------------------------------------------------------------------------------------------------------------------------------------
----------------------------------------------------------------------------------------------------------------------------------------------------------------------------------------------------------------------------------------------------------------------------------------
-----------------------------SSS---SSS-------------------------------------S-----------S---SSS--------------SS-----S--------------------------------------------------------------------------------------------------------XXXX-----------------------------S--------------------------
----------------------------------------------------------------------------------------------------------------------------------------------------------------------------------------------------------------------------------------------------------------------------------------
----------------------------------------------------------------------------------------------------------------------------------------------------------------------------------------------------------------------------------------------------------------------------------------
---------------------------------------------------E-----------------------------------E-------------------------------------------------------------------X----------------------------------------------------------------------------------------------------------------------------
-X-----------------------?SS---SS-----------------<>-----------------------------------?S-----------------------------------------------------------------XXX------------X-----------------------QQS-X------------------SSSSSSSS----------------------------------------------X---------
-X--------------------------------------------X---[]------------------------------------------------------------------------------------------------------XXX-------------------------------------------------------------------------------------X------------------------XXXX---------
----------------------------------------------X---[]-----------------------------------------------------------------------------------------------------XXXX-----------------------------------------------------------------------------------X-X------------------------XXXX--------X
XX-----E--------------------------------------X---[]------------------------------------------------------------------------------E--------------------E-XXXXX----------XX-----E---------------------------E-E----------------------------------XXX-----------------------XXXXX-------XX
-X-XXXXXXXXX-XXXXXXXXXXXXXXXXXXXXXXX---XXXXXXXXXXXXXXXXXXXXXXXXX--XXX-XXXXXXXXXXXXXXXXX---XXXXXX----XXX---------XXXXXXXXXXXXXXXXXXXXXXXXXXXXXXXXXXXXXXXXXXXXXXXX-----XXXXXXXXXXXXX---XXXXXXXXXXXXXXX---XXXXXXXXXXXXXXXXXXXXXXXXXXXXXXXXXXXXXXXXXXXXXXXXXXXXXXXXXXXXXXXXXXXXXXXXXXXXXXXXX
