----------------------------------------------------------------------------------------------------------------------------------------------------------------------------------------------------------------------------------------------------------------------------------------
----------------------------------------------------------------------------------------------------------------------------------------------------------------------------------------------------------------------------------------------------------------------------------------
----------------------------------------------------------------------------------------------------------------SSSSSSSSSSSSSSSSSSSSSSSSSSSS--------------------------------------------------------SSSSSSSSSSSSSSSSSSSSSSSSSSSS--------------------------------------------------------
----------------------------------------------------------------------------------------------------------------------------------------------------------------------------------------------------SSSS-SSSSSSS------------------------------------------------------------------------
----------------------------------------------------------------------------------------------------------------------------------------------------------------------------------------------------SSSS--SSSSS-------------------------------------------------------------------------
------------------------------------------------------------------------X-----------------SQQQQQQ--------------S----------------X---------------------------------------------SSSSSSS--------------S-SSS--SSSSS----------------------------XXX-------------------------------------XX---
-------------------------------------------------XXXXX------------------X-------------------------------------------------------X--------------------------------------------------------------------S----------------------------------------------------------------------------------
--------------------------------------------------------------------------------------------------------------------------------XS----------------------------------------------------------------------------S-------------------------------------------------------------------------
------------------------------------------------------------------------XX------------------------------------------------------XXXS-----------------------------------------------------------E--------E-----S------------S------------------------------XX----------------------------
-------------------------------------------XXX-----------E--------------X-------------E--SSS-SQSQ---------------<>------Q---X----X----X-----------------------------------E--SSS-SSS----------<>-------SSSSSSSSS--------E------X-X----------------------------------------XXX-----------
----------------E---------E-----------------------------<>-------X------X------------<>--------------------E----[]--------------XX---XX----------------------------------<>-------------------[]-----SSSSS--SSS--------<>------X-X------------------------------------------------------
---------------<>--------<>-----------------------------[]----------XXXXXX-----------[]-------------------<>-X--[]----------XXXXXX---XX----X-----------------------------[]-------------------[]----SSSSSSS-SSS--------[]------X--------------------------------------------------------
----EE---------[]--------[]-----------------------------[]-E--------XXXXXX-----------[]----------------EE-[]-X--[]----------XXXXXX---XX----X------------------E----------[]---------------EE--[]----SSSSS-SSSSS--------[]----XXX-X------------------------------------------------------
XXXXXXXXX-XXXX-XXX--XXXXXXXX---------X------------------XXXXXXXXXXXXXXXXX--XXXXXXXXXXXXXXXXXXXXXXXXXXXXXXXXXXXXXXXXXXXXXXXXXXXXXXX---XXXXXXXXXXXXXXXX--XXXXXXXXXXXXXXXXXXXXXXXXXXXXXXXXXXXXXXXXXXXXXXXXXXXXXXXXXXXXXXXXXXXXXXXXX------XXXXX---XX--XXXXXXXXXX--------XXXX----------------
