----------------------------------------------------------------------------------------------------------------------------------------------------------------------------------------------------------------------------------------------------------------------------------------
----------------------------------------------------------------------------------------------------------------------------------------------------------------------------------------------------------------------------------------------------------------------------------------
----------------------------------------------------------------------------------------------------------------------------------------------------------------------------------------------------------------------------------------------------------------------------------------
-----------------------------------------------------------------E----------------------------------------------------------------------------------------------------------------------------------------------------------------------------------------------------------------------
-----------------------------------------------------------------XXX--------------------------------------------------------------------------------------------------------------------------------------------------------------------------------------------------------------------
---------------------------------------------------------------------QQ-----------------------QSS--------------S--------------Q---------SSXXXXXXX---------------------------------------------------------------------------------------------------------------------------------------
----------------------------------------------------------------------------------------------------------------------------------------------------------------------------------------------------------------------------------------------------------------------------------------
----------------------------------------------------------------------------------------------------------------------------------------------------------------------------------------------------------------------------------------------------------------------------------------
--------------------------------------------------------------SSS----------------------------------------------------S------------------------------------------------------------------------------------------------------------------------------------------------------------------
-------------------------------------------------------E-------------QQQ--------------E--QQ--SS?----E----------------------QQQQQQ------SS--------------------------------------------XXXX--------------------------------------------------QQ--QQ---------------------------------------
------------------------------------------------------<>-----------------------------<>------------<>--------------------------------------------------------------------------------X------------------------------E---------E---------------------------------------------------------
-------------------------------------------<>---------[]-----------------------------[]--X---------[]---------------------------------------------------X---------------------------XX-----------------------------<>---------E---------------------------------------------------------
-------EE-E--------------------------------[]---------[]---------E-------------------[]------------[]-EE--------------------------E-----------------E---E------------EE------------XXX----------E------------------[]---------E-------------------------------------------------------E-
---XXXXXXXXXXXXXXXXXXXXXXXXXXXXXXXXXX-XXXXXXXXXXXXXXXXXXXXXXXXXXXXXXXXXXXX----------XXXXXXXXXXXXXXXXXXXXXXXXXXXXXXXXXXXXXXXXXXXXXXXXXXXX-XXXXXXXXXXXXXXXXXXX-----XXXXXXXXXXXXX---XXXXX-----XXXXXXXXXXXXXXXXXXXXXXXXXXXXXXXXXXXXXXXXXXXXXXXXXXXXXXXXX-----X-XXXXXXXX---XXXXXX---XXXXXXXXX
