--------------------------------
--------------------------------
--------------------------------
--------------------------------
--------------------------------
--------------------------------
--------------------------------
--------------------------------
--------------------------------
--------------------------------
--------------------------------
--------------------------------
--------------------------------
--------------------------------
--------------------------------
--------------------------------
WWWWWWWWWWW---------------------
WWWWDDDWWWW---------------------
WWBBBFBBBWW---------------------
WWBBBFBBBWW---------------------
WWBBBFBBBWW---------------------
WWBBBFBBBWW---------------------
WWBBBFBBBWW---------------------
WDFBBFBBFWW---------------------
WDFFFBFFFWW---------------------
WWBBBFBBBWW---------------------
WWBBBFBBBWW---------------------
WWBBBFBBBWW---------------------
WWBBBFBBBWW---------------------
WWBBBFBBBWW---------------------
WWWWDDDWWWW---------------------
WWWWWWWWWWW---------------------
