--------------------------------
--------------------------------
--------------------------------
--------------------------------
--------------------------------
--------------------------------
--------------------------------
--------------------------------
--------------------------------
--------------------------------
--------------------------------
--------------------------------
--------------------------------
--------------------------------
--------------------------------
--------------------------------
WWWWWWWWWWW---------------------
WWWWDDDWWWW---------------------
WWFFFFFFFWW---------------------
WWFPPPPPFWW---------------------
WWFPFFFPFWW---------------------
WWFPFPFPFWW---------------------
WWFFFPFFFWW---------------------
WDFFFPFFFDW---------------------
WDFFFPFFFDW---------------------
WWFFFPFFFWW---------------------
WWFPFPFPFWW---------------------
WWFPFFFPFWW---------------------
WWFPPPPPFWW---------------------
WWFFFFFFFWW---------------------
WWWWWWWWWWW---------------------
WWWWWWWWWWW---------------------
