--------------------------------
--------------------------------
--------------------------------
--------------------------------
--------------------------------
--------------------------------
--------------------------------
--------------------------------
--------------------------------
--------------------------------
--------------------------------
--------------------------------
--------------------------------
--------------------------------
--------------------------------
--------------------------------
WWWWWWWWWWW---------------------
WWWWDDDWWWW---------------------
WWFPFFFPFWW---------------------
WWFPFFFPFWW---------------------
WWFPFFFPFWW---------------------
WWFPFFFPFWW---------------------
WWFPFFFPFWW---------------------
WWFPFFFPFWW---------------------
WWFPFFFPFWW---------------------
WWFPFFFPFWW---------------------
WWFPFFFPFWW---------------------
WWFPFFFPFWW---------------------
WWFPFFFPFWW---------------------
WWFPFFFPFWW---------------------
WWWWWWWWWWW---------------------
WWWWWWWWWWW---------------------
