--------------------------------
--------------------------------
--------------------------------
--------------------------------
--------------------------------
--------------------------------
--------------------------------
--------------------------------
--------------------------------
--------------------------------
--------------------------------
--------------------------------
--------------------------------
--------------------------------
--------------------------------
--------------------------------
WWWWWWWWWWW---------------------
WWWWWWWWWWW---------------------
WWFFFFFFFWW---------------------
WWFFFFFFFWW---------------------
WWFFBBBFFWW---------------------
WWFFBBBFFWW---------------------
WWFFFFFFFWW---------------------
WDFFFFFFFDW---------------------
WDFFFFFFFDW---------------------
WWFFFFFFFWW---------------------
WWFFBBBFFWW---------------------
WWFFBBBFFWW---------------------
WWFFFFFFFWW---------------------
WWFFFFFFFWW---------------------
WWWWDDDWWWW---------------------
WWWWWWWWWWW---------------------
