--------------------------------
--------------------------------
--------------------------------
--------------------------------
--------------------------------
--------------------------------
--------------------------------
--------------------------------
--------------------------------
--------------------------------
--------------------------------
--------------------------------
--------------------------------
--------------------------------
--------------------------------
--------------------------------
WWWWWWWWWWW---------------------
WWWWWWWWWWW---------------------
WWFFFFFFIWW---------------------
WWFIFFFIFWW---------------------
WWIFFFIFFWW---------------------
WWFFFIFFFWW---------------------
WWFFIFFFFWW---------------------
WWFIFFFFFWW---------------------
WWFFFFFIFWW---------------------
WWFFFFIFFWW---------------------
WWFFFIFFFWW---------------------
WWFFIFFFIWW---------------------
WWFIFFFIFWW---------------------
WWIFFFFFFWW---------------------
WWWWDDDWWWW---------------------
WWWWWWWWWWW---------------------
