--------------------------------
--------------------------------
--------------------------------
--------------------------------
--------------------------------
--------------------------------
--------------------------------
--------------------------------
--------------------------------
--------------------------------
--------------------------------
--------------------------------
--------------------------------
--------------------------------
--------------------------------
--------------------------------
WWWWWWWWWWW---------------------
WWWWWWWWWWW---------------------
WWM-----MWW---------------------
WW-------WW---------------------
WW-FFFF--WW---------------------
WWFF--F--WW---------------------
WWF---FFFWW---------------------
WDFFFF-FFDW---------------------
WDFFFF-FFDW---------------------
WWF---FFFWW---------------------
WWFF--F--WW---------------------
WW-FFFF--WW---------------------
WW-------WW---------------------
WWM-----MWW---------------------
WWWWWWWWWWW---------------------
WWWWWWWWWWW---------------------
