--------------------------------
--------------------------------
--------------------------------
--------------------------------
--------------------------------
--------------------------------
--------------------------------
--------------------------------
--------------------------------
--------------------------------
--------------------------------
--------------------------------
--------------------------------
--------------------------------
--------------------------------
--------------------------------
WWWWWWWWWWW---------------------
WWWWWWWWWWW---------------------
WWFFFFFFFWW---------------------
WWFMFMFMFWW---------------------
WWFFFFFFFWW---------------------
WWFFFFFOOWW---------------------
WWFMFMFMOWW---------------------
WDFFFFOOODW---------------------
WDFFFFOOODW---------------------
WWFMFMFMOWW---------------------
WWFFFFFOOWW---------------------
WWFFFFFFFWW---------------------
WWFMFMFMFWW---------------------
WWFFFFFFFWW---------------------
WWWWDDDWWWW---------------------
WWWWWWWWWWW---------------------
