--------------------------------
--------------------------------
--------------------------------
--------------------------------
--------------------------------
--------------------------------
--------------------------------
--------------------------------
--------------------------------
--------------------------------
--------------------------------
--------------------------------
--------------------------------
--------------------------------
--------------------------------
--------------------------------
WWWWWWWWWWW---------------------
WWWWWWWWWWW---------------------
WWFFFFFFFWW---------------------
WWFFFFFFFWW---------------------
WWFFFFFFFWW---------------------
WWFFFFFFFWW---------------------
WWFFFFFFFWW---------------------
WWFFFFFFFDW---------------------
WWFFFFFFFDW---------------------
WWFFFFFFFWW---------------------
WWPPPPPPPWW---------------------
WWFFFFFFFWW---------------------
WWFFFFFFFWW---------------------
WWFFFFFFFWW---------------------
WWWWWWWWWWW---------------------
WWWWWWWWWWW---------------------
