--------------------------------
--------------------------------
--------------------------------
--------------------------------
--------------------------------
--------------------------------
--------------------------------
--------------------------------
--------------------------------
--------------------------------
--------------------------------
--------------------------------
--------------------------------
--------------------------------
--------------------------------
--------------------------------
WWWWWWWWWWW---------------------
WWWWDDDWWWW---------------------
WWBBBFFFFWW---------------------
WWBBBFFFFWW---------------------
WWBBFFFBFWW---------------------
WWBBFFFFFWW---------------------
WWBFFFFFFWW---------------------
WDFFFFFFFWW---------------------
WDFFFFFFFWW---------------------
WWBFFFFFFWW---------------------
WWBBFFFFFWW---------------------
WWBBFFFBFWW---------------------
WWBBBFFFFWW---------------------
WWBBBFFFFWW---------------------
WWWWWWWWWWW---------------------
WWWWWWWWWWW---------------------
