--------------------------------
--------------------------------
--------------------------------
--------------------------------
--------------------------------
--------------------------------
--------------------------------
--------------------------------
--------------------------------
--------------------------------
--------------------------------
--------------------------------
--------------------------------
--------------------------------
--------------------------------
--------------------------------
WWWWWWWWWWW---------------------
WWWWDDDWWWW---------------------
WWFFFFFFFWW---------------------
WWFMFMFMFWW---------------------
WWFFFFFFFWW---------------------
WWFFFFFOOWW---------------------
WWFMFMFMOWW---------------------
WWFFFFOOODW---------------------
WWFFFFOOODW---------------------
WWFMFMFMOWW---------------------
WWFFFFFOOWW---------------------
WWFFFFFFFWW---------------------
WWFMFMFMFWW---------------------
WWFFFFFFFWW---------------------
WWWWWWWWWWW---------------------
WWWWWWWWWWW---------------------
