--------------------------------
--------------------------------
--------------------------------
--------------------------------
--------------------------------
--------------------------------
--------------------------------
--------------------------------
--------------------------------
--------------------------------
--------------------------------
--------------------------------
--------------------------------
--------------------------------
--------------------------------
--------------------------------
WWWWWWWWWWW---------------------
WWWWWWWWWWW---------------------
WWFFFFFFFWW---------------------
WWFFFFFFFWW---------------------
WWFFFFFFFWW---------------------
WWFFFFFFFWW---------------------
WWFFFFFFFWW---------------------
WWFFFBFFFWW---------------------
WWFFFFFFFWW---------------------
WWFFFFFFFWW---------------------
WWFFFFFFFWW---------------------
WWFFFFFFFWW---------------------
WWFFFFFFFWW---------------------
WWFFFFFFFWW---------------------
WWWWDDDWWWW---------------------
WWWWWWWWWWW---------------------
