--------------------------------
--------------------------------
--------------------------------
--------------------------------
--------------------------------
--------------------------------
--------------------------------
--------------------------------
--------------------------------
--------------------------------
--------------------------------
--------------------------------
--------------------------------
--------------------------------
--------------------------------
--------------------------------
WWWWWWWWWWW---------------------
WWWWWWWWWWW---------------------
WWFFFFFFFWW---------------------
WWFBFFFBFWW---------------------
WWFBFFFBFWW---------------------
WWFFFFFFFWW---------------------
WWFFFFFFFWW---------------------
WDFFFBFFFDW---------------------
WDFFFBFFFDW---------------------
WWFFFFFFFWW---------------------
WWFFFFFFFWW---------------------
WWFBFFFBFWW---------------------
WWFBFFFBFWW---------------------
WWFFFFFFFWW---------------------
WWWWWWWWWWW---------------------
WWWWWWWWWWW---------------------
