--------------------------------
--------------------------------
--------------------------------
--------------------------------
--------------------------------
--------------------------------
--------------------------------
--------------------------------
--------------------------------
--------------------------------
--------------------------------
--------------------------------
--------------------------------
--------------------------------
--------------------------------
--------------------------------
WWWWWWWWWWW---------------------
WWWWWWWWWWW---------------------
WWFFFFFFBWW---------------------
WWFBFFFBFWW---------------------
WWBFFFBFFWW---------------------
WWFFFBFFFWW---------------------
WWFFBFFFFWW---------------------
WWFBFFFFFDW---------------------
WWFFFFFBFDW---------------------
WWFFFFBFFWW---------------------
WWFFFBFFFWW---------------------
WWFFBFFFBWW---------------------
WWFBFFFBFWW---------------------
WWBFFFFFFWW---------------------
WWWWWWWWWWW---------------------
WWWWWWWWWWW---------------------
