--------------------------------
--------------------------------
--------------------------------
--------------------------------
--------------------------------
--------------------------------
--------------------------------
--------------------------------
--------------------------------
--------------------------------
--------------------------------
--------------------------------
--------------------------------
--------------------------------
--------------------------------
--------------------------------
WWWWWWWWWWW---------------------
WWWWDDDWWWW---------------------
WWFFFFFFFWW---------------------
WWFFFFFFFWW---------------------
WWFFFFFFFWW---------------------
WWFFFFFFFWW---------------------
WWFFFFFFFWW---------------------
WDFFFFFFFDW---------------------
WDFFFFFFFDW---------------------
WWFFFFFFFWW---------------------
WWBBFFFBBWW---------------------
WWBBBFBBBWW---------------------
WWBBBFBBBWW---------------------
WWBBBSBBBWW---------------------
WWWWWWWWWWW---------------------
WWWWWWWWWWW---------------------
