--------------------------------
--------------------------------
--------------------------------
--------------------------------
--------------------------------
--------------------------------
--------------------------------
--------------------------------
--------------------------------
--------------------------------
--------------------------------
--------------------------------
--------------------------------
--------------------------------
--------------------------------
--------------------------------
WWWWWWWWWWW---------------------
WWWWWWWWWWW---------------------
WWFFFFFFFWW---------------------
WWFBBBBBFWW---------------------
WWFBFFFBFWW---------------------
WWFBFMFBFWW---------------------
WWFBMFFBFWW---------------------
WWFBFFFFFDW---------------------
WWFBFFFFFDW---------------------
WWFBMFFBFWW---------------------
WWFBFMFBFWW---------------------
WWFBFFFBFWW---------------------
WWFBBBBBFWW---------------------
WWFFFFFFFWW---------------------
WWWWWWWWWWW---------------------
WWWWWWWWWWW---------------------
