--------------------------------
--------------------------------
--------------------------------
--------------------------------
--------------------------------
--------------------------------
--------------------------------
--------------------------------
--------------------------------
--------------------------------
--------------------------------
--------------------------------
--------------------------------
--------------------------------
--------------------------------
--------------------------------
WWWWWWWWWWW---------------------
WWWWDDDWWWW---------------------
WW-------WW---------------------
WW-------WW---------------------
WW-------WW---------------------
WW-------WW---------------------
WW-------WW---------------------
WD-------WW---------------------
WD-------WW---------------------
WW-------WW---------------------
WW-------WW---------------------
WW-------WW---------------------
WW-------WW---------------------
WW-------WW---------------------
WWWWWWWWWWW---------------------
WWWWWWWWWWW---------------------
