--------------------------------
--------------------------------
--------------------------------
--------------------------------
--------------------------------
--------------------------------
--------------------------------
--------------------------------
--------------------------------
--------------------------------
--------------------------------
--------------------------------
--------------------------------
--------------------------------
--------------------------------
--------------------------------
WWWWWWWWWWW---------------------
WWWWDDDWWWW---------------------
WWFFFFFFFWW---------------------
WWFFFFFFFWW---------------------
WWFFBFBFFWW---------------------
WWFFFFFFFWW---------------------
WWFFFFFFFWW---------------------
WWFFFFFFFWW---------------------
WWFFFFFFFWW---------------------
WWFFFFFFFWW---------------------
WWFFFFFFFWW---------------------
WWFFBFBFFWW---------------------
WWFFFFFFFWW---------------------
WWFFFFFFFWW---------------------
WWWWWWWWWWW---------------------
WWWWWWWWWWW---------------------
