--------------------------------
--------------------------------
--------------------------------
--------------------------------
--------------------------------
--------------------------------
--------------------------------
--------------------------------
--------------------------------
--------------------------------
--------------------------------
--------------------------------
--------------------------------
--------------------------------
--------------------------------
--------------------------------
WWWWWWWWWWW---------------------
WWWWDDDWWWW---------------------
WWFFFFFFFWW---------------------
WWFBBBBBFWW---------------------
WWFBFFFBFWW---------------------
WWFBFFFBFWW---------------------
WWFBFFFBFWW---------------------
WWFBFBFBFWW---------------------
WWFBFBFBFWW---------------------
WWFBSBFBFWW---------------------
WWFBBBFBFWW---------------------
WWFFFFFBFWW---------------------
WWBBBBBBFWW---------------------
WWFFFFFFFWW---------------------
WWWWWWWWWWW---------------------
WWWWWWWWWWW---------------------
