--------------------------------
--------------------------------
--------------------------------
--------------------------------
--------------------------------
--------------------------------
--------------------------------
--------------------------------
--------------------------------
--------------------------------
--------------------------------
--------------------------------
--------------------------------
--------------------------------
--------------------------------
--------------------------------
WWWWWWWWWWW---------------------
WWWWWWWWWWW---------------------
WWFFFFFFFWW---------------------
WWFBFBFBFWW---------------------
WWFFFFFFFWW---------------------
WWFBFBFBFWW---------------------
WWFFFFFFFWW---------------------
WDFBFBFBFWW---------------------
WDFBFBFBFWW---------------------
WWFFFFFFFWW---------------------
WWFBFBFBFWW---------------------
WWFFFFFFFWW---------------------
WWFBFBFBFWW---------------------
WWFFFFFFFWW---------------------
WWWWDDDWWWW---------------------
WWWWWWWWWWW---------------------
