--------------------------------
--------------------------------
--------------------------------
--------------------------------
--------------------------------
--------------------------------
--------------------------------
--------------------------------
--------------------------------
--------------------------------
--------------------------------
--------------------------------
--------------------------------
--------------------------------
--------------------------------
--------------------------------
WWWWWWWWWWW---------------------
WWWWWWWWWWW---------------------
WWOOOOOOOWW---------------------
WWOOOOOOOWW---------------------
WWOOOOOOOWW---------------------
WWOOOOOOOWW---------------------
WWOOOOOOOWW---------------------
WDOOOOOOODW---------------------
WDOOOOOOODW---------------------
WWOOOOOOOWW---------------------
WWOOOOOOOWW---------------------
WWOOOOOOOWW---------------------
WWOOOOOOOWW---------------------
WWOOOOOOOWW---------------------
WWWWDDDWWWW---------------------
WWWWWWWWWWW---------------------
