--------------------------------
--------------------------------
--------------------------------
--------------------------------
--------------------------------
--------------------------------
--------------------------------
--------------------------------
--------------------------------
--------------------------------
--------------------------------
--------------------------------
--------------------------------
--------------------------------
--------------------------------
--------------------------------
WWWWWWWWWWW---------------------
WWWWWWWWWWW---------------------
WW-------WW---------------------
WW-------WW---------------------
WW-------WW---------------------
WW-------WW---------------------
WW-------WW---------------------
WW-------DW---------------------
WW-------DW---------------------
WW-------WW---------------------
WW-------WW---------------------
WW-------WW---------------------
WW-------WW---------------------
WW-------WW---------------------
WWWWWWWWWWW---------------------
WWWWWWWWWWW---------------------
