--------------------------------
--------------------------------
--------------------------------
--------------------------------
--------------------------------
--------------------------------
--------------------------------
--------------------------------
--------------------------------
--------------------------------
--------------------------------
--------------------------------
--------------------------------
--------------------------------
--------------------------------
--------------------------------
WWWWWWWWWWW---------------------
WWWWDDDWWWW---------------------
WWFFFFFFFWW---------------------
WWFFFFFFFWW---------------------
WWFIIIIIFWW---------------------
WWFIFFFIFWW---------------------
WWFIFFFIFWW---------------------
WWFIFFFIFDW---------------------
WWFIFFFIFDW---------------------
WWFIFFFIFWW---------------------
WWFIFFFIFWW---------------------
WWFIIIIIFWW---------------------
WWFFFFFFFWW---------------------
WWFFFFFFFWW---------------------
WWWWDDDWWWW---------------------
WWWWWWWWWWW---------------------
