--------------------------------
--------------------------------
--------------------------------
--------------------------------
--------------------------------
--------------------------------
--------------------------------
--------------------------------
--------------------------------
--------------------------------
--------------------------------
--------------------------------
--------------------------------
--------------------------------
--------------------------------
--------------------------------
WWWWWWWWWWW---------------------
WWWWDDDWWWW---------------------
WWFFFFFFFWW---------------------
WWFBFFFBFWW---------------------
WWFBFFFBFWW---------------------
WWFBFFFBFWW---------------------
WWFBFFFBFWW---------------------
WDFBFFFBFDW---------------------
WDFBFFFBFDW---------------------
WWFBFFFBFWW---------------------
WWFBFFFBFWW---------------------
WWFBFFFBFWW---------------------
WWFBBBBBFWW---------------------
WWFFFFFFFWW---------------------
WWWWDDDWWWW---------------------
WWWWWWWWWWW---------------------
