--------------------------------
--------------------------------
--------------------------------
--------------------------------
--------------------------------
--------------------------------
--------------------------------
--------------------------------
--------------------------------
--------------------------------
--------------------------------
--------------------------------
--------------------------------
--------------------------------
--------------------------------
--------------------------------
WWWWWWWWWWW---------------------
WWWWDDDWWWW---------------------
WWFFPFFFFWW---------------------
WWFFPFFFFWW---------------------
WWFFPFFFFWW---------------------
WWFFPFFFFWW---------------------
WWFFPFFFFWW---------------------
WWFFPFFFFWW---------------------
WWFFPFFFFWW---------------------
WWFFPFFFFWW---------------------
WWFFPFFFFWW---------------------
WWFFPFFFFWW---------------------
WWFFPFFFFWW---------------------
WWFFPFFFFWW---------------------
WWWWDDDWWWW---------------------
WWWWWWWWWWW---------------------
