--------------------------------
--------------------------------
--------------------------------
--------------------------------
--------------------------------
--------------------------------
--------------------------------
--------------------------------
--------------------------------
--------------------------------
--------------------------------
--------------------------------
--------------------------------
--------------------------------
--------------------------------
--------------------------------
WWWWWWWWWWW---------------------
WWWWWWWWWWW---------------------
WWFFFFFFFWW---------------------
WWFPPPPPPWW---------------------
WWFPPPPPPWW---------------------
WWFPPFFPPWW---------------------
WWFPPFFPPWW---------------------
WDFPPFFFFDW---------------------
WDFPPFFFFDW---------------------
WWFPPFFPPWW---------------------
WWFPPFFPPWW---------------------
WWFPPPPPPWW---------------------
WWFPPPPPPWW---------------------
WWFFFFFFFWW---------------------
WWWWDDDWWWW---------------------
WWWWWWWWWWW---------------------
