--------------------------------
--------------------------------
--------------------------------
--------------------------------
--------------------------------
--------------------------------
--------------------------------
--------------------------------
--------------------------------
--------------------------------
--------------------------------
--------------------------------
--------------------------------
--------------------------------
--------------------------------
--------------------------------
WWWWWWWWWWW---------------------
WWWWDDDWWWW---------------------
WWFFFFFFBWW---------------------
WWFBFFFBFWW---------------------
WWBFFFBFFWW---------------------
WWFFFBFFFWW---------------------
WWFFBFFFFWW---------------------
WWFBFFFFFWW---------------------
WWFFFFFBFWW---------------------
WWFFFFBFFWW---------------------
WWFFFBFFFWW---------------------
WWFFBFFFBWW---------------------
WWFBFFFBFWW---------------------
WWBFFFFFFWW---------------------
WWWWDDDWWWW---------------------
WWWWWWWWWWW---------------------
