--------------------------------
--------------------------------
--------------------------------
--------------------------------
--------------------------------
--------------------------------
--------------------------------
--------------------------------
--------------------------------
--------------------------------
--------------------------------
--------------------------------
--------------------------------
--------------------------------
--------------------------------
--------------------------------
WWWWWWWWWWW---------------------
WWWWWWWWWWW---------------------
WWOOOOOOOWW---------------------
WWOOOOOOOWW---------------------
WWOOOOOOOWW---------------------
WWOOOOOOOWW---------------------
WWOOOOOOOWW---------------------
WWOOOOOOOWW---------------------
WWOOOOOOOWW---------------------
WWOOOOOOOWW---------------------
WWOOOOOOOWW---------------------
WWOOOOOOOWW---------------------
WWOOOOOOOWW---------------------
WWOOOOOOOWW---------------------
WWWWWWWWWWW---------------------
WWWWWWWWWWW---------------------
