--------------------------------
--------------------------------
--------------------------------
--------------------------------
--------------------------------
--------------------------------
--------------------------------
--------------------------------
--------------------------------
--------------------------------
--------------------------------
--------------------------------
--------------------------------
--------------------------------
--------------------------------
--------------------------------
WWWWWWWWWWW---------------------
WWWWDDDWWWW---------------------
WWFFFFFFFWW---------------------
WWFFFFFFFWW---------------------
WWFFFFFFFWW---------------------
WWFFFFFFFWW---------------------
WWFFFFFFFWW---------------------
WWFFFBFFFWW---------------------
WWFFFFFFFWW---------------------
WWFFFFFFFWW---------------------
WWFFFFFFFWW---------------------
WWFFFFFFFWW---------------------
WWFFFFFFFWW---------------------
WWFFFFFFFWW---------------------
WWWWWWWWWWW---------------------
WWWWWWWWWWW---------------------
