--------------------------------
--------------------------------
--------------------------------
--------------------------------
--------------------------------
--------------------------------
--------------------------------
--------------------------------
--------------------------------
--------------------------------
--------------------------------
--------------------------------
--------------------------------
--------------------------------
--------------------------------
--------------------------------
WWWWWWWWWWW---------------------
WWWWDDDWWWW---------------------
WW-------WW---------------------
WW-------WW---------------------
WW-------WW---------------------
WW-------WW---------------------
WW-------WW---------------------
WD-------DW---------------------
WD-------DW---------------------
WW-------WW---------------------
WW-------WW---------------------
WW-------WW---------------------
WW-------WW---------------------
WW-------WW---------------------
WWWWWWWWWWW---------------------
WWWWWWWWWWW---------------------
