--------------------------------
--------------------------------
--------------------------------
--------------------------------
--------------------------------
--------------------------------
--------------------------------
--------------------------------
--------------------------------
--------------------------------
--------------------------------
--------------------------------
--------------------------------
--------------------------------
--------------------------------
--------------------------------
WWWWWWWWWWW---------------------
WWWWDDDWWWW---------------------
WWFFBFBFFWW---------------------
WWFFBFBFFWW---------------------
WWFFBFBFFWW---------------------
WWFFBFBFFWW---------------------
WWFFBFBFFWW---------------------
WWFFBFBFFWW---------------------
WWFFBFBFFWW---------------------
WWFFBFBFFWW---------------------
WWFFBFBFFWW---------------------
WWFFBFBFFWW---------------------
WWFFBFBFFWW---------------------
WWFFBFBFFWW---------------------
WWWWDDDWWWW---------------------
WWWWWWWWWWW---------------------
