--------------------------------
--------------------------------
--------------------------------
--------------------------------
--------------------------------
--------------------------------
--------------------------------
--------------------------------
--------------------------------
--------------------------------
--------------------------------
--------------------------------
--------------------------------
--------------------------------
--------------------------------
--------------------------------
WWWWWWWWWWW---------------------
WWWWDDDWWWW---------------------
WWFFFFFFFWW---------------------
WWFBFFFBFWW---------------------
WWFBFFFBFWW---------------------
WWFFFFFFFWW---------------------
WWFFFFFFFWW---------------------
WDFFFBFFFWW---------------------
WDFFFBFFFWW---------------------
WWFFFFFFFWW---------------------
WWFFFFFFFWW---------------------
WWFBFFFBFWW---------------------
WWFBFFFBFWW---------------------
WWFFFFFFFWW---------------------
WWWWWWWWWWW---------------------
WWWWWWWWWWW---------------------
