--------------------------------
--------------------------------
--------------------------------
--------------------------------
--------------------------------
--------------------------------
--------------------------------
--------------------------------
--------------------------------
--------------------------------
--------------------------------
--------------------------------
--------------------------------
--------------------------------
--------------------------------
--------------------------------
WWWWWWWWWWW---------------------
WWWWDDDWWWW---------------------
WWFFFFFFMWW---------------------
WWFFFBFFFWW---------------------
WWFFFFFFFWW---------------------
WWFFFFFBFWW---------------------
WWFFFFFFFWW---------------------
WWFFFFFFFWW---------------------
WWFFFFFFFWW---------------------
WWFFFFFFFWW---------------------
WWFFFFFBFWW---------------------
WWFFFFFFFWW---------------------
WWFFFBFFFWW---------------------
WWFFFFFFMWW---------------------
WWWWWWWWWWW---------------------
WWWWWWWWWWW---------------------
