--------------------------------
--------------------------------
--------------------------------
--------------------------------
--------------------------------
--------------------------------
--------------------------------
--------------------------------
--------------------------------
--------------------------------
--------------------------------
--------------------------------
--------------------------------
--------------------------------
--------------------------------
--------------------------------
WWWWWWWWWWW---------------------
WWWWDDDWWWW---------------------
WWIIIFIIIWW---------------------
WWIIIFIIIWW---------------------
WWIIIFIIIWW---------------------
WWIIIFIIIWW---------------------
WWIIIFIIIWW---------------------
WDFIIFIIFDW---------------------
WDFFFIFFFDW---------------------
WWIIIFIIIWW---------------------
WWIIIFIIIWW---------------------
WWIIIFIIIWW---------------------
WWIIIFIIIWW---------------------
WWIIIFIIIWW---------------------
WWWWDDDWWWW---------------------
WWWWWWWWWWW---------------------
