--------------------------------
--------------------------------
--------------------------------
--------------------------------
--------------------------------
--------------------------------
--------------------------------
--------------------------------
--------------------------------
--------------------------------
--------------------------------
--------------------------------
--------------------------------
--------------------------------
--------------------------------
--------------------------------
WWWWWWWWWWW---------------------
WWWWWWWWWWW---------------------
WWFFFFFFFWW---------------------
WWFPPPPPFWW---------------------
WWFPFFFPFWW---------------------
WWFPFPFPFWW---------------------
WWFFFPFFFWW---------------------
WDFFFPFFFDW---------------------
WDFFFPFFFDW---------------------
WWFFFPFFFWW---------------------
WWFPFPFPFWW---------------------
WWFPFFFPFWW---------------------
WWFPPPPPFWW---------------------
WWFFFFFFFWW---------------------
WWWWDDDWWWW---------------------
WWWWWWWWWWW---------------------
