--------------------------------
--------------------------------
--------------------------------
--------------------------------
--------------------------------
--------------------------------
--------------------------------
--------------------------------
--------------------------------
--------------------------------
--------------------------------
--------------------------------
--------------------------------
--------------------------------
--------------------------------
--------------------------------
WWWWWWWWWWW---------------------
WWWWDDDWWWW---------------------
WWFFFFFFFWW---------------------
WWIIIIIFFWW---------------------
WWFFFFIFIWW---------------------
WWIIFIIFFWW---------------------
WWFIFFFFFWW---------------------
WDFIIIIIFDW---------------------
WDFFFFFFFDW---------------------
WWFIFFFIIWW---------------------
WWFIFFFFFWW---------------------
WWFIIIIIFWW---------------------
WWFFIFFFFWW---------------------
WWFFIFFIIWW---------------------
WWWWWWWWWWW---------------------
WWWWWWWWWWW---------------------
