--------------------------------
--------------------------------
--------------------------------
--------------------------------
--------------------------------
--------------------------------
------------------XSSS----------
-----oo----------XXX------------
----------------XXXS------------
-XXX------------XXXX------------
XXXX----------XXXXXX-SSS-------<
XXXX---------XXXXXXX-----------[
XXXX------------XXXX-----------[
XXX---XXXXXXXXXXXXXXXX---XXXXXXX
