--------------------------------
--------------------------------
--------------------------------
--------------------------------
--------------------------------
--------------------?SS---------
--------------------------------
--------------------------------
--------------------------------
--------------------------------
-----------------E---B----------
------------B--------b-------B--
------------b--------B-------b--
XXXXXXXXXXXXXXXXXXXXXXXXXXXXXXXX
