--------------------------------
--------------------------------
--------------------------------
--------------------------------
--------------------------------
------------------------XX------
------------------------XX------
------------------------XX------
---------------------X--XX------
--------------------XX--XX------
-----------E----E--XXX--XX------
-----B------------XXXX----------
-----b-----------XXXXX----------
XXXXXXXXXXXXXXXXXXXXXXXXXXXXXXXX
