--------------------------------
--------------------------------
--------------------------------
--------------------------------
--------------------------------
--------------------------------
--------------------------------
--------------------------------
--------------------------------
--------------------------------
---------------X----------------
----------B----X----------------
--EE-E----b----X---EE-E--E------
XXXXXXXXXXXXX--XXXXXXXXXXXXXXXXX
