--------------------------------
--------------------------------
--------------------------------
------------------Q-------------
------ooooooo----------XXX------
---XX---------------------------
----------------XX--------------
---------XX---------------------
--------------------------------
----------------------------XXXX
--------------------------------
------------XXXXX---------------
--------------------------------
XXXX--XXXX----------------------
