--------------------------------
--------------------------------
--------------------------------
--------------------------------
--------------------------------
--------------------------------
--oooo----------oooo------------
--------------------------------
--------------E---------------E-
-------------<>--------------<>-
X------------[]--------------[]-
X------------[]--------------[]-
X------------[]--------------[]-
XXXXXXXXXXXXXXXXXXXXXXXXXXXXXXXX
