--------------------------------
--------------------------------
--------------------------------
--------------------------------
---------------------Eooo-------
---------------------XXXXX------
--------------------------------
--------------------------------
------------------------------XX
-------------------XXXXXXXX-----
--------------------------------
----------------------------o---
-------------XXXX----------XXX--
XXXXXXXXXXX---------------------
