--------------------------------
--------------------------------
--------------------------------
--------------------------------
--------------------------------
-----------E--S---SSSSSSSSS-----
----------<>--------------------
----------[]--------------------
--E-------[]--------------------
-<>------SXXS-------------------
-[]--E---------E---------------E
-[]-<>--------<>--------------<>
-[]-[]--------[]--------------[]
XXXXXXXXXXXXXXXXXXXXXX------XXXX
