--------------------------------
--------------------------------
--------------------------------
--------------------------------
--------------------------------
--------------------------------
--------------------------------
--------------------------------
--------------------------------
--------------<>---------<>-----
------<>------[]---------[]-----
------[]------[]---------[]-----
------[]-E----[]-----E-E-[]-----
XXXXXXXXXXXXXXXXXXXXXXXXXXXXXXXX
