--------------------------------
----------------------------XXX-
SSSSSSSSSSSSSSSSSSSSSSSSSSS-----
--------------------------------
--------------------------------
--------------------------------
--------------------------------
--------------------------------
---------------E----------------
-----------E--<>----------------
----E-----<>--[]----------XX----
---<>-----[]--[]---------XXXXXX-
---[]---E-[]--[]--------XXXX----
-XXXXXXXXXXXXXXX--XXXXXXXXX-----
