--------------------------------
--------------------------------
--------------------------------
--------------------------------
-----E------------------oo--oo--
-----E--E-------oo--------------
-------XXXXXX-------------------
--------------------------------
-----------------XX-------------
-XXX---------------------XX-----
--------------------------------
-----------------------------XXX
--------------------------------
X-------------------------------
