--------------------------------
--------------------------------
--------------------------------
--------------------------------
--------------------------------
--------------------------------
--------------------------------
--------------------------------
------------Q--?----------------
---------Q-E------ESSS----E----<
-----------E-------------<>----[
-------------------------[]----[
-------------------------[]---E[
XXXXXXXXXXXXXXXXXXXXXXXXXXXXXXXX
