--------------------------------
--------------------------------
--------------------------------
--------------------------------
--------------------------------
SSS-----SSSSS-------------------
-------------------E------------
------------------<>------------
------------------[]------------
------------ES----[]------E-----
------E----<>---E-[]-----<>-----
-----<>----[]--<>-[]-----[]-----
-----[]----[]--[]-[]-----[]-----
XXXXXXXXXXXXXXXXXXXXXXXXXXXXXXXX
