--------------------------------
--------------------------------
S-----SSSSSSSSSSSSSSSSSSSSSSSSSS
S-------------------SSSSSSSSSSSS
S-------------------SSSSSSSSSSSS
S-------------------SSSSSSSSSSSS
S-------------------------------
S-------------------------------
S---------------------------?---
S---------------------SSSSSS??SS
S---------------------SSSSS---SS
S---------------------SSSSS---SS
S--------------------------oooSS
XXXXXXXXXXX--XX--X---XXXXXXXXXXX
