--------------------------------
--------------------------------
--------------------------------
--------------------------------
--------------------------------
--------------------------------
--------------------------------
-------------------------B------
-------------------------b------
QQQQ-------------------SSXSS----
-------B-----E---B--------------
E------b---------b-----------B--
-----------------B-----------b--
XXXXXXXXXXXXXXXXXXXXXXXXXXXXXXXX
