----------
----------
----------
----------
----------
----------
----------
----------
----------
----------
----------
----------
------X---
XXXXXXXXXX
