--------------------------------
--------------------------------
--------------------------------
--------------------------------
------------------E-------------
----------------SSSSSSSS---SSSQ-
--------------------------------
---------------E----------------
S-------------------------------
-------------S?S--------------S-
--------------------------------
--------------------------------
-------------------------------E
XXXXX--XXXXXXXXXXXXXXX---XXXXXXX
