--------------------------------
--------------------------------
oo------------------------------
----E--E------------------------
---XXXXXXX-------------oooo-----
-----------------------XXXX-----
-------------oo-----------------
--------------------------------
XXX-----------------------------
--------------------------------
------------------XXX-?---------
--------------------------------
--------------------------------
-------------XXXX-----XXXXX-XXXX
