--------------------------------
--------------------------------
SSSSSSSSSSSSSSSSSSSSSSSSS?SSSSSS
--SSSS------SSSS----------------
--SSSS--E---SSSS----------------
---S----SS----------oooooo------
---S----SS----------------------
---S----SS----------SSSSSS------
---So??-SS---E------SSSSSS------
---SSS--SS--SSSS----------------
-----------EE-------------------
--------------------------------
--------------------------------
XXXXXXXXXXXXXXXX---XXXXXXXXXXXXX
