--------------------------------
--------------------------------
--------------------------------
--------------------------------
--------------------------------
--------------------------------
--------------------------------
-------------XSS--o-------------
------------XXX-----------------
-----------XXXX-SS--------------
----------XXXXX-----------------
---------XXXXXX--SSS------------
--------XXXXXXX-----------------
X-XXXXXXXXXXXX------XXXXXXXXX---
