--------------------------------
--------------------------------
--------------------------------
--------------------------------
--------------------------------
-------------E-----oo-----------
-----E---------------------XXX--
---XXXXXXXX---------------------
--------------------------------
---------------XXXX--XXXX-------
--------------------------------
X-------------------------------
------------ooo-----------------
------------XXX-------------XXXX
