--------------------------------
--------------------------------
--------------------------------
--------------------------------
--------------------------------
--------------------------------
--------------------------------
--------------------------------
-o-------------------oo---oo----
--------------------------------
--------------------------------
--------X---X-------------------
--------X-E-X-------------------
---XXXXXXXXXXXXXXXX-----X----XXX
