---------------------
---------------------
---------------------
---------------------
---------------------
---XXXX--------------
---------------------
---------------------
-------XXXX----------
---------------------
---------------------
---------------------
------------------XX-
-----------XXXXXXXXXX
