--------------------------------
--------------------------------
--------------------------------
--------------------------------
--------------------------------
--------------------------------
--------------------------------
--------------------------------
-----------------------------E--
----------------------------<>--
----------------------------[]--
----------------------------[]--
--------------E-EE-------E--[]--
XXXXXXXXXXXXXXXXXXXXXXXXXXXXXXXX
