--------------------------------
--------------------------------
--------------------------------
--------------------------------
--------------------------------
--------------------------------
--------------------------------
--------------------------------
--------------------------------
--------E------E----------------
-------<>-----<>----E-----------
-------[]-----[]----------------
-E-----[]-----[]-----------EEE--
XXXXXXXXXXXX--XXXXXXXXXXXXXXXXXX
