--------------------------------
--------------------------------
--------------------------------
--------------------------------
----------------E---------------
---------------SQS--SQS---------
--------------------------------
------XX------------------------
-----XXX------------------------
----XXXX-------SQS--S?S--------S
---XXXXX--------------------E--E
--XXXXXX------------------------
-XXXXXXX-----E-----E------------
XXXXXXX--XXXXXXXXXXXXXXXXXXXXXXX
