--------------------------------
--------------------------------
--------------------------------
--------------------------------
--------------------------------
--------------------------------
--------------------------------
--------------------------------
-------------------------o------
--------------------------------
--------------------------------
--------------------------------
--E-E---------------E---------EE
XXXXXXX-X-XX-XX-XX-XXXXXXXXXXXXX
