--------------------------------
--------------------------------
--------------------------------
--------------------------------
--------------------------------
-------------------------Q-Q----
--------------------------------
--------------------------------
---oo---------------------------
--o--o-------------------Q-Q----
--------------------------------
--------------------------------
--------------------------------
XXXXXXXXXXXXXXXXXXXXXXXXXXXXXXXX
