--------------------------------
--------------------------------
--------------------------------
--------------------------------
--------------------------------
------------------Q-------------
--------------------------------
--------------------------------
--------------------------------
---------------E--?-------------
--------------<>----------------
--------------[]----------------
--------------[]----------------
XXXXXXXXXXXXXXXXXXXXXXXXX--XXXXX
