--------------------------------
--------------------------------
--------------------------------
--------------------------------
--------------------------------
--------------------------------
------------------------E-------
-----------------------<>-------
-----------------------[]-------
--------------XSSS-----XX-------
--------------X----------------E
--------------X-----------B---<>
E----------E-EX-----------b---[]
XXXXXXXXXXXXXXXXXXX---XXXXXXXXXX
