--------------------------------
--------------------------------
--------------------------------
--------------------------------
--------------------------------
--------------------------------
--------------------------------
--------------------------------
-----------------SSSSSSSS-------
--------------------------------
----E---------------------------
--------E-----------------------
--------------------------------
XX-X-XX-X-XX-XXXXXXXXXXXXXXXXX-X
