--------------------------------
--------------------------------
--------------------------------
---------o----------------------
--------XXX---------------------
------------o------o-o----XXX---
-o---o------XXXX----------------
XXX-XXX-------------------------
-------------------XXXX---------
------------------------XXX-XXX-
--------------------------------
---------------XXXX-------------
---E----------------------------
XXXXXXXXXXXX--------------------
