--------------------------------
--------------------------------
--------------------------------
--------------------------------
----------------E---------------
------------SSSSSS----S---------
--------------------------------
--------------------------------
-------------E------------------
------E----SSSSSSS-----E--------
-----<>---------------<>--------
-----[]---------------[]--------
-----[]---------------[]--------
XX--XXXXXXXXXXXXXXXXXXXXXXXXXXXX
