--------------------------------
--------------------------------
--------------------------------
--------------------------------
--------------------------------
SQQS----------------------------
--------------------------------
--------------------------------
--------------------------------
-SS------X--X----------XX--X----
--------XX--XX--------XXX--XX---
-------XXX--XXX------XXXX--XXX--
-E----XXXX--XXXX----XXXXX--XXXX-
XXXXXXXXXXXXXXXXXXXXXXXXX--XXXXX
