--------------------------------
--------------------------------
SSSSSSSSSSSSSSSSSSSSSSSSSSSSSSSS
----------------------SS--SSSSSS
----------------------SS--SSSSSS
---------oooo-------SS--------SS
--------------------SS--------SS
-------S-SSSS-S-----SS--------SS
-------SoS--SoS-----SS----ooooSS
-------SSS--SSS-----SSSS--SSSSSS
X---------------------SS--------
XXX-------------------SS--------
XXX-------EE---------E------E--E
XXXXXXXXXXXXXXXXXXXXXXXXXXXXXXXX
