--------------------------------
--------------------------------
--------------------------------
--------------------------------
--------------------------------
-----------S-------SSS----------
--------------------------------
--------------------------------
----------E-EE------------------
-----X--------XX-XX-------------
----XXX-------XX-XX-------------
---XXXX-------XX-XXX------------
--XXXX--------X--XXX--E-E---E---
XXXXXX--------X--XXXXXXXXXXXXXXX
