--------------------------------
--------------------------------
---SSSSSSSSSSSSSSSSSSSSSSSSSSSSS
--------------------------------
--------------------------------
SSS------------E----------------
--------------<>----------------
S-------------[]----------------
-S------------[]-------S--------
--S------E--SS[]SS---E----E-----
--------<>----[]----<>---<>-----
--------[]----[]----[]---[]-----
--------[]-E--[]----[]---[]-----
XXXXXXXXXXXXXXXXXXXXXXXXXXXXXXXX
