--------------------------------
--------------------------------
--------------------------------
--------------------------------
--------------------------------
--------------------------------
--------------------------------
--------------------------------
------E--S--------o-----E--o----
-----<>-----E----------<>-------
-----[]----<>----------[]-------
-----[]----[]----------[]-------
-E---[]----[]----------[]-------
XXXXXXXXXXXXXXXXXXXXXXXXXXXXXXXX
