--------------------------------
--------------------------------
--------------------------------
--------------------------------
--------------------------------
--------------------------------
--------------------------------
--------------------------------
--------------------------------
------------------E-------------
-----------------<>----------E--
-----------------[]---------<>--
----E------E-EE--[]---------[]--
XXXXXXXXXXXXXXXXXXXXXXXXXXXXXXXX
