----------------------------------------------------------------------------------------------------------------------------------------------------------------------------------------------------------------------------------------------------------------------------------------
------------------------------------------------------------------------------------------------------------------------------------S---------------------------------------------------------------------------------------------------------------------------------------------------
----------------------------SSSSSSSSSSSSSSSSSSSSSSSSSSSS----------------------------------------------------------------------------SS--------------------------------------------------------------------------------------------------------------------------------------------------
---------------------------------------------------------------------------------------------------------------------SSSSSSSSSSS----S------S---------S----------------------------------------------------------------------------------------------------------------------------------
---------------------------------------------------------------------------------------------------------------------SSSSSSSS--S-----S----SS--------------------------------------------------------------------------------------------------------------------------------------------
--------------------------------------------------------------------------------------------------------------------SSSSSSSSSSSS----SS-----S---SSSSSSSSSS----------------------------S----XX------------------------S------------S-------------------------------------SS---------------
----------------------------------------------------------------------------------------------------------------E-----------------------------------------------------------------------------------------------------------------------------------------------------------------------
----------------------------------------------------------------------------------------------------------------X-----------------------------------------------------------------------------------------------------------------------------------------------------------------------
--------------------------------------E------------------------------------------------------------------------------------------------E--?-----E------------------E----XXXXXX--------------------E--------------------------------------------------------------E----------E-----------
SQQX--------------XX-----------S-----<>-----------------------------------------S------------------------------------SSSSSSSQ---------<>--------SSSSSSSS----------<>----------------XX-----------X-------E----------E--------------S-----Q-----------------------E---------<>-----------
-------E----XXX----------------------[]--------<>------X---------------------------------------------------------->-------------------[]------E-------------------[]-----------------------------XX-----<>---------<>-------------------------------------------[]---------[]---E-------
------XX--------------------SS-------[]--------[]----------------------------------------------------------------[]--X----------------[]-----SS-------------------[]-----------------------------XX-----[]---------[]----XX-------------------------------XX----[]---------[]-----------
---------------X------------S--------[]--------[]------X------------------------------E-------E--------------EE--[]----------------EE-[]----------------------E---[]---------------------------------E--[]-----E-E-[]----X-------------------------------XXX----[]---------[]-----------
XXXX-----XXX---XXX--XXX-XXX-XXXXXXXXXXXXXXXXXXXXXXXXXXXXXXXXXXXXX---XXXXXXXXXXXXXXXXXXXXXXXXXXXXXXXXXXXXXXXXXXXXXXXXXXXXXXXXXXXXXXXXXXXXXXXXXXXXXXXXXXXXXXXXXXXXXXXXXXXX------XX--------------------XXXXXXXXXXXX-XXXXXXXXXXXXXXXXXXXXXXXXXXXXXXXXXXX--XXXXXX--XXXXXXXXXXXXXXXXXXXXXXXXXX
