----------------------------------------------------------------------------------------------------------------------------------------------------------------------------------------------------------------------------------------------------------------------------------------
----------------------------------------------------------------------------------------------------------------------------------------------------------------------------------------------------------------------------------------------------------------------------------------
----------------------------------------------------------------------------------------------------------------------------------------------------------------------------------------------------------------------------------------------------------------------------------------
-------------------------------------------------------------------------------------------------------------------------------X--------------------------------------------------------------------------------------------------------------------------------------------------------
-------------------------------------------------------------------------------------------------------------------------------X--------------------------------------------------------------------------------------------------------------------------------------------------------
--------------------------------------------------------------------------------XXXX-------------------------------------------X----------------------QQ--------------------------------------------------------------------------------------------------------------------------------
-------------------------------------------X----------------------------------------------------------------------------------XX----------------------------------------------------------------------------------------------------------------------------------X---------------------
------------------------------------------XXX--------------------------------------------------------------------------------XXX-----------------------------------------------------XX---XX-------------------------------------------------XX-XXXX------------------------------------
------------------------------------------XX--------------------------------------------------------------------------------XXXX--------------------------------------------------------------------------------------------------------------------------------------------------------
------------------------------------------XX-----------------------------------SS------------------------------------------XXXXX-----------------QQ---QQ---?Q---------------------------------SS-----------------------------QQ-----------------------SS------------------XXXXXX--------
-------------------------------------------X-----E------------------------------------------------------------------------XXXXXX-----E-----<--------------------------------------E-----E-------------------------------------------------------E---------------------------------------
------------------------------------------XX-----X-----------------------------------------------------------------------XXXXXXX-----X-----[--------------------------------------E----<>-------------------------------------------------E---------------------------------------------
-----------------------------E--E------E--XX----------------------------------------------------E------------EE--E-EE---XXXXXXXX-----X--E--[------------------E-------------EE----S----[]-----E--E-EXX-----E-E----------------E---E-EE----S----E------E--E-E----------------------------
XXXXXXXX------XXXXXXXXXXXXXXXXXXXXXXXXXXXXXXXXXXXX-XXXXX---XXXXXXXXXXXXXXXXXXXX--XXXXXXXXXXXXXXXXXXXXX-XXXXXXXXXXXXXXXXXXXXXXXXXXXXXXXXXXXXXXXXXXXXXXXXXXXXXXXXXXXXXXXXXXXXXXXXXXXXXXXXXXXXX-XXXXXXXXXXXXXXXXXXXXXXXXX-----XXXXXXXXXXXXXXXXXXXXXXXXXXXXXXXXXXXXXXXX-----XXX---XXXXXXXXXX
