----------------------------------------------------------------------------------------------------------------------------------------------------------------------------------------------------------------------------------------------------------------------------------------
----------------------------------------------------------------------------------------------------------------------------------------------------------------------------------------------------------------------------------------------------------------------------------------
----------------------------------------------------------------------------------------------------------------SSSSSSSSSSSSSSSSSSSSSSSSSSSS-----S-SSSSS--------------------------------------------------------------------------------------------------------------------------------
----------------------------------------------------------------------------------------------------------------SSS----SSSS-------------------------------------------------------------------------------------------------------------------------------------------------------------
--------------------------------XXX------------------------------XXX---------------------------------------------------SSSS--------------------------------------------------------------------------------------------------------------XXX--------------------------------------------
----------------------------E----------------------------------------QQ---------SSSXX---SSSSQQSSSSS----------------S---SSSS---------------S-----------------XX-----------------------------------------SSSSSSSSSS-SS-----------------------------------------------QQ-QQQQ--------------
------------------------------------------------------------------------------------------------------------------------------------------------------------XX-------------------------XXX----------------------------------------------------------------------------------------------
---------------XXXXX----------------------------------------------------------------]-------------------------------------S---------------------------------XX------------------------XXX-----------------------------------------------------------------------------------------------
-------------------------------------------------------------SS---------------------X-X-----------------------E-----E-----E------------SS------------------XXXX----------------------XXXXX---------------------------------E------------------------------------------------------------
----------------------------X---------------XXXX-------------------EQQQQQQ------S---------SS?S-SSSS----------<>----SSS-SSSSS--------E---------------Q-X-----XX----X------------------XXXX---------------SSSSSSSS----------<>-----------------------------S--------QS?-QSSQQQ---------<>-
---------------------E------X------------XXXXX-X-------------------------------------------------------------[]-SSSSSS--SSS--------<>------X------------EXX-XX----X----E----------XXXXXXXX--------------------------------[]--------------E------------------------------------------[]-
---------------------------[---------------------------------------------------------------------------------[]-SSSSSSSSSSS--------[]------->-----------XXXXXX----X---XX---------XXXXXXXXX---------[----------------------[]-X-----------<>------------------------------------------[]-
-EE-E---E-EEE-EE--------EE-[-------------------------------------E--------E----------------------------EE-E--[]-SSSSSSSSSSS--------[]-------EE-E--------XXXXXX----X---XX---E----XXXXXXXXXX------E--[--------------------E-[]-X-------E---[]--------------EE--------------------E-----[]-
XXXXXXXXXXXXXXXXXXXXXXXXXXXXXXX-------XX--------------X-XXXXXXXXXXXXXXXXXXXXX--XXXXXXXXXXXXXX---XXXXXXXXXXXXXXXXXXXXXXXXXXXXXXXXXXXXXXXXXXXXXXXXXXXXXXXXXXXXXX---XXXXXXXXXXXXXXX-XXXXXXXXXXXXXXXX-XXXXXXXXXXXXXXXXXXXXX-XXXXXXXXXXXXXXXXXXXXXXXXXXX---XXXXXXXXXXXXXXX--XXXXXXXXXXXXXXXXX
