----------------------------------------------------------------------------------------------------------------------------------------------------------------------------------------------------------------------------------------------------------------------------------------
----------------------------------------------------------------------------------------------------------------------------------------------------------------------------------------------------------------------------------------------------------------------------------------
----------------------------------------------------------------------------------------------------------------------------------------------------------------------------------------------------------------------------------------------------------------------------------------
----------------------------------------------------------------------------------------------------------------------------------------------------------------------------------------------------------------------------------------------------------------------------------------
----------------------------------------------------------------------------------------------------------------------------------------------------------------------------------------------------------------------------------------------E-----------------------------------------
----------------------------------------------E---XXXX------------QQQQQ--------------SSS---SSS-------------------------------------S-----------S----------------------------------------------------------------------------------------------------------------------QQQ---------------
----------------------------------------------------------------------------------------------------------------------------------------------------------------------------------------------------------------------------------------------------------------------------------------
--------------------------------------------------------E------S------------------------------------------------------------------------------------------------------------------------------------------------------------------------------------------------------------------------
----------------------------------------------------------S-SSSSS-----------------E------------------------E---------------------------------------------------------------------------X------------------------------------------------------------------------------------------------
-------------XXX--------------------------XXX----------------------SSSSS-Q-------<>----SS-----------------<>--------------------------------------------------------------------------XXX------------X-----------------------QQS---------------------------S------Q---QQQQQQQQ----------
------------XXXX-------------------------XXXXX-----------------------------------[]-------------------X---[]--------------------------------------------------------------------------XXX--------------------------------------------------------------------------------------------<--
----------XXXXXX-------------------------XX-X------------------------------------[--------------------X---[]-------------------------------------------------------------------------XXXX----------------------------------------XXX-------------------------------------------------[--
---------XXXXXXX--------E--------------------------------------------------E--------------------------X---[]--------------------------------------------------E--------------------E-XXXXX----------XX-----E----------------------------E---EE---------E-----------------------E-----[]-
XXXXXXXXXXXXXXXXXXXX----XXXXXXXXX---XXXXXX--------------XXXXXXXXXXXXXXXXXXXXXXXXXXXXXXXXXXXX---XXXXXXXXXXXXXXXXXXXXXXXXX--XXX-XXXXXXXXXXXXXXXXXXXXXXXXXXXXXXXXXXXXXXXXXXXXXXXXXXXXXXXXXXXXXX-----XXXXXXXXXXXXX---XXXXXXXXXXXXXXXXXX-XXXXXXXXXXXX-----XXXXXXXXXXXXXXXXXXXXXXXXXXXXXXXXXXX
