----------------------------------------------------------------------------------------------------------------------------------------------------------------------------------------------------------------------------------------------------------------------------------------
----------------------------------------------------------------------------------------------------------------------------------------------------------------------------------------------------------------------------------------------------------------------------------------
------------------------------------------------------------------------------------------------------------------------------------------------------------------------------------------------------------------------------------------------------------SSSSSSSSSS-----SSSSSSSSSSSSS
----------------------------------------------------------------------------------------------------------------------------------------------------------------------------------------------------------------------------------------------------------------------------------------
----------------------------------------------------------------------------------------------------------------------------------------------------------------------------------------------------------------------------------------------------------------------------------------
---------------------------X---------------XSS---------------------------------------------------------------XXX----------------------------SSS---------------------------------------------------------------------XX---------------SSSQQQQQQ------------------------------------------
------------------------------------------XXX----------------------------------------------------------------------------------------------------------------------------------------------------------------------XXX------------------------------------------------------------------
-----------------------------------------XXXX------------------------XX--XXX--------------------------------------------------------------------------------------------------------------------------------------XXXX----------X-------------------------------------------------------
----------------------------------------XXXXXE-----------------------------------------------------------------------E----------E--------------------------------------------------------------------------------XXXXX------------------------------------------------------XSSS--------
-----------------------S-----E---------XXXXXX---------------------------------S-------------------------------------<>---------<>----------ESSSQS-------------XX------X----------------------------------------X-XXXXX---------E------SSSSQSQQ-----------<>-<>---E---E------X-----------
----------E-----------------<>-------XXXXXXXX----X----------------E-----E-------------------------------------------[]---------[]------E--<>-------E----------XX-------------------------X--------------------XXXXXXXX--------<>-------------------------[]-[]--->---E------X----XX-----
----------------------------[]-------XXXXXXXX----X----------------E----<>-------------------------------------------[]---------[]---------[]------<>--------X-XX-----------------------XXXX------------------XXXXXXXXX--------[]-------------------------X]-[]------------XXX----XX-----
---------E]-----------------[]-EE---XX-XXXXXX----X-----X----EE----S----[]--------E-E----------E---------------------[]---------[]---------[]------[]-------XX-XX------XX---------------XXXX---------EE-E-----XXXXXXXXX--------[]-------------------EE-E--X]-[]--E--------XXXX----XX----X
XXXXXXXXXXXXXXXXXXXX---XXXXXXXXXXXXXXXXXXXXXXXXXXXXXXXXXXXXXXXXXXXXXXXXXXXXXXXXXXXXX--XX-XXXXXXXXXXXXXXXXX--XXXXXXXXXXXXX--XXXXXXXXXXXXXXXXXXXXXXXXXXXXXXX-XXXXXXXXXXXXXXXXXXXXXXXXXXXXXXXXXXXXXXXXXXXXXXXXX-XXXXX-XXX-XXXXXXXXXXXXXXXXXXXXXXXXXXXX-XXX-XXXXXXXXXXXXXXXX-XXXX---XXXXXXXX
