----------------------------------------------------------------------------------------------------------------------------------------------------------------------------------------------------------------------------------------------------------------------------------------
----------------------------------------------------------------------------------------------------------------------------------------------------------------------------------------------------------------------------------------------------------------------------------------
----------------------------------------------------------------------------------------------------------------------------------------------------------------------------------------------------------------------------------------------------------------------------------------
---------------------------------------------------------------------------------------------------------------------------------------------------------------------------------E------------------------------------------------------------------------------------------------------
---------------------------------------------------------------------------------------------------------------------------------------------------------------------------------XXX----------------------------------------------------------------------------------------------------
----------------------------------------------------------------------------------SS--S--------------------S-------------------------------------------------------------------------QQ---------------SS---SSSS-------------SSS----------------X-S--------------------------------------
----------------------------------------------------------------------------------------------------------------------------------------------------------------------------------------------------------------------------------------------XX----------------------------------------
------------------------------------------------------------------------------------------------------------------------------------------------------------XXXX------------------------------------------------------------------------------XX----------------------------------------
--------------------------------------------E---------------------------E----------------------------------------------------------------------------------------------------SSSS-----------------------------------------------------------X-XX-------------XXXXX--------------------E-
-------------------------------------------<>----------------QQ---QQ---<>-----------SSSQS-------------XX---------------------------------QQ------------------------------------------QQQ---------QQ----------------------------------------X--XX-----------E------------SSS----------<>-
---------------------------------E---------[]--------------------------[]------------------E----------XX------------------E---------------------------------------------------E---E--------------------------------------------------------XXXXX-----E----<>-------------------------[]-
-------------------------------------------[]--------------------------[]-----------------<>----------XX-----------------<>------------------------------------------------------<>--------------------------------------------------------XX-XX----<>----[]-------------------------[]-
-------E-EE---------------E-----EE---------[]--------------------------[]-E---------------[]-------XX-XX---------------EE[]------------E-EE---E--EE-E-EEE---------E--E-E---------[]---------------E-------------------E----------E--E----XXXX-XX----[]----[]-------------------------[]-
XXXXXXXXXXXXXXXXXXXXXXXXXXXXXXXXXXXXXXXXXXXXXXXX---XXXXXXXXXXXXXXXXXXXXXXXXXX----XXXXXXXXXXXXXXXXXXXXXXXXXXXXXXXXXXXXXXXXXXXXXXXXXX-XXXXXXXXXXXXXXXXXXXXXXXXXXXXXXXXXXXXXXXXXXXXXXXXXXXXXXXX--XXXXXXXXXXXXXXXXXXXXXXXXXXXXXXXXXXXXXXXXXXXXXX-XXXX-XXXXXXXXXXXXXXXXXXXXX----XXXXXXXXXXXXX
