----------------------------------------------------------------------------------------------------------------------------------------------------------------------------------------------------------------------------------------------------------------------------------------
----------------------------------------------------------------------------------------------------------------------------------------------------------------------------------------------------------------------------------------------------------------------------------------
------------------------------------------------------------------------------------------------------------------------------------------------------------------------------------------------------------------------------------------------------------SSSSSSSSSSSSSSSSSSSSSSSSSSSS
--------------------------------------------------------------------------------------------------------------------------------------------------------------------------------------------------------------------------------------------------------------SSSSSSSSSSSSSS----SS-S--SS
------------------------------------------------------------------------------------------------------------------------------------------------------------------------------------------------------------------------------------------------------------X-SSSSSSSSSSSSSS----SSSS--SS
-----------------------XXX------------------------------------------XE---E---------------X---------E-----------------------------S---------------------------------XXXXX-----------?SS------------------------------------------SSS--------------------SS----SSSSSSSSSSSSSSS----------SS
--------------------------------------------XXXX------------------------XXXXXXX-----------------------------------------------------------------------------------------------------------------------------------------------------------------------------ES--------------------------
-------------------------------------------------------------------------------------------------------------------------------XX-------------------------------------------------------------------------------------------------------------------------------------S-----------------
-----------------------------------------------------------------------------------X-------------------------------------------X-----------------------------------------XSSSSSSS-----------------E-------------------------------------------------------------E-----S-----------------
---------------XX------------------------------------SSS---------------------------S------------X----------------------------------------------------------------------------------SSSSS---------<>------------------------------------------------------------SSSSSSSSS----------------
---------------X-------------X---------------------------E--------------------------------------X--------------------E----------E----E-----------------------------------------------------------[]--------------------------------------------X--X-----------E-------------------------
----------------------------XXX-------------------------XXXX------------------------------------X-------------------<>---------<>---<>-----------------------------------------------------------[]-----------------------------------------------X----------SSSSX----S-------<>--------
----------------------------XX------E-------------------X-----------------------------E---E-E---X---------E-EE-E-E--[]-----E--E[]---[]-----------------------------------------------------E-----[]----------------E---------------------------X--X----------[]------E--------[]--------
XXXXX----XXXX---------------XX-XXXXXXXX-XXXXXXXXXXXXXXXXX----XXXXXXXXXXX-----XXXXXXXXXXXXXXXXXXXXXXXXXXXXXXXXXXXXXXXXXXXXXXXXXXXXXXXXXXXXXXXXXXXX--XXXXXXXXXXXXXXXXXXXXXXXXXXXXXXXXXXXXXXXXXXXXXXXXXXXXXXXXXX-XXXXXXXXXXXXXXXXXXXXXX---XXXXXXXXXXXXX-----X-XXXXXXXXXXXXXXXXXXXXXXXXXXXXX
