----------------------------------------------------------------------------------------------------------------------------------------------------------------------------------------------------------------------------------------------------------------------------------------
----------------------------------------------------------------------------------------------------------------------------------------------------------------------------------------------------------------------------------------------------------------------------------------
-------------------------------------------------------------------------------------------------------------------SSSSSS-----------S-------SSSSSSSSSSSSSSSSSSSSSSSSSSSS----------------------------------------------------------------------------------------------------------------
------------------------------------------------------------------------------------------------------------------SSSSSSSSSSSS------------SS--------------------------------------------------------------------------------------------------------------------------------------------
-------------------------------------------------------------------------------------------------------------------SSSSSSSSSS-------------S---------------------------------------------------------------------------------------------------------------------------------------------
-----------?SSS-----XXX-------XXX----------------------------------------------------------------------------------SSSSSSSSSSSSS----S-----SS---------------------------------------------XXXXXXX----------------------------------------------------------------------------------------
------------------------------------------------------------------------X---------------------------------------EE----------------------------------------------------------------------------------------------------------------------------------------------------------------------
-------------------------------------------------------------------------------------------------------------------------------------------------------------S--------------------------------------------------------------------------------------------------------------------------
-XXXXX--------------------XX----------------------------------------------------------------------------------------E------------------E--------------E------SSS------------X-X---------------------------------------------------------------------------------------------------------
------------SS------------------------------------------------------------------S-SQ--------------------------------SSSSSSSS----------<>----<>-S----S<>------X--X------X-----------------------------------------------------SS--------------XXXX---------------------------------------
-X----------------------X--S--------------------------------------------------------------------------------------E-------------------[]----[]--------]------X-XX-X----X---------------------------------------------------------------------X------------------------E-----------------
-----------------------------------------------------------------------------------------------------------------SS--X------------<---[]----[]-------[]---X-<>-XX------X--------------------------------------------------------------------XX-----------------------<>-----------------
XX----------------------------------E---E----------E-EE---------E----E---------E---------------------------------[]------E--------EE--[]----S-----E--[]--EX-[]-XX------X-----------------------------------E-EE----------------------------XXX----------E------------[]--------------EE-
------XX-XX-----------------XXXXXXXXXXXXXXXXXXXXXXXXXXXX-----XXXXXXXXXXXXX--XXXXXXXX-----XXXXX--XXXXXXXXXXXXXXXXXXXXXXXXXXXXXXXXXXXXXXXXXXXXXXXXXXXXXXXXXXXXXXXX--XXXXXX------------------XXX-------XXXXXXXXXXXXXXXXXXXXXXXXXXXX---XX---XXXXXX-----X-X--X---XXXXXXXXXXXXXXXXXX----XXXXXX
