----------------------------------------------------------------------------------------------------------------------------------------------------------------------------------------------------------------------------------------------------------------------------------------
----------------------------------------------------------------------------------------------------------------------------------------------------------------------------------------------------------------------------------------------------------------------------------------
----------------------------------------------------------------------------------------------------------------------------------------------------------------------------------------------------------------------------------------------------------------------------------------
--------------------------------------------------------------E-------------------------------------------------------------------------------------------------------------------------------------------------------------------------------------------------------------------------
-------------------------------------------------------------XXXX----------------------------------------------------------------------------------------------------------------------------------------------------------------------------------------------XXXXX--------------------
----------------------------X--------------------------------------------XXXX------------------------------------------------Q--------------------------------------------------------------------------------?SS-------------------------------------------E----------------SSSSSSSS---
-----------------XXX--------------------------------------------------------------------------------------------------------------------------------------------------------------------------------------------------------------------------------------------------------------------
---------------------------------------------------------------------------------------------------X-----------------------------------------------------X------------------------------------------------------------------------------------XXXXXX------------------------------------
--------------------------E-----------------E--------------XXXX------------------------------------X------------------SSS--------------------------------X-----------------XXX---------------------X----------E------------E------------------------------------------------------------
-X-----------------------QQS-----E---------<>----------E------------XXX----------X-------------------------------------------?S---------S?SS----------------------SSSSSS------------------------------E--SS--S]-----E-----<>--------------------------------XXXX------------XXXXXX------
-X------------------------------<>---------[]------E--<>-------------------------XXX-----------XXXXX--------------------------------------------------E------------------X---------------------------<>------[]----<------[]---------E---------------E-------------------XXXX-----------
XXXX----------------------------[]---------[]-----<>--[]-------------------------XX-----------XXXXXX-------------------------------------------------<>----------------------------------------------[]--X---[]----[------[]-------------------X----<>----------------------------------
XXXX----------------------------[]---------[]-----[]--[]----------------------X--X----------XXXXXXXX--------E--E-------E-E-----------------------E-E-[]------------E--E-XXX--------------------------[]------[]----[------[]-----EE-EE----EE--EE----[]----------------------------------
XXXXXXXXXXX--XXXXXXXXXXXXXXX-XXXXXXXXXXXXXXXXXXXXXXXXXXX------------------XXXXXXXXX-XXXX--XXXXXXXXXXXXXXXXXXXXXXXXXXXXXXXXXXXXXXXXXXXXXXXXXXXXXXXXXXXXXXXXXXXXX-XXXXXXXXXXXXXXXXXXX---XXXXXXXXXXX---XXXXXXXXXXXXXXXXXXXXXXXXXXXXXXXXXXXXXXXXXXXXXXXXXXXXXXXXXX-------XXX----------------
