------------------------------------------------------------------------------------X---------------------------------------------------------------------------------------------------------------------------------------------------------------------------------------------------
-------------------------------------------------------------------------------------X--------------------S-----------------------------------------------------------------------------------------------------------------------------------------------------------------------------
------------------------------------------------------------------------------------SSSSSSSSSSSSSSSSSSSSSSSSSSSS----------------------------SSSSSSSSSSSSSSSSSSSSSSSSSSSS------------------------------------------------------------------------------------SSSSSSSSSSSSSSSSSSSSSSSSSSSS
------------------------------------------------------------------------------------SSSSSSSSSSSSSSS-----SSSS--SS--------------------------------------------------------------------------------------------------------------------------------------------S------SS--------------S----
------------------------------------------------------------------------------------SSSSSSSSSSSSSSS-----SSSS--SS--------------------------------------------------------------------------------------------------------------------------------------------SS-----SSS?-----------------
--SSSSSSSS----SS------SSSSSS--------------------------------------------------XXXX--SSSSSSSSSSS--SSS----------SS-SSS---SS--------------------------------------------------------------------XXXXXXX----------------XX-------------SS--SSSS------SSSS-------SSS----------S--------------
------------------------------------------------------------------------------------[S-S---------------------------------------------------------------------------------------------------------------------------XXX------------------------------------------------------------------
----------------------------------------------------------------------------------------------S------------E-------------------------------------------------------------------------------------------------------XXX---------------------------------------S--------------------------
--------------------------------SSSSS---------------------------------------------------E-----S-----------<>?--------------------------E--------------E-----------------------------------------------------------XXXX---------------------------------E---------------------------SS---
--SSSSSSS------------------------------QQQQQ----------E-X---------------XXXXX--------SSSSSSSSSSS-------E?-[]---XSSSS------------------<>-------------<>-------------------------------------------------------X--XXXXX--------------------------------<>--E-SSSSS--S-----------XX------X
-----------------------------------------------------<>---------------XXX-----------SSSSSSSSSSS-------<>--[]----------------------XX--[]-------------[]----------------X--------------------------------------X-EXXXXX--------------------------------[]-<>--------SS--------X-XX------X
------------------X----------------------------------[]-----------------------------SSSSSSSSSSS-------[]X-[]---X----------------XXXX--[]-------------[]--------<>------X--------------------------------------XXXXXXXX--------------------------------[]-[]-------<>--------XXXXX------X
------------------X----------------------------------[]-----------------------------SSSSSSSSSSS-------[]--[]---X------E--------XXXXX--[]-------------[]--------[]------X----------------------------E--E------XXXXXXXX--------------------------------[]-[]-]--E--[]-------XXXXXX-----XX
XXXXXXXXXXXXXXXXXXXXXXXXXXXXXXXXXXXXX--XXXXXXXXXXXXXXXXX---------XXXX------XXXX--XXXXXXXXXXXXXXXXXXXXXXXXXXXXXXXXXXXXXXXXXXXXXXXXXXXXXXXXXXXXXXXXXXXXXXXXXXXXXXXXXXXXXXXXXXXX--XXXXXXXXXXXXXXX---XXXXXXXXXXXXXXXXXXXXXX---------XXXXXXXXX--X----XXXXXXXXXXXXXXXXXXXXXXXXXXXXXXXX---XX-XX
