----------------------------------------------------------------------------------------------------------------------------------------------------------------------------------------------------------------------------------------------------------------------------------------
----------------------------------------------------------------------------------------------------------------------------------------------------------------------------------------------------------------------------------------------------------------------------------------
------------------------------------------------------------------------------------------------------------------------------------------------------------------------SSSSSSSSSSSSSSSSSSSSSSSSSSSS------------------------------------------------------------------------------------
XEEE--E------------------------------------X--------------------------------------------------------------------------------------------------------------------------------------------------------------------------------------------------------------------------------------------
<XXXXXXXX----------------------------------X----------------------------------------------------------------------------------------------------XXX-------------------------------------------------------------------------------------------------------------------------------------
?----------------SSSSSSSS------------------X-----------------------------------------------------------------XXX------------------------------------------------SSSSSS------------------------------X--SSSSSSSSSS-SS-----S--SSSS----------------------------SSS-------------------------
------------------------------------------XX--------------------------------------------------------------------------------------------------------------------------------------------------------------------------------------------------------------------------------------------
-----------------------------------------XXX-------------------------------X------------------------------------------------------------------------------------------------------------------------X------------------------------------------XX---------------------------------------
----------------------------------------XXXX--------------------------------------------------------------------------------------------------------------------------------------E------------------------------------------------------------------------------------------------E----
XXXXX------------XXXXX-----------------XXXX---------------------------------------------------------------SSS------------------XX-----------XXXXX-------------XXXX------>--S----S<>----------------X----SSSSSS--?SS----------X-------------------------S----SSSQ--------------XX--<>----
-----------EXXX-----------------------XXXXXX-----E----------------------E---------------------------E-------------------------EXXX-----------------------XXX---------------------[]--------<X------X--------------------------------------------E----E-------------E---------XXX--[]----
------XX-----------------------------XXXXXXX---------------------------<>--------------------------<>-------------------------XXXXX----------------------------------------------[]-----<>-XX-----XX-------------------------------------------<>---<>------------<>--------XXXX--[]----
-----------------------------E------XXXXXXXX--------E--E--E-EE----E----[]--------EEE-----E----E----[]-----E-------------------XXXXX-------XX---------------X------------E-----E--[]-----[]-XX----XXX--------------------E--------EE-EE----EE--E[]---[]E-----------[]-------XXXXX--[]---X
----------------------------XXXXXXXXXXXXXXXXXXXXXXXXXXXXXXXXXXXXXXXXXXXXXXXXXXXXXXXXXXXXXXXXXXXXXXXXXXXXXXXXXXXXXXXXXXXX--XXXXXXXXX--------X---------XX--------X-------XXXXXXXXXXXXXXXXXXXXXXXXXXXXXXXXXXXXXXXXXXXXXXXXXXXXXXXXXXXXXXXXXXXXXXXXXXXXXXXXXXXXXXXXXXXXXXXXXXXXXXXXXXXXXXXXX
