----------------------------------------------------------------------------------------------------------------------------------------------------------------------------------------------------------------------------------------------------------------------------------------
----------------------------------------------------------------------------------------------------------------------------------------------------------------------------------------------------------------------------------------------------------------------------------------
------------------------------------------------------------------------------------SSSSSSSSSSSSSSSSSSSSSSSSSSSS------------------------------------------------------------------------------------------------------------------------------------------------------------------------
---------------------------------------------------------------------------------------------------------------------------------------------------------------------------------------------------------------------------------------------------------------------E------------------
------------------------------------------------------------------------------------------------------------------------------E--------------------------------------------------------------------------------------------------------------------------------------XXX----------------
------------------X-----------------------------------------------------XX--------------------------X-----------E--E--E----------E----------X----------SS------------------------------------------------------------------------------------E------------------------------------------
-----------------XX----------------------------------------------------XXX--------------------------X--------------XXXXXX-------X--XXXXXXX------------------------------------------------------------------------------------------------------XXXXX-----------------------------------
-----------------XX----------------------------------------------------XXX---------------------------S----------------------------------------------------------------------------------------------------------------------------------------------------------------------------------
----------------XXX---------------------------------------------------XXXX--------------------------XSSS----------------------------------------------------E--------------------------X-------------------------------------------------------------------------SS?--------------------
----------------XXX----------------------------------QQ-----------X--XXXXX----------<>-------E--X----]----X-----X--------------XXXXSS------Q-----E---E-----<>------------------------XXX----------------------------------S--SS--X------------------------SS-----------E-QQQQQ--------E-
--------------XXXXX-----------------------------------------------X-EXXXXX----------[]-------E--X---[----XX-------------------------------------<>---------[]---E--------------------XXX----------------------E------------------X---------------------------------------------------<>-
-------------XXXXXX-----------------------------------------------XXXXXXXX---------X[]----------XXXX[X---XX---XXXXXX----------------------------[]---------[]--<><-----------------XXXXX---------------------<>-----------------XXX--------------------------------------------------[]-
-------------XXXXXX----------------------------------EE----E------XXXXXXXX---------X[]----------XXX-[]---XX---XX-------------E------------------[]---------[]--[][----------------XXXXXX--------E--------E-E-[]---------------E-XX------E----------------------------E---------------[]-
XXXXX--XXXXXXXXXX-----------XXXXXXXXXXX--XXXXXX-XXXXXXXXXXXXXXXXXXXXXXXXXXXX-XXXXXXXXXXXXXXXXXXXXXXXXX---XXXXXXX------------XXX----XXXXXXXXX--XXXXXXXXXXXXXXXXXXXXXXXXXXXXXXXXXXXXXXXXXXXXXXXXXXXXXXXXXXXXXXXXXXXXXXXXXXXXXXXXXX-----XXXXXXXXXXXX----XXXXXXXXXXXXXXXXXXXXXXXXXXXXXXXXXXX
