----------------------------------------------------------------------------------------------------------------------------------------------------------------------------------------------------------------------------------------------------------------------------------------
----------------------------------------------------------------------------------------------------------------------------------------------------------------------------------------------------------------------------------------------------------------------------------------
-----------------------------------------------------------------------------------------------------------------------------------------------------SSSSSSSSSS----S-S-S----------------------------------------------------------------------------------------------------------------
------------------------------------------------------------------------------------------------------------------------------------------------------------------------------------------------------------------------------------------------------------XEEE--E---------------------
-------------------------------------------------------------------------------------------------------------------------------------------------------------------------------------------------------------------------------------------------------------XXXXXXXX-------------------
---------------------------------------------------------XXX--------------------------------------------------------------------------------S---------------------------------------------------------------------------------X------------------------XXXX-?----------------SSSSSS-----
----------------------------------------------------------------------------------------------------------------------------------------------------------------------------------------------------------------------------------------------------------------------------------------
------------------------------------------------------------------------------------------------------X---------------------------------------------------------------------------------------------------------------------------------------------------------------------------------
-----------------------------------------------------------------------------------------------------XX---------------------------------------------------------------------------------------------------------------------------------------------------------------------------------
-----------------------------------------X-XXX------------------------------------------------------XXX----------------------------------SSSSSSQ--------------XXX-----XX--------------------S-------------------XX---------------------------XXXX-----------XXXXX-------------XXXX------
----------------E---------E-------------X-----------------------------------------------------------XXXX-------------------------------------------E---------XXXX------X---------------------------------------XXX---------------------------XX--------------------X---EXXX-------------
---------------<>-----------------------XX--------------------------------------------------------XXXXXX------------------------------------------<>--------XXXXX------X-XXX-----------------------------------XXX---------------------------XX-------------------XX--------------------
---------------[]---------E-------------XX-------E--E---------------------------------------------XXXXXX---------X-----E--------------------------[]-------XXXXXX------X------------------------------------EXXXXX-------EE-E--------------XXX-----------------------------X-----XX-----
XXXXXXXXXXXXXXXXXXXXXXXXXXXXX-XXXXX-XXXXXXX--XXXXXXXXXXXXXXXXXXXXXXXXXXXXXXXXXXXXXXXXXXXXXXXXXXXXXXXXXXXXXXXXXXXXXXXXXXXXXXXXXXXXXXXXXXXXXXXXXXXXXXXXXXXXXXXXXXXXXXXXXXXXXX-XXXXXXXXXXXXXXXXXXXXXXXXXXXXXXXXXXXXXXXXXXXXXXXXXXXXXXXXXX--XXXXXX----XXXX----XX----------------------------
