----------------------------------------------------------------------------------------------------------------------------------------------------------------------------------------------------------------------------------------------------------------------------------------
----------------------------------------------------------------------------------------------------------------------------------------------------------------------------------------------------X-----------------------------------------------------------------------------------
----------------------------SS--------------------SSSSSS--------------------------------------------------------------------------------------------------------------------------------------------------------------------------------------------------------------------------------
----------------------------------------------------------------------------------------------------------------------------------------------------------------------------------------------------------------------------------------------------------------------------------------
-------------------------------------------------------------------------------------------------------------------------------------------------------------------------------------------------------------XXX------------------------------------------------------------------------
-----SSQQQQQQQQ------------S-----------------------------------Q--QQQQQ---------SSSS-----------------------------------------------------------S---------------------------------------------------X-------------------------------------------------------------------?SSS-------------
----------------------------------------------------------------------------------------------------------------------------------------------------------------------------------------------------------------------------------------------------------------------------------------
----------------------------------------------------------------------------------------------------------------------------------------------------------------------------------------------------------------------------------------------XXXXXX------------------------------------
--------------------------------------E------------E-----------------------------------------------------------------------------------------------------------------------------------------------------E----------Q----------------------------------------XSSSSSSS------------------E
------SS?-QSSSQQ--------------E--S---<>-----E-----<>--------E-Q---QQQQQQQQ---------------------------------------------------------------S---------------------------------------------------SSSSSS----------------->-----S--------------------------------E-----------SSSSS------------
-----------------------------<>------[]----<>---E-[]--------------------------------------------------X---------------------------------------------------------------------------E----------------------E----E----[]---------------------------E---------<>----------------------------
-----------------------------[]--X---[]----[]--<>-[]---X--------------------------------------------XXX-------------------------------------------------------X------------------<>---------------------<>---<>----[]--------------------------<>---------[]----------------------------
-------------------E---------[]------[]----[]--[]-[]-----------------------E------------------------XXX-----------------E----E---------E----------------------X--------------E---[]---------------------[]---[]----[]---------E[--E-EE----E----[]---------[]----------------------------
XXXXXXXXXXXXXXXXXXXXXXXXXX--XXXXXXXXXXXXXXXXXXXXXXXXXXXXXXXXXXXXXXXXXXXXXXXXXXXXXXXXXXXXXXXXXXXXXXXXXXXXXXXXXXXXXXXXXXXXXX-XXXXXXXXXXXXXXXXXXXXXXXXXXXXXXXXXXXXXXXXXXXXXXXXXXXXXXXXXXXXXXXXXXXXXXXXXXXXXXXXXXXXXXXXXXXXX--XXXXXXXXXXXXXXXXXXXXXXXXXXXXXXXXXX---XXXXXXXXXXXXXXXXXX-------
