----------------------------------------------------------------------------------------------------------------------------------------------------------------------------------------------------------------------------------------------------------------------------------------
----------------------------------------------------------------------------------------------------------------------------------------------------------------------------------------------------------------------------------------------------------------------------------------
--------------------------------------------------------SSSSSSSSSSSSSSSSSSSSSSSSSSSS--------------------------------------------------------SSSSSSSSSSSSSSSSSSSSSSSSSSS-----------------------------------------------------------------------------------------------------------------
----------------------------------------------------------------------------------------------------------------------------------------------------------------------------------------------------------------------------------------------------------------------------------------
-----------------------------XXXXXXX----------------------------------------------------------------------------------------------------------------------------------------------------------------------------------------------------------------------------------------------------
-XXX------------------------S----------------SSS------------------------------------------------?SS-------------------------------------S-------------------------------X---SSSSQQSSS---------------X------------------SSSS-----------------------------------------Q-QQ----------------
------------------------------------------------------------------------------------------------------XX--------------------------------------------------------------------------------------------------------------------------------------------------------------------------------
-------------------------------------------------------------------------------------------------------------------------------------------------------------S----------X---------------------------------------------------------------------------------------------------------------
--------------------------------------------------------------------------------------------------------------XX---------------------------------------------XXS------------------------------------X-XXX----------------------------E----------E---------------------------------------
--------------------------E-XXXXX-------------XXXX----XX---S----S-S------------------X-----------------------------------Q--------------------------Q-S------X----X-----------SSSS-SSSS----------<>-------------XXX-----------------<>---------<>----------E----------QSQQ--------------
-------------------------<>------------EXXXXX--X---------------------------X---------X-----------------------------------------------------------------------X----X------------------------------[]---------------------------------[]---------[]---------<>----------------------------
-------------------------[]-------XX-----------X------------------------<>-XX-------XXX----------------------------------------------------->-------------XXXX-X--X---XX-------------------------[]---------------------------------[]---------[]---------[]----------------------------
-------------------------[]----------------X------------------E---------[]-X--------XXX-------------------------------------------E---------E-----E------XXXXX-X--X---XX-------------------EE-E--[]---------------------------------[]---E-----[]---------[]----------------------------
XXXXXXXXX--XXXXXXXX-XXXXXXXXXXX------------X--XXXXXXXXXXXXXXXXXXXXXXXXXXXXXXXXXXXXXXXXXXXXXXXXXX--XX--X--XXXXX--XXXXXXXXXXXXXXXXXXXXXX-XXXXXXXXXXXXXXXXXXXXXXXX---XXX-XXXXXXXXXXXXXXXXXXXXXXXXXXXXXX-------XXXX-------------------XXXXXXXXXXXXXXXXXX--XXXXXXXXXXXXXXXXXXXXXXXXXXXXXXXXX-
