----------------------------------------------------------------------------------------------------------------------------------------------------------------------------------------------------------------------------------------------------------------------------------------
----------------------------------------------------------------------------------------------------------------------------------------------------------------------------------------------------------------------------------------------------------------------------------------
----------------------------------------------------------------------------------------------------------------------------------------------------------------------------------------------------------------------------------------------------------------------------------------
---------------------------------------------------------------------------------------------E------------------------------------------------------------------------------------------------------------------------------------------------------------------------------------------
---------------------------------------------------------------------------------------------XXX---------------------------------------------------------------------------------XXX----------------------------------------------------------------------------------------------------
----------------------------------------------------------------SS--------------------------------------------------------------------------------------?S------------------------QQQQQ---------SS-S-------------------------------------------E----------------------------------------
---------------------------------------------XXX----------------------------------------------------------------------------------------------------------------------------------------------------------------------------------------------EX----------------------------------------
----------------------------------------------------------------------------------------------------------------------------------------------------------------------------------------------------------------------------------------------XX----------------------------------------
-----------------------------------------------------------------------------------------SSSS-----------------------------------E-------------SSSSSSS-----------------E-----------------E---------------------------------------------------X-XX----------------------------------------
-----------------------------X------------------------SS--------------------------E--------------QQQ----------E------E---------<>-----------------------S?-----------<>-----E-----QQQ--?Q-----------------S--------------------------------XX-------------------------QQQ--QQ-----------
-----------------------------X---------------------------------------------------<>-------E------------------<>-----<]---------[]---E--------------------------------[]-------------------------------------------------------------------XXXXXX-----E----------------------------------
----------------------------XXX--------------------------------------------------[]--------------------------[]-----[]---------[]------------------------------------[]-------------------------------------------------------------------XXXX-X----<>-----[----------------------------
------------EE-------E------XX------------------------------------------------E--[]----------E---------------[]-----[]---------[]-E----------------E-E---------------[]-------------------EE--------------------------E----------EE-E-E-XXXXXXEE----[]--EE-[----------------------------
------XXXXXXXXXXXXXXXXXXXXXXXXXXXXXXXX---XXXXXXXXXXXXXXXXXXXXXXX---XXXXXXXXXXXXXXXXXXXXXXXXXXXXXXXXXXXXXXXXXXXXXXXXXXXXXXXXXXXXXXXXXXX-X-XXX---XXXXXXXXXXXXXXXX-XXXXXXXXXXXXXXXXXXXXXXXXXXXX---X-XXXXXXXXXXXXXXXXXXXXXXXXXXXXXXXXXXXXXXXXXXXXXXXXXXXXXXXXXXXXXXXXXXXXXXXXXXXXXXXXXXXXXXX
