----------------------------------------------------------------------------------------------------------------------------------------------------------------------------------------------------------------------------------------------------------------------------------------
----------------------------------------------------------------------------------------------------------------------------------------------------------------------------------------------------------------------------------------------------------------------------------------
------------------------------SS---SS--SSSSSSSSSSSSSSSS-----------------------------------------------------------------------------------------------------------------SSSSSSSSSSSSSSSSSSSSSSSSSSSS-----------------------------------SSS-S-----------SS-------------------------------
---------------X-------------------------------------------------------------------------------------------------------------------------------------------------------------------------------------EEE--E-----------------------------------------------------------------------------
---------------X-------------------------------------------------------------------------------------------------------------------------------------------------------------------------------------XXXXXXXX---------------------------------------------------------------------------
---------------X---------------S----S----------------------S--SSSSSS-------------------------------------------------------------------------------------------X------------------------XX----------?----------------SSSSS------SSSSSSSSSS------------SSS-------------------------------
--------------XX----E-------------------------------------------------------------------------------------------------------------------------------------------------------------------XX----------------------------------------------------------------------------------------------
-------------XXX-XXX-E--------------------------------------------------------------------------------X---------------------------------------------------------------------------------XXX--------------------------------------------------------------------------------XXX----------
------------XXXX----------------------E----------------------------------------E---------------------XX----------------------------------------XXXX-------------------------------------XXXS-----------------------------------S---E----------------------------------------------------
-----------XX-X----------------S----SSS----------------------SSSSSS-----------<>---------------------XX----------X----------------------SSSS------------XX--------------<>------Q-S-X----X----X-----XXXXX------------XXXXX------SSSSS--SS-----------------------------------------------
----------XXXXXX-----E-----<--E----------------E------------------------------[]------------------EXXXX-------------------------------------------------------------X---[]----------XXX-XX---XX----E-----------EXX----------XXXX-------S----------XX-------------------XX---------------
----------XXXXXX----<>-----[------------------->-------X----------------------[]------------------XXXXX-----------------------------------------------------------------[]-------X--XXXXXX---XX---XX-------X---------------------------S--------XXXX-------------------SS---------------
-E--EEE-XXXXXXXX----[]--E--[---------E---------[------XX----------------------[]------------------XXXXX---------XX-----EEE----------------------------------------------[]-E--E-----XXXXXX---XX---XX---------------------XX---------------------X-XX----------E-----EXXXX-EE--------EE-E
XXXXXXXXXXXXXXXXXXXXXXXXXXXXXXXXXXXXXXXXXXXXXXXXXXXXXXXXXXXXXXXXX--XXXXXXXXXXXXXXXXXXXXXXX-XXXXXXXXXXXXX----X--XXXXXXXXXXXXXXXXXXXXXXXXXXXXX-------X--------XXXXXXXXX---XXXXXXXXXXXXXXXXXX----XXX-XX----------------------------XXXXXXXXXXXXXXXXXXXXXXX-XXXXXXXXXXXXXXXXXXXXXXXXXXXXXXXX
