----------------------------------------------------------------------------------------------------------------------------------------------------------------------------------------------------------------------------------------------------------------------------------------
----------------------------------------------------------------------------------------------------------------------------------------------------------------------------------------------------------------------------------------------------------------------------------------
----------------------------------------------------------------------------------------------------------------------------------------------------------------------------------------------------------------------------------------------------------------------------------------
----------------------------------------------------------------------------------------------------------------------------------------------------------------------------------------------------------------------------------------------------------------------------------------
----------------------------------------------------------------------------------------------------------------------------------------------------------------------------------------------------------------------------------------------------------------------------------------
-----------S--------------------------------------------------------------S--------------------------------------------QQQQQQQQ------------------------------------------XXX-------------------------------------------S--SSSS----------------------------------------------------------
--------------------------------------------------------------------------X-------------------------------------------------------------------------------------------------------------------------------------------------------------------------------------------------------------
-------------------------------------------------------------------------XX------------------------------------------------------------------------------XX----X------------------------------------------------------------------------------------------------------------------------
----------------E----------------------------------------S---------------XX-------------------------------------------------------------------------------------------------------------------------------------------------------------------------------------------------------------
-----E---------<>-------------------------XXXX----------SS--------------XXXX--X-------------------------------------E-Q---QQQQQQ-Q--------E-----------------------S--S--------------------------------QQ--------------XX----------------------------------------------------------SS----
----<>---------[]---E--------------------------------------------------XXXXX--X----X----------E------------------------------------------<>-----------E-----E---------------------------------------------------------------------------------EXX----------------E----E-----E-----------
----[]---------[]---------------------------------------]-------------XXXXXX------XX---------<>------------------------------------------[]----------<>--------------------------------------------------------------------------------------------------------------<>----<>-----------
----[]---------[]---------------------------------------]-------------XXXXXX-----XXX---------[]--------------EE--------------------EE-E--[]---E--E---[]------------E-EE-------------E---------------------------------------------------------------------------EE---[]----[]-----E-----
XXXXXXXXXXXXXXXXXXXX---XXXXXXXXXXX---XXXXX-----XXXXXXXXXXXXXXXXX-XXXXXXXXXXXXXXXXXXXXXXXXXXXXXXXXXXXXXXXXXXXXXXXXXXXXXXXX--XXXXXXXXXXXXXXXXXXXXXXXXXXXXXXXXXXXXXXXXXXXXXXXXXXXXXXXXXXXXXXX-XXXXXXXXXXXXX----XXXXXXXXXXXXXXXXXXXXXXXXX---XXXXX---------------XXXXXXXXXXXXXXXXXXXXX-XXXXXX
