----------------------------------------------------------------------------------------------------------------------------------------------------------------------------------------------------------------------------------------------------------------------------------------
-----------------------------------------------------------------------------------------------------------------------------------------------------------------------S----------------------------------------------------------------------------------------------------------------
------------------------------------------------------------------------------SSSSS---------------------------------------------------------SSSSSSSSSSSSSSSSSS--SS----SS----------------------------------------------------------------------------------------------------------------
------SSSSS--------------------------------------------------------------------------------------------------------------E--------------------SSSSSSSSSSSSSS----SS----SS----------------------------------------------------------------------------------------------------------------
-------SSSS---------------------------------------------------------------------------------------------------------------------------------S-SSSSSSSSSSSSSS----SS----SS-------------------------------------XXX------------------------------------------------------------------------
-SSSSSSSSSSSS--S----S----------------------------------X---------------------------------------------------------------------Q--------------SSSSSSSSSSS--SSS----S------S-----------------------------------------------------------------------X----------------------------SSS---------
E----------------------------------------------------------------------------------------------------------------------------------------------------------------------------------------------------------------------------------------------X--------------------------------E-------
-----------------------------------------------------------------------------------------------------------------------S----------------------------------------------------------------------------------------------------------------------XX---------------------------------E------
----E------------------E--?---------------------------------------------------------------------------------------SSSSSSS-----------------------E------------------E-------------------------------------E----------E------------------------XXX-----------------E----------E-----------
-----SSSSSSS----------<>---------------------------SS-------------------E---------------------------------------------------S?SS----------E---SSSSSSSSS--------E--<>------------------------------Q-----<>---------<>----------E------------XXXX-------------E--<>---------<>----------E
--E-------------------[]-----------------------------------------E-----<>----------------------------------------------------------------<>---SSSSSSSS--------<>--[]------------------------------------[]---------[]---------<>----------XXXXXX----------------[]---------[]----X----<>
-SS-------------------[]-----------------------------------------------[]----<X----------------------------------------------------------[]--SSSSSSSSSS-------[]--[]------------------------------------[]---E-----[]---------[]---------XXXXXXX----------------[]---------[]---<>----[]
-[]---------------E---[]-----------E-E------------------EE--E------E-E-[]----[-------------E-E---------------------------E---------E-----[]----SSS-SSS--------[]--[]------------------------------------[]---E-----[]---------[]--------XXXXXXXX--------E--E[E--[]-----E-E-[]---[]----[]
XXXXXXXXXXXXXXXXXXXXXXXXXXXXXXXXXXXXXXXXXXXXXXX-----XXXXXXXXXXXXXXXXXXXXXXXXXX-XXXXXXXXXXXXXXXXXXXXXXXXXXXXXXXXXXXXXXXXXX---XXXXXXXXXXXXXXXXXXXXXXXXXXXXXXXXXXXXXXXXXXXXXXXXXXXXXXXX--XXX-----XXXXXXXXXXXXXXXXXXXXXXXXXX-XXXXXXXXXXXXXXXXXXXXXXXXXXXXXXXXXXXXXXXXXXXXXXX---XX---XXXXXXXX
