----------------------------------------------------------------------------------------------------------------------------------------------------------------------------------------------------------------------------------------------------------------------------------------
--------------------------------------------------------------------------------------------------------------------------------------------------------------------------------------------------------------------------------------------------------------------------------S-------
----------------------------SSSSSSSSSSSSSSSSSSSSSSSSSSSS------------------------------------------------------------------------------------------------------------------------------------------------------------------------------------------------------------------------S-------
---------------------------------------------------------------------------------------------------------------------------------------------------------------------------------------------------------------------------------------------------------------------------------------S
---------------------------------------------------------------------------------------------------------------------------------------------------------------------------------------------------------------------------------------------------------------------------------S----S-
-----------------XX-------------------------------------------------------X-------------------------------------------------------------------------------------------------------------S----------------------------------------------QQQQQQ-----------SSSS----SSSSSSSSSSSS----SS---SSS
----------------XXX-------------------------------------------------------X---------------------------------------------------------------------------------------------------------------------------------------------------------------------------------X---------------------------
---------------XXXX--------------------------SX--------------------------XX------------------------XE----------------------------------------------------------X--------------------------------------------------------------------------------------------X---------------------------
--------------XXXXX-------------------------XXXS---------S---------------XX--------------E---------X------------------------------------------------------------------------------------E-----------------------------------------------------------------------------------------------
----------X--XXXXXX-----------------Q-S------X----X-----X--------------XXXX-------------<>---------------------E--------Q-----------------------------------------SS--------->---------<>-----------Q-----------------X---------------Q---QQQ--------------------SSSSSSSQ---------------
----------X-EXXXXXX--------------------------X-X--X----X--------------EXXXX-------------[]----------E----E----<>----------------XX------------------------------------------[]---------[]----X--------------------EXXXXX----------------------------------------------------------------
----------XXXXXXXXX--------->------------XXXXX-X--X----X-------------EXXXXX-------------[]---------<>---<>----[]---------------XXX--------XX--------------------------------[]---------XX----X------------------------------------------------------------------------------------------
---------XXXXXXXXXX---------E-----E------XXXXX-X--X----X--------------XXXXX--------X-E--[]---------[]---[]----[]--------------XXXX--------XX--E--E--E-E-----------E--E---E--[]-----E-XXXX----X----------------------------------------------------E----------------------------EE-E-----
XXXXXXXX-XXXXXXXXXXXXXXXXXXXXXXXXXXXXXXXXXXXXX-XXXXXXXXXXXXXXXX---XXXXX----XXXXXXXXXXXXXXXXXXXXX-XXXXXXXXXXXXXXXXXXXXXXXXXXXXXXXXX----XXXXXXXXXXXXXXXXXXXXXXXXXXXXXXXXXXXXXXXXXXXXXX-XXXX-XXXXXXXXXXXXXXXX--XXXXX---------------XXXXXXXXXXXXXXXXXXXXXXXX-XXXXXXXXXXXXXXXXXXXXXXXXXXXXXXX
