----------------------------------------------------------------------------------------------------------------------------------------------------------------------------------------------------------------------------------------------------------------------------------------
--------------------------------------------------------------------------------------------------------------------------------------------X-------------------------------------------------------------------------------------------------------------------------------------------
----------------------------------------------------------------------------------------------------------------SSSSSSSSSSSSSSSSSSSSSSSSSSSS--------------------------------------------------------------------------------------------------------------------------------------------
----------------------------------------------------------------------------------------------------------------------------------------------------------------------------------------------------------E---------------------XEEE--E-------------------------------------------------
-------------------------------------------------------------------------------------------------------------------------S?---------------------------------------------------------------------------XXXXXXX--------------------XXXXXXXX-----------------------------------------------
--XX----------------------------------------------------------------------------------------------------------------------------------------------------S------------------------------------------------------------XXXX-------?----------------SSSS----------S------------------------
----------------------------------------------------------------------------------------------------------------------------------------------------------------------------------------------------------------------------------------------------------------------------------------
-----------------XXX------------------------------------------------------------------------------------------------------------------------------------------------------------------XXXXXX--------------------------------------------------------------------------------------------
--------------------------------------------------------------------------------------------------------------------------E---------------------------------E------------------------------------------XXXX--------------------S---------------------------S----------------------------
---------------------------------E----------E------------------------------------------------------XX----------->--S-----<]---------E------X-----E---------<>----------E------------------------------XXX-------XXX-----XX------XXXXX------------XXXXX---------XX-----------------------
--------------------------------<>---E-----<>---------------------------E---------------------------------------SSSSS----[]--------<>------X----<>---------[]---------<>---------------------E------------------------------XXXX-----------EXXX-----------XX----------------------------
--------------------------------[]---------[]----<X--------------------<>---------------------------------------SS?SS----[]--------[]------X----[]---------[]----<>---[]---------------------------[-----------------------------------X------------------X-----------------------------
--E-----E-E-E------------EE-EE--[]-----E-E-[]----[-----X----EE---------[]----------E----------------------------SSSSS-ES-[]--------[]----XXX----[]---------[]----[]---[]-EE-EEE-E-EEE-EE--------EE-E---------------------XX--------------------X-----XX---------------------------------
XXXXXXXXXXXXXXXXX----XXXXXXXXXXXXXXXXXXXXXXXXX-XXXXXXXXXXXXXXXXXX-XXXXXXXXXXXXXXXXXX---X----XXXXXXX--XXXXXXXXXXXXXXXXXXXXXXXXXXXXXXXXXXXXXXX-XXXXXXXXXXX-X-XXXXXXXXXXXXXXXXXXXXXXXXXXXXXXXXXXXXXXXXX--------------------------------------------------------XXXX--XXXXXX----XXXXXXX--XX-
