----------------------------------------------------------------------------------------------------------------------------------------------------------------------------------------------------------------------------------------------------------------------------------------
----------------------------------------------------------------------------------------------------------------------------------------------------------------------------------------------------------------------------------------------------------------------------------------
------------------------------------------------------------------------------------SSSSSSSSSSSSSSSSSSSSSSSSSSSS----------------------------SSSSSSSSSSSSSSSSSSSSSSSSSSSS---------------------------------------------------------------------------------------S-SSSSSSSSSSSS---------SS
--------------------------------------------------------------------------------------------------------------------------------------------SSSS--SSSSS------------------------------------------------------E---------------------------------X--------------------------------------SS
--------------------------------------------------------------------------------------------------------------------------------------------SSSS---SSSS------------------------------------------------------XXX-------------------------------X--------------------------------------SS
---SSSSSSSSSS-SS-----SSSSSSS---------------X-S-------------------------------------------------------------------S---------------------------SSSS-SSSSS---------------S------------------------------------------------------------------------XSS----------SSS----S-----S--------------
-------------------------------------------X--------------------------------------------------------------------------------------------------------------------------------------------------------------------------------------------------XXX---------------------------------------
------------------------------------------XX-------------------------------------------------------------------------------------------------------------------------------------------------------------------------------------------------XXXX---------------------------------------
------------------------------------------XX-----------------E----------E---------------------E-------------------------------------------------E-----E------------SS-------------------------------------SSS-------------------------------XXXXXE--------------------------------------
----SSSSSS-----------------------------X--XX----------------<>---------<>----------------S---<]----------------X-----------------XX------------SSSSSSSS----------------X---------------X--------------------------QQ---------QQ--E---------XXXXXX----------ESSSSS-------------XX------XX
---------------------------------------X-XXX-----------E----[]---------[]----------E-<>------[]---------E------X----------------XXX----------SSSSS--SSS--------<>------X--------------EXXX----------------E---E-----------------<>--------XXXXXXX----X----<>-------E---------XXX--------
------------------<--------------------X-XXX-----------[----[]---------[]----------]S[?------[]--------<>------X---------------XXXX-------XXSSSSSSSSSSS--------[]---------------------XXXX-------------------<>-----------------[]-------XXXXXXXX----X----[]------<>--------XXXX--------
------------------E-E--------E-EE----XXXXXXX----------E[----[]---E-----[]---------E[S[]------[]--------[]------X--------------XXXXX-------XXSSSSSSSSSSS--------[]------X--------------XXXX-------------------[]---------------E-[]-EE---XXXXXXXXX----X----[]------[]-------XXXXXX-E--XXX
XXXXXXXXXXXXXXXXXXXXXXXXXXXXXXXXXXXXXXXXXXXXX------X--XX-XXXXXXXXXXXXXXXXXXX--XXXXXXXXXXXXXXXXXXXXXXXXXXXXXXXXXXXXXXXXXXXXXXXXXXXXXXXXXXXXXXXXXXXXXXXXXXXXXXXXXXXXXXXXXXXXXXXX--XXXXXXX-------------XXXXXXXXXXXXXXXXXXXXXXXXXXXXXXXXXXXXXXXX-XXXXXXXXXXXXXXXXXXXXXXX---XX--XXXXXXXXXXXXX
