----------------------------------------------------------------------------------------------------------------------------------------------------------------------------------------------------------------------------------------------------------------------------------------
----------------------------------------------------------------------------------------------------------------------------------------------------------------------------------------------------------------------------------------------------------------------------------------
----------------------------------------------------------------------------------------------------------------------------------------------------------------------------------------------------------------------------------------------------------------------------------------
----------------------------------------------------------------------------------------------------------------------------------------------------------------------------------------------------------------------------------------------------------------------------------------
----------------------------------------------------------------------------------------------------------------------------------------------------------------------------------------------------------------------------------------------------------------------------------------
---------------------------------------------------XXXXXX---SS-SSSSS-----------------XXX---------------------------------------X-----------------------Q----------------------------?S-----------------------------------------------------------SSSS-----------------?SS---------------
------------------------------------------------------------------------------------------------------------------------------XX--------------------------------------------------------------------------------------------------------------------------------------------------------
------------------------------------------------------------------------------------------------------------------------------XX--------------------------------------------------------------------------------------------------------------------------------------------------------
----------------------------------------------------------------------------------------------------------------------------XXXX--------------------------------------------S---S------------------------E----------E-------------------------------------------------------------------
------------XX-----------------------------------S-SS----------S----SSS----------<>-----------------------------------------XXXX-----------------QQ---??----E-----------------------S------------QQ-----<>---------<>----------E-XXXX-------------XX----------E--QQ--S??----E-----------
----------XXXXX------------------------------------------------------------------[]---------------------------------------XXXXXX---------------------------<>-------------------------------------------[]---------[]---------<>-------E---------------------<>------------<>---E--E----
---------XXXXXX------------------------------------------------------------------[]--------------------------------------XXXXXXX---------------------------[]-------------------------------------------[]---------[]---------[]-----------------------------[]--X---------[]-----<>----
--------XXXXXX-E-----EE-EE-E-----------------------------------------------EE-E--[]---------E----------------EE--E-E----XXXXXXXX--------E--E---------------[]-E----------------E-E----------------------[]---E-----[]---------[]----------------------X------[]------------[]-EE--[]----
XXXXXXXXXXXXXXXXXXXXXXXXXXXX---XXXXXXXXXXXXXXXXXXXXXXXXXXXXXXXXXX---XXXXXXXXXXXXXXXXXXXXXXXXXXXXXXXXXXXXXXXXXXXXXXXXXXXXXXXXXXXXXXXX---XX--XXXXXXXXXXXXXXXXXXXXXXXXXXXXX---XXXXXXXXXXXXXXXX----XXXXX-XXXXXXXXXXXXXXXXXXX--XXXXXXXXX---XXXXXX---XXXXXXXXXXXX--XXXXXXXXXXXXXXXXXXXXXXXXXXX
