----------------------------------------------------------------------------------------------------------------------------------------------------------------------------------------------------------------------------------------------------------------------------------------
----------------------------------------------------------------------------------------------------------------------------------------------------------------------------------------------------------------------------------------------------------------------------------------
----------------------------------------------------------------------------------------------------------------------------------------------------------------------------------------------------------------------------------------------------------------------------------------
----------------------------------------------------------------------------------------------------------------------------------------------------------------------------------------------------------------------------------------------------------------------------------------
-----------------------------------------------------------------------------------------------------------------------------------------------------------------------------------------------------------------------------------------XXX--------------------------------------------
--X---------------------------------------------------------------------------------------------------------------------------------------------------------------------------------------SS----------------------------------S-----------------------------------------S---------------
----------------------------------------------------------------------------------------------------------------------------------------------------------------------------------------------------------------------------------------------------------------------------------------
-----------------------------------------------------------------------------------------------------------------------------------------------------------X----------------------------------------------------------------------------------------------------------------------------
----------------------------------------------------------------------------------------------------------------------------------------------------------XX--------------XX---------------------------------------------------------SSSS------------------------E----------E-----------
----------------------SSSSSS------------------------SSSS----------------------S-----------------------------------------------XXX------------------------XXX-----------E------------XXX----------X------------------E------------------------QQQ----------E-----<>---------<>----------E
----------------------------------------------------------------------------------------------E---------------------------------------------------------XXXX----------<>-------------------------XX----------------<>------------------------------------<>-----[]---------[]---------<>
-XX-----------------------------------------------------------------X------------------------<>-------------------------------------------------------XXXXXX----------[]-------------------------XX----------------[]------------------------------------[]-----[]---------[]----<>---[]
-----E-EE---E--------E-E-----------E-E--------------------E--EE-E-E-X---------E-EE-E-------E-[]---------------E---------------------------E----------XXXXXXX----------[]----------------------E--X------E----------[]-E------------------E---------------[]-----[]---------[]----[]---[]
XXXXXXXXXXXXXXXXXXXXXXXXXXXXXXXXXXXXXXXXXXXXXXXXXXXXXXXXXXXXXXXXXXXXXXXXXXXXXXXXXXXXXXXXXXXXXXXXXXXXXX------XXXXXXXXXXX----XXXX----XXXXXXXXXXXXXXXXX-XXXXXXXXXXXXXXXXXXXXXXX--XXX-------XXXXXXXXXXX-XXXXXXXXXXXXXXXXXXXXXX-X-XXXXXXXXXXXXXXXXXXXXXXXXXXXXXXX--XXXXXXXXXX-X-XX--XXXXXXXXX
