----------------------------------------------------------------------------------------------------------------------------------------------------------------------------------------------------------------------------------------------------------------------------------------
----------------------------------------------------------------------------------------------------------------------------------------------------------------------------------------------------------------------------------------------------------------------------------------
----------------------------------------------------------------------------------------------------------------------------------------------------------------------------------------------------------------------------------------------------------------------------------------
----------------------------------------------------------------------------------------------------------------------------------------------------------------------------------------------------------------------------------------------------------------------------------------
----------------------------------------------------------------------------------------------------------------------------------------------------------------------------------------------------------------------------------------------------------------------------------------
----------------------------------SQQQQQQ----------------------Q--Q---------------------------------SSS---------------------------------------------------------------------------------------------Q----------------------XX---SS------------------------------------------------------
-------------------------------------------------------------------------------------------------------------------------------------------------------------------------------------------------------XXXX-----------------------------------------------------------------------------
----------------E---------------------------------------------------------------------------------------------------------------------------------------------------------------------------------------------------------------------------------X-------------------------------------
-----E----------E-----------------------------------------------------------------------------------E------------------------------------------------------------------------E----------E---------------------------------------------------------X-------------------------------------
----<>---------[]----------E------SSS-QSQ---------------------Q---QQ---------------------E---------<>----------E------------Q-----------------------------------------------<>---------<>------------------------XXXXXX---------QQQ---------------X-------------------------------------
----[]---------[]---------<>-----------------------E---------------------------E--------<>---------[]----X----<>--------------------------------------E-----E---------E-----[]---------[]-----------------------------------------------------EXXXXX------------------------------------
----[]---------[]---------[]----------------------<>-[------------------------<>--------[]---------[]----<X---[]-------------------------------------<>----<>--------<>-----[]---------[]------------------------------------------------------XXXX-------XX----------------------------
----[]---------[]---------[]-------------------EE-[]-[------------------------[]----EE--[]-----E-E-[]----[]---[]---------------------------------E---[]----[]--------[]-----[]---------[]--------------------------------E---------------------XXXX------XXX----------------------------
XXXXXXXXXXXXXXXXX-XXXXXXXXXXXXXXXXXXXXXXXXXXXXXXXXXXXXXXXXXXXXXXXXXXXXXXXXXXXXXXXXXXXXXXXXXXXXXX---XX---XXXXXXXXXXXXXXXXX--XXXXXXXXXXXXXXX--XXXXXXXXXXXXXXXXXXX--XXXXXXX-XXXXXXXXXXXXXXXXXXXXXXXXXXX---------XXXXX-----XXX----XXXXXXXXXXXXXXXXXXXXXX--XXXXXX-----XXXXXXXXXXXXXXXXXXXXXXX
