--------------------------------------------------------------------------------------------------------------------------------------------X-------------------------------------------------------------------------------------------------------------------------------------------
----------------------------------------------------------------------------------------------------------------------------------------------------------------------------------------------------------------------------------------------------S-S---------------------------------
--------------------------------------------------------------------------------------------------------------------------------------------SSSSSSSSSSSSSSSSSSSSSSSSSSSS-----------------------------------------------------------SSSSSS----SSS----SSSSSSSS----------------------------
--------------------------------------------------------------------------------------------------------------------------------------------SSSSSSSSSSSSSS---------S--SS-----------------------------------------------------------SSSSSSSSSSSSS----SSSSSSSS---------------X------------
--------------------------------------------------------------------------------------------------------------------------------------------SSSSSSSSSSSSSS------------S------------------------------------------------------------SSSSSSSSSSSSS----SSSSSSSS----------------------------
--------------------------------------------------------X---SS--QQSS--------------------------------------------X---SSSSSSSS------SS---------SSSSSSSSSS--S------------SS----------------------SSSSSS---SSSSSS------S-?-S-------S---SSSSSSSSSSSSS----SSSSSSSS---------------X------------
-----------------------------------------------------------------------------------------------------------------------------------------------S--------------------------------------------------------------------------------EE----------------------------------------XXX-----------
------------------------------------------------------------------------------------------------------------------------------------------------------S-------------------------------------------------------------------------X----------------------------------------XXXX-----------
---------------------------------E----------E-------------X-----------------------E-----------------------------X-X-----------------------------?-----S------------SS---------------------------------EE----------------------------E-----------------------------------XXXXXX----------
----------------E-----<>--------<>---------<>------------------S?S-SSSS----------<>------------------------------------SS---?SS----------<>-SSSSSSSSSSSS--------E------X------------Q----------------?S?SS-------------X------------SSSSSSSS---------------------------XXXXXX-----------
---------------<>-----[]--------[]---------[]------------------------------------[]------------------------------------------------------[]-SSSSSSSSSSS--------<>------X-----------------------------------E----X-----------------E-----------------------------------XXXXXXX----X------
---------------[]-----[]--------[]---------[]------------------------------------[]--------------------------<E--------------------------[]-SSSSSSSSSSS--------[]------X----------------------------------X----------------------SS--X-------------------------------XXXXXXXX----X------
---------------[]-----[]--------[]---E-----[]------------------------------EE-E--[]--------------------------[]--------------------EE-E--[]-SSSSSSSSSSS--------[]------X------------------------------------------------E-E-----------------------EEE-------EE-E----XXXXXXXXXX---X-----X
XXXXXXXXXXXXXXXXXXXXXXXXXXXX-XXXXXXXXXXXXXXXXXXXXX-XXXXXXXXXXXXXXXXXXXXXXXXXXXXXXXXXXXX-XXX-----XX-------XXXXXXX--XXXXXXX---XXXXXXXXXXXXXXXXXXXXXXXXXXXXXXXXXXXXXXXXXXXXXXXXXXXXXXXXXXXXXXXXXXXXXXXXXXXXXXXXXXXXXXXXXXXXXXXXXXXXXXXXXXXXXXXXXXXXXXXXXXXXXXXXXXXXXXXXXXXXXXXXXXXXXXXXXXXX
