----------------------------------------------------------------------------------------------------------------------------------------------------------------------------------------------------------------------------------------------------------------------------------------
----------------------------------------------------------------------------------------------------------------------------------------------------------------------------------------------------------------------------------------------------------------------------------------
--------------------------------------------------------SSSS--------------SS--------SSSSSSSSSSSSSS--------------------------------------------------------------------------------------------------------------------------------------------------------------------------------------
--------------------------------------------------------------------------------------SSSSSSSSSSS---------------------------------------------------------------------------------------------------------------------------------------------------------------------------------------
--------------------------------------------------------------------------------------SSSSSSSSSSS---------------------------------------------------------------------------------------------------------------------------------------------------------------------------------------
--------------------------------------QQ---------------------------------------------SSSSSSSSSSS---S---------------------------------------------------------------------------------------------------S-------------------------XX-----------------------XX----------------XX----------
---------------------------------------------------------------------------------------------------------------------------------------------------------------------------------------------------------------------------------------------------------------------------XXX----------
----------------X---------------------------------------------------------------------------------------------------------------------------------------------------------------------------------------------------------------------------------------------------------XXXX----------
---------------XX-------------------------------------------------E---------------------E------------------E---------------------------------XSSSSSSS-----------------E--------------------------------------------------------------------------------------------------XXXXX----------
---------------XX---------------E-Q---QQQ--?Q--------------------<>--------------------SSSSSSSS-----------<>---------E----------E-----------------------SSS----------<>--------------------------------------Q---------------------------------------SSSSS------------XX-XXXXX----------
--------------XXX----------------------------------E--E----------[]------------E------ESSS--SSS-------<>--[]--------<>---------<>------------------------------------[]-----------------------------------------------------------------------------------------------XXXXXXXX----------
-------------XXXX---------------------------------<>-------------[]--------XX-->---X-SSSSSS--SS-------[]--[]--------[]---------[]----<>------------------------------[]----------------------------------------------------------------------------------------------XXXXXXXXX----------
-E-EE------E-XXXX------------------------------E--[]-------------[]-----------[]--XX--S------S--------[]--[]----EE--[]-----E-E-[]----[]------------------------E-----[]-------------E---------------------------------E--------------E-EEEE-----------------EE-E-----XXXXXXXXX----------
XXXXX--XXXXXXXXXXXXXXX--XXXXXXXXXXXXXXXXXXXXXXXXXXXXXXXXXXXXXXXXXXXXXXXXXXXXXXXXXXXXXXXXXXXXX-XXXXXXXXXXXXXXXXXXXXXXXXXXXXXXXXXXXXXX-XXXXXXXXXXXXXXXX---XXXXXXXXXXXXXXXXXXXXXXXXXXXXXXXXXXXX-------XXXXXXXXXXXXXXXXXXXXXXXXXXXXXXXXXXXXXXXXXXXXXXXXXXXXXXXXXXXXXXX-XXXXXXXXXXXXX-X-XXXXX
