----------------------------------------------------------------------------------------------------------------------------------------------------------------------------------------------------------------------------------------------------------------------------------------
----------------------------------------------------------------------------------------------------------------------------------------------------------------------------------------------------------------------------------------------------------------------------------------
-----------------------------------------------------------------------------------------------------------------------------------------------------------------------------------<>---------------------------------------------------------------------------------------------------
-----------------------------------------------------------------------------------------------------------------------------------------------------------------------------------[]---------------------------------------------------------------------------------------------------
--------------E--------------------------------------------------------------------------------------------------------------------------------------------------------------XXX---[]---------------------------------------------------------------------------------------------------
-XXXX----------------------------------------XX--------------------------------------SSS---SS-----------------------------------XXX----------X-X------------------------E------------------XXXX----------------------------------------SSSSS---------------------------------------XXX--
---------------------------------------------XX--------------------------------------------------------------------------------XXXX-------------------------------------XXX---XX-------------------------------------XXX----------------------------------------------------------------
-----------------------------S--------------XXX-------------------------------------------------------------------------------XXXXX-----------------------------------------------------------------------------------------------------------------------------------------------------
----------------------------SS-------------XXXX------------------------------------------------------------------------------XXXXXX--------------------------------------------------------------------------------------------------------------------E--------------------------------
----------------------S--S--E---------X-----XXXX--X----------E---E------E----------E--SSS---------------------------------XX-XXXXXX---X---------------------------------X-XX------------XXXXSX-------X-----------------------?SS-----SS--SS-----------<>----X-------------XXXXX---------
------------X--------------->-------------XXXXXX--X---------<>---E-----<>---------<>------------------X--------->---------XXXXXXXXX---X-----------------------------------XX-------------------------X---------------------------->-------------------[]--------------------------------
------------X---------------]------------XXXXXXX--X----X<---[]---------[]----<>---[]------------------X--------->--------XXXXXXXXXX---X----X------------------------------XX------------------------XXX-----------------------------------------------[]--------------------------------
-----EE-E---X--------EEE-E--]-----------XXXXXXXX--X----X[]--[]-----E-E-[]----[]---[]------------------X---------EE-E-----XXXXXXXXXX---X----X------------------------------XX------------------------XX--------------------------------------------E---[]--------------------------------
X----XXXXXX-XXXXXXXXXXXXXXXXXXXXXXXXXXXXXXXXXXXX-XXXXXXXXXXXXXXXXXXX---XXXXXXXXXXXXXXXXXXXXXXXXXX--XXXXXXXXXXXXXXXXXXXXXXXXXXXXXXXXX-XXXXXXXXXXXXXXXXXXXXXXX--------XXXX------------------XXXXXXXXXXXXXXXXXXXXX--XXXXXXXXXXXXXXXXXXXXXXXXXXXXXXXX-----XX-XXXXXXXXX---XXXXXX----XXXX-XXXX
