----------------------------------------------------------------------------------------------------------------------------------------------------------------------------------------------------------------------------------------------------------------------------------------
----------------------------------------------------------------------------------------------------------------------------------------------------------------------------------------------------------------------------------------------------------------------------------------
----------------------------------------------------------------------------------------------------------------SSSSSSSSSSSSSSSSSSSSSSSSSSSS--------------------------------------------------------------------------------------------------------------------------------------------
------------------------------------------------------------------------------------------------------------------SS-SSSSSS-------------------------------------------------------------------------------------------------------------------------------------------------------------
--------------------------------------------------------------------------------------XXX-------------------------SS--SSSSS------------------------------------------------------------------------------------------------------E--XXX-------------------------------------------------
---------------------------------------??SS-----------------------------------------?--S-------------S?SSSS------SSSS-SSSSS---------------SS-----------------SSS--------SSS--------------------S--------------------------------S---------------------SSS-----------------------------XX
----------------------------------------------XX----------------------------------------------------------------------------------------------------------------------------------------------------------------------------------------------------------------------------------------
-----------------------------------------------------------------------XXXXX----------------------------------------------S----------------------------------------------------------------------------------------------------------------------------------------------XX----X--------
--------------------------------S---------------------E--------------------------------X----------------------------E-----S-----------------------------------------------------------------------------------E------------E------------------------------------------------------------
-----------------------------X-----------------------<>----------------------------E-XXXX---------E----XXX---XXX---SSSSSSSSS-----------------XXXX-------------XX--------SSSQ?-------------XX-------------S---<>-----E-----<>----XQQQ--------------EXXX----------------------------SS----
-----------------------------X-----------------------E------------------E---------<>-------E---EXX----------------SSSS--SSS--------<-------X-----------------------------------E----X-----XX-----------------[]----<>-----[]-----------------XXXXXXXX-----------------------------------
-XX-------------------------XXX----------------------------------------<>----------[-----XXX---------------------SSSSS-S-SS--------[]------X----------------------------------<>----------XX-----------------[]----[]-----[]-----------------------XX-----------------------------------
----------------------------XXX--------------------------E--EE----EE--E[]---------E[---------------XX---X-X-------SSS--SSSS--------[]------X----------------------------------[]-------XX-XX-----------------[]----[------[]---X------------------------------E--E--E-E-----------E--E--
XXX----XX----XXXXXXXXXXXXXXXXXXXXXXXXXX---XX-XX-XXXXXXXXXXXXXXXXXXXXXXXXXXXXXXXXXXXX----------------XXXXXXXXXXX-XXXXXXXXXXXXXXXXXXXXXXXXXXXXXXXX-XXX---XXXXXXXXXXXXXXXXXXXXX-XXXXXXXX--XXX------XXXXXXXXXXXXXXXXXXXXXXXXXXXXXXXXXXX-----XXXXX---------------XXXXXXXXXXXXXXXXXXXXXXXXXXXX
