----------------------------------------------------------------------------------------------------------------------------------------------------------------------------------------------------------------------------------------------------------------------------------------
------------------------------------------------------------------------------------------------------------------------------------------------------------------------X---------------------------------------------------------------------------------------------------------------
-----------<>---------------SSSSSSSSSSSSSSSSSSSSSSSSSSSS----------------------------------------------------------------------------------------------------------------SS--------------------SSSSSS------------------------------------------------------------------------------------
-----------[]------<>-------SSSS-SSSSSSS------------------------------------------------------------------------------------------------------------------------------------------------------------------------------------------------------------------------------------------------
----XXXX---[]-------]-------SSSS--SSSSS-------------------------------------------------------------------------------------------------------------------------------------------------------------------------------------------------------------------------------------------------
E-------------------XXXX-----SSS--SSSSS----------------------------XXX--------------S-----------------------------------------------------------------------------------X-----------S----------------------------------------------------------X----------------------------------------
XXXX-XX?-----------------X---S-----------------------------------------------------------------------------------------------------------------------------------------------------------------------------------------------------------------X-----------------------------XX---------
--X-----------------------------------S----------------------------------------------------------------------------------------------------------------------X-----------------------------------------------------X--------------------------XX----------------------------XXX---------
--------------------------------E-----S------------S------------------------------XX------------------------------------------------------------------------XXX-------------------E---------------------------------------------------------XXXX---------------------------XXXX---------
X--X------------XXXXXX---------SSSSSSSSS--------E------X-X--------------------------SQQQ--------------XX--------------------------------------------Q-------XX---------------E---<>-----E---------------------------------------------------XXXX--------------------------XXXXX---------
--XX-------------------------SSSSS--SSS--------<>------X-X-------------------------------------------XXX------------------E-----E---------------------------XX--------------<>---[]----<>---E------E--------------------------------------XXXXXX-------------------------XXXXXX---------
---X------------------------SSSSSSS-SSS--------[]------X--------------------------------------------XXXX-----------------<>------------------------------XXXXX--------------[]---[]----[]--<><>---<>---------------X---------------------XXXXXXX------------------------XXXXXXX---------
----------------------------SSSSS-SSSSS--------[]----XXX-X-----------------------------------------XXXXX-----------------[]-----------------E--E--------XXXXXX--------------[]---[]E-E-[]--[][]---[]----------EE--EX----------EE---E----XXXXXXXX--------E--E----------XXXXXXXXX---------
----------------------------XXXXXXXXXXXXXXXXXXXXXXXXXXXX------XXXXX---XX--XXXXXXXXXXXXXXXXXXXXXXXXXXXXXXXXXXXXXXXXXXXXXXXXXXXXXXXXXXXXXXXXXXXXXXXXXXXXXXXXXXXXXX----XXXX-XXXXXXXXXXXXXXXXXXXXXXXXXXXXXXXX-XXXXXXXXXXXXXX--XXXXXXXXXXXXXXXXXXXXXXXXXX-X--XXXXXXXXX----XXXXXXXXXXX---XXXXX
