----------------------------------------------------------------------------------------------------------------------------------------------------------------------------------------------------------------------------------------------------------------------------------------
----------------------------------------------------------------------------------------------------------------------------------------------------------------------------------------------------------------------------------------------------------------------------------------
----------------------------------------------------------------------------------------------------------------------------------------------------------------------------------------------------------------------------------------------------------------------------------------
--------------------------------------------------------------------------------------------------------------------------------------------------E-------------------------------------------------------------------------------------------------------------------------------------
--------------------------------XX-----------------------------------------------------------------------------------------------E------------XXXXXXX-----------------------------------------------------------------------------------------------------------------XX----------------
-----------------------------------------------------------------------------------------------------------------------------E-------------------------------XXXX---------XX------------------------------------------------------------------------------------------------------------
----------------------------------------------------------------------------------------------------------------------XX------------XX--X-----------------------------------------------------------------------------------------------------------------------------------------------
-------------------------------------------------------------------------XX-------------------------------------------------------------------------------------------------------------------------------------------------------------------------------------------------------------
-------------------------------------------------------------------------XX---------------------------------------------------------------XX---XXXX--------------------S--------------------------------------------E---------------------------E---------------------------------------
----------------E-----------XQQ--------------XEXXX----------------------XXX-----------------------------------E---XX------------XSS-----------XXX--------------------------------------------------------E---------<E----------------E---------<>----------E---------------Q------------
---------------<>------------------------XXXXXXXX----------------------XXXX----------X-----------------------<>--XXX------------------------------------------------XXXX--------------------------------<>---------[>---E-----------<>---------[]------E--<>----------E-----------------
---------------[]------------------------------X----------------------XXXXX----------------------------------[]--XXX------------------------------------------------------------------------------------[]---------[]---------------[]---------[]-----<>--[]---------<>-----------------
----E----------[]-----------------------------------------------------XXXXX----------X-----------------------[]---XX---------------------------------------------XX-------------E---E----------E-E------[]---------[]---------------[]---------[]-----[]--[]---------[]-----------------
XXXXXXXXXXXXXXXXXXXXX--X-XXXXXXXXXX---XXXX-----XXXX-XXXXXXXXXXXXXXXXXXXXXXXX-------XXXXXXXXXX------X--------XXXX--------------------------------------------------------XXXXXXXXXXXXXXXXXXXXXXXXXXXX-XXXXXXXXXXXXXXXXXXXXX-XXXXXXXXXXXXXXXXXXXXXXXXXXXXXXXXXXXXXXXXXXXXXXXXXXXX----XXXXX
