----------------------------------------------------------------------------------------------------------------------------------------------------------------------------------------------------------------------------------------------------------------------------------------
----------------------------------------------------------------------------------------------------------------------------------------------------------------------------------------------------------------------------------------------------------------------------------------
SSSSSSSSSSSSSSSSSSSSSSSSSSSS-----------------------------------------------------------------------------------------------------------------------------------------------------------------------------------------------------------SS-----------------------------------------------
---------------------------------------------------------------------------------------------------------------------------------------------------------------------------------------------------S------------------------------------------------------------------------------------
---------------------------------------------------------------------------------------------------------------------------------------------------------------------------E---------------------SSS--------------E---------------------------------------------------------------------
-S--------------------------------------------------XXX-----------------------------------------------------------------------------------------------------------------S-SSSSSSS------------------------------------------------SSS---SSS----------------------------------------------
----------------------------------------------------------------------------------------------------------------------------------------------------------------------------------------------------------------------------------------------------------------------------------------
-S-----------------------------------------------------------------------------------------------------------------------------X--------------------------------------------------------------------------------------------------------------------------------------------------------
------------------------------------------------------------------------------------------------------------------------------XX------------------------------------------EE---------------------------------------------------------------------------E--------------------------------
SSSS----S-S------X-XX-----------------------X------------------------------------SSS------------------------------------------XX-------------------------------------SSSSXS?SS------------XX------XX----------------------SS-S-Q---SS--SSSS-----------<>---------E----------E-----------
[----------------X-XX-X--------------------XX------------------------------------------------------------E-------------------XXX-----------------------------------------------E---EX-----X---------------------X---------------------------------X---[]--------<>---------<>-----------
]--------------XXXXXX----------------------XX------------------------------------------------------<-----------------------XXXXX----------------------------------------------S>--------X-X]--------------------X---------------------------------<>--[]--------[]---------[]---------XX
]-----E-------XXXX-XX------------------E--XXX-------------------E--------------------EE-EE----EE--E[]----------E----------XXXXXX-------------X-----EEE-------------E----------[]-------XX-X]E-E---XX--------E---XE-------E-E----------------------[]--[]--------[]---------[]---------XX
XXXXXXXXXXXXXXXXXXXXX-XXXXXXXXXXX-XXXXXXXXXXXXXXXX---XXX----XXXXXX--XXXXXXXXXXXXXXXXXXXXXXXXXXXXXXXXXXXXXXXXXXXXXXXXX-XXXXXXXXXXXXXXXXXXXXXXXXXXXXXXXXXXXXXXXXXXXXXXXXXXXXXXXXXXX--XXXXXXXXXXXXXXXXX-----XXXXXXXXXXXXXXXXXXXXXXXXXXXXXXXXXXXXXXXXXX-XXXXXXXXXXXXXXXXXXXXXXXXXXXXXXXXXXXX
