----------------------------------------------------------------------------------------------------------------------------------------------------------------------------------------------------------------------------------------------------------------------------------------
----------------------------------------------------------------------------------------------------------------------------------------------------------------------------------------------------------------------------------------------------------------------------------------
----------------------------------------------------------------------------------------------------------------------------------------------------------------------------------------------------------------------------------------------------------------------------------------
-----------------------------------------------------------------------------------------------------------------------------------------------E----------------SSSSSS------------------------------------------------------------------------------------------------------------------
---------XXX---------------------------------------------------------------------------------------------------------------------------------XXXX---------------SSSSS-------------------------------------------------------------------------------------------------------------------
-----------------------------------QQ-QQQQ--------------------------------XX------------------------------XXXX-------------------------------------S-----S-----SSSSSSS----XX-------------------------------------------------------------------X------------SSSSSSSSSS------------------
----------------------------------------------------------------------------------------------------------------------------------------------------------------------------------------------------------------------------------------------EX----E-----------------------------------
---------------------------------------------------------------------------------------------------------------------------------------------------------------------------------------------------------------------------------------------XXXXXXX-E----------------------------------
----------------------------------------------------------XXXX--------------------------------------------------------------------------------E---------------------------------------------------------------------XSSS--------------------X------------------E-------------------E----
-------------------------S--------QS?-QSSQQQ---------<>-------------XXX----------X--------------------X-----------------------------------E-XXXXX-------------XXXX----XX-------------------------------------------------------------------X-----------------?SSS--SS-------------<>----
----------E------------------------------------------[]--------------------------XX---------------XX----------------------E--------------<>--------X---EXX----XX--------------------X------------------------E------------X----------E-----XXX-------E-----<-------S----------X---[]----
---------<>------------------------------------------[]--------------------------X-------------------------------------------------------[]-------S>----------XX--------------------X---------------<>------------XXXX----X---------<>--------------<>-----[----------------X-X---[]----
-----E---[]--------------EE--------------------E-----[]----------------------------------------------------------------E-EE--------------[]-------[]-------XX-XXX---------------E-XXX------------EEE[]-----------XXXXX----X------EE-[]----EE--EE----[]-----[------------------X---[]----
XXXXXXXXXXXXXXXXXXX---XXXXXXXXXXXXXXX--XXXXXXXXXXXXXXXXX-----XXX-------XXXXXXXXXXXX----------XXX----------------XXXXXXXXXXXXXXXXXXXXXXXXXXXXXXX--XXXXXXXXXXXXXXXXXXXXXXXXXXXXXXXXXXXXXXXXXXXXXXXXXXXXXXXXXXXXXXXXXXXX--XXXXXXXXXXXXXXXXXXXXX-XXXXXXXXXXXXXXXXXXXXXXXXXXXXX-XXXX-XXXXXXXX
