----------------------------------------------------------------------------------------------------------------------------------------------------------------------------------------------------------------------------------------------------------------------------------------
----------------------------------------------------------------------------------------------------------------------------------------------------------------------------------------------------------------------------------------------------------------------------------------
---------------------------------------------------------------------------------------------------------------------------------------------------------------------S------------------------------------------------------------------------------------------------------------------
-----------------------------------------------------------------------------------------------------------------------------------------------------------------------------------------------------------------------------------------E----------------------------------------------
-----------------------------------------------------------------------------------------------------------------------------------------------------------------------------------------------------------------------------------------XXX--------------------------------------------
X---------------------------------------------------SSXX----------------------SSS--------------------------------------------------------XXX-------------------------------S----S--------------SSSS------------------------------------------QQ----------SSX----------------------------
----E-----------------------------------------------------------------------------------------------------------------------------------------------------------------------------------------------------------------------------------------------------------------------------------
----------------------------------------------------------------------------------------------------------------------------------------------------------------------------------------------------------------------------------------------------------------------------------------
------------------------------------------------------------------------------------------------------------------------------------------------------E------------------------------------------------------------------------------SSS----------------------XXX-----------------------
X-------------XXXXXX--------------------QQQQ--------S---XXXXX-------------XXXX------------------XX----------------------------------SS-SS------------<>---------------------------------------------------------X--------------------------E-QQQQ------SS---------------SSS-------------
---------------------------------------------------------------E---EXX-------------------------XXX---------------------------------------------------[]--------------------------------------------------------XXX----------------------------------------------------------------------
--------------------------------------------------------------X>----------X-------------------XXXX---------------------------------------------------[------------------------------------X--------------------XXX----------------------------------------------------------------------
--------------------------------------------------------------[]-------XX-------------------XXXXXX-E------E-EE-E-------------------------------------[------------------------------------E---------------E-EXXXXX--------E-EE-E---------E--------E-------------------------------------
-----------X------------XXX-XXXXXXXXXX-XXXXXXXXXXXXXXX-XXXX---XXXXXXX--XXXXXXXX--XXXX-XXXXXXXXXXXXXXXXXXXXXXXXXXXXXXXXXXXXXXXXXXXXXXXXXXXXXXXXXXXXXXXXXXXXXXXXXXX----XXXXXXXXXXXXXXXXXXXXXXXXXXXXXXXXXXXXXXXXXXXXXXXXXXXXXXXXXXXXXXXXXXXXXXXXXXXXXXX---XXXXXXXXXXXXXXXXX----XXX---------
