----------------------------------------------------------------------------------------------------------------------------------------------------------------------------------------------------------------------------------------------------------------------------------------
----------------------------------------------------------------------------------------------------------------------------------------------------------------------------------------------------------------------------------------------------------------------------------------
-----------------------------------------------------------------------------------------------------------------------------------------------SSSSSS-----------S-------SSSSSSSSSSSSSSSSSSSSSSSSSSSS------------------------------------------------------------------------------------
----------------------------------------------------------------------------------------------------------------------------------------------SSSSSSSSSSSS------------SS----------------------------------------------------------------------------------------------------------------
-----------------------------------------------------------------------------------------------------------------------------------------------SSSSSSSSSS-------------S-----------------------------------------------------------------------------------------------------------------
-----------?SSS-----XXX-------XXX------------------------------------------------------------------------------------------------S-------------SSSSSSSSSSSSS----S-----SS---------------------------------------------XXXXXXX------------------------------------------------------------
------------------------------------------------------------------------X-------------------------------------------------------------------EE------------------------------------------------------------------------------------------------------------------------------------------
--------------------------------------------------------------------------------------------------------------------------------E--------------------------------------------------------S----------------------------------------------------------------------------------------------
-XXXXX--------------------XX-----------------------------------------------------------------------------------------E---------<>---------------E------------------E--------------E------SSS------------X-X-----------------------------------------------------------------------------
------------SS------------------------------------------------------------------S-SQ--------------------------------<>---------[]----------E----SSSSSSSS----------<>----<>-S----S<>------X--X------X-----------------------------------------------------SS--------------XXXX-----------
-X----------------------X--S----------------------------------------------------------------------------------------[]---------[]----E----<>--E-------------------[]----[]--------]------X-XX-X----X---------------------------------------------------------------------X--------------
--------------------------------------------------------------------------------------------------------------------[]---------[]---<>----[]-SS--X------------<---[]----[]-------[]---X-<>-XX------X--------------------------------------------------------------------XX--------------
XX----------------------------------E---E----------E-EE---------E----E---------E---------------------------------E--[]-----E---[]---[]----[]-[]------E--------EE--[]----S-----E--[]--EX-[]-XX------X-----------------------------------E-EE----------------------------XXX----------E---
------XX-XX-----------------XXXXXXXXXXXXXXXXXXXXXXXXXXXX-----XXXXXXXXXXXXX--XXXXXXXX-----XXXXX--XXXXXXXXXXXXXXXXXXXXXXXXXXXX-XXXXXXXXXXXXXXXXXXXXXXXXXXXXXXXXXXXXXXXXXXXXXXXXXXXXXXXXXXXXXXX--XXXXXX------------------XXX-------XXXXXXXXXXXXXXXXXXXXXXXXXXXX---XX---XXXXXX-----X-X--X---
