----------------------------X-----------------------------------------------------------------------------------------------------------------------------------------------------------------------------------------------------------------------------------------------------------
-------------------------------------------E----SSS----S--------------------------------------------------------------------------------------------------------------------------------------------------------------------------------------------------------------------------------
------------------------------SSSSSSSSSS--<>----SSSSSSSS--------------------------------------------------------SSSSSSSSSSSSSSSSSSSSSSSSSSSS------------------------------------------------------------------------------------SSSSSSSSSSSSSSSSSSSS------------------------------------
------------------------------SSSSSSSS---SS]----SSSSSSSS--------------------------------------------------------SSSSSSSSSS------------SS------------------------------------------------------------------------------------------------------------------------------------------------
---------------------------->SSSSSSSSS----SS----SSSSSSSS--------------------------------------------------------SSSSSSSSSS?------------S------------------------------------------------------------------------------------------------------------------------------------------------
-----------??SS-------------?--SSSSSS----SSS-??SSSSSS-SS---------------------------------------------------------SSSS--SS----S---------SS----SSS---SSSS---------------S------------------------XX------------------XXX------------------------------------------------------------------
------------------------------------------------------------------------------------------------------------------------------------------------------------------------------------------------------------------XXXX------------------------------------------------------------------
------------------------------------------------------------------------X---------------------------XXXX---------------------------------------------------------------------------------------------------------XXXXX------------------------------------------------------------------
-XSSSSSSS-----------------E--?EX--------------------------------------XXX--------------------------------------------------------------SS-----------------------------------------------------------------------XXXXXX---------------------------------E--------------------------------
------------SSS----------<>-SXXX?SSS------E---XEXX---XXX-------------XXXXX--------------------------------------SSSSSSSSSSS--------E?----------SS-SSSSS--------------------------------E----------------------XXXXXXXX---------ESS-S----SQS-----------<>-------------------X-----------E
-X-----------------------[]-----SSSSSS-EXX----<>---------------------XXXXX-----------------------------------------SS-SSSS--------<>X-------------------------------------------------EXXX--------------------XXXXXXXX--------<>-------------------X--[]-------------------X----------<>
-------------------------[]----SSSSSS-------X-[]-------------------XXXXXXX-----------------------------------------SSSSSSS------<X[]X-------------------------->---------------------------------------------XXXXXXXXX---X----[]----------------<>-X--[]------------------XXX---------[]
XX-------E---------------[]------SSSS-------X-[]E-E---XX----------XXXXXXXX------E-----E-EE--E-EEE-EE---------E-EE--SSSSSSS------[][]X-------------------------E]------------------------------------EE-E----XXXXXXXXXX---X--E-[]E-----E---------[]----[]---------------E--XX----------[]
---XXXXXXXXXXXXXXXX-XXXXXXXXXX----XXXXXX---XXXXXXXXXXXX-XXXXX---XXXXXXX--XXX-X--X--XXXXXXXXXXXXXXXXXXXXXXXXXXXXXXXXXXXXXXXXXXXXXXXXXXXXXXXXXXXXXXXXXXXXXXXXXXXXXXXXXXXXXXXXXXX--XXXXX---------------XXXXXXXX-XXXXXXXXXXXXXXXX-XXXXXXXXXXXXXXXXXXXXXXXXXXXXXXXXXXXXXX--XXXXXXXXXXXXXXXXXX
