----------------------------------------------------------------------------------------------------------------------------------------------------------------------------------------------------------------------------------------------------------------------------------------
----------------------------------------------------------------------------------------------------------------------------------------------------------------------------------------------------------------------------------------------------------------------------------------
--------------------------------------------------------SSSSSSSSSSSSSSSSSSSSSSSSSSSS------------------------------------------------------------------------------------SSSSSSSSSSSSSSSSSSSSSSSSSSSS------------------------------------------------------------------------------------
----------------------------------------------------------------------------------------------------------------------------------------------------------------------------------------------------------------------------------------------------------------------------------------
----------------------------------------------------------------------------------------------------------------------------------------------------------------------------------------------------------------------------------------------------------------------------------------
----------------S----------------------------------------S-------------------------------------?SSS----------------------------------------------------------------------------------------------------------------------------------------------S--------------------------------------
----------------------------------------------------------------------------------------------------------------------------------------------------------------------------------------------------------------------------------------------------------------------------------------
-------------------------------------------X-------------S-------------------------------------------------------------------------------------------------------------------------------S-----------------------------------------------------XX---------------------------------------
----------------E-------------------------XX----------------------------------------XXXXXX--------------------XX-------------------------------------------------------------------------XXS-----------------------------------------E---------X-----------------E----------E-----------
-----E---------<>----------E--------------XXX-----------SSSS----S-S------X-XX------X--------?---SSS----------X-----------------------------------------------SSSS-------SS------Q-S------X--------------------------------S-------------------------------------<>---------<>----------E
----[]---------[]-----[]--<>-------------XXXX-----------[----------------X-XX-X----X------------------------XXXX-----------------XXX------------------------------------[----------------X-X------------------------E----------------E----------E----E-----<----[]---------[]---------<>
----[]---------[]-----[]--[]-----------XXXXXX--------------------------XXXXXX------X-------------------------------------------XXXXX-------X----------------------------]-------------XX[X-XX----------------------<>---------------<>---------<>---<>-----[----[]---------[]---------[]
-E--[]-----E-E-[]-----[]--[]---E------XXXXXXX-----------]-----E-------XXXX-XX------X----------------------------------E-------XXXXXX------XX----------------------------E-----E------XXX[X-X----------E-EE----E----[]----------E-E--[]-----E--E[]---[]-----[----[]---------[]---------[]
XXXXXXXXX-XX---XX-XXXXXXXXXXXXXXX--XXXXXXXXXXXXXXX--XXXXXXXXXXXXXXXXXXXXXXXXX-XXXXXX----XXXX-----XXXXXXXXXXXXX--XXXXXXXXXXXXXXXXXXX---XX--XX-------XXXXX-XXXXXXXXXXXXXXXXXXXXXXXXXXXXXXXXXXXX--XXXXXXXXXXXXXXXXXXXXXXXXXXXXXXXXXXXXXXXXXXXXX-XXXXXXXXXXXXXXX-XXXXXXXXXXX-X-XX-XXXXXXXXXX
