------------------------------------------------------------------------------------X---------------------------------------------------------------------------------------------------------------------------------------------------------------------------------------------------
----------------------------------------------------------------------------------------------------------S-----------------------------------------------------------------------------------------------------------------------------------------------------------------------------
------------------------------------------------------------------------------------SSSSSSSSSSSSSSSSSSSSSSSSSSSS------------------------------------------------------------------------------------SSSSSSSSSSSSSSSSSSSSSSSSSSSS--------------------------------------------------------
------------------------------------------------------------------------------------SSSSSSSSSSSSSSS------SSS--SS------------------------------------------------------------------------------------SSSSSSSSSSSS--------------SS--------------------------------------------------------
------------------------------------------------------------------------------------SSSSSSSSSSSSSSS------SSS--SS--------X----------------------------XX---------------------------------------------SSSSSSSSSSS---------------S---------------------------------------------------------
--------------------------------SSSSSSSSS--S-----------S------------------X----------SSSSSSSSSSS-SSS----------SS-----------------XXX----------------------Q---------XXXX----------------------XXXXX-SSSSSSSSSSS--SS-----------S-S-------------------------------------------------------
-------------------------------------------------------------------------XX---------ES-S------------------------------------------------------------------------------------------------------------------------------------------------------------------------------------------------
-----------------------------------------------------------------------XXXX-------------------S--------------------------------------------------------------------------------------------------------------------------------------------------------------------------XX-XXXX--------
----S-SSS-------------------------------------------------------------XXXXX-------------E-----S------------S?------XXXX--------------------------SSS-----------------------------------------------------------------------E------------------------------------------------------------
------------S?S-----------E------SSSSSSS-----------------------------XXXXXX------------SSSSSSSSS---------------X------------XX---------------------------QQQQ----S-SS-----------------XXX------------SSSSSSSSSS--------E--------QQQQ--------------XXXX----XX----------------------SS----
-------------------------<>------------------------E-----------------XXXXXX----------SSSSSSSSSS--------<>------X-------------------------EX-----------------------------------------------------------SSSSSSSSS-------<>---E-----------E-----XXX-XXXX-----------------------------------
-------------------------[]-----------------------<>---------------XXXXXXXX---------SS?SSSSSSSS--------[]------X-------------------------XX----------------------------------------------------------SSSSSSSSSS-------[]--<>---X------<>----------XX------------------------------------
-------E-E---------------[]--------------------EE-[]--------------XXXXXXXXX-----E--XSSSSSSSSSSS--------[]----XXX-------------------------------------E--------E--------------------------------------SSSSSSSSSS-------[]--[]--XX------[]-------X--XXX---------E--E--E-E-E---------E--E-E
XXXXXXXXXXXXXXXXXXXXXXXXXXXXXXXXXXXXXXXXXXXXXXXXXXXXXXXXXXXXXXX--XXXXXX--XXXXXXXX-XXXXXXXXXXXXXXXXXXXXXXXXXXXXXX-------XXXX-----------------XXXXXXXXXXXXXXXXXXXXXXXXXX-XXXXXXXX---XXXXXXXXXXXXXXXXXXXXXXXXXXXXXXXXXXXXXXXXXXXXXXXXXXXXXXXXXXXXXXXXXXXXXXXXXXXXXXXXXXXXXXXXXXXXXXXXXXXXXX
