----------------------------------------------------------------------------------------------------------------------------------------------------------------------------------------------------------------------------------------------------------------------------------------
----------------------------------------------------------------------------------------------------------------------------------------------------------------------------------------------------------------------------------------------------------------------------------------
SSSSSSSSSSSSSSSSSSSSSSSSSSSS--------------------E-------------------------------------------------------------------------------------------SSSSSSSSSSSSSSSSSS-----------------------------------------------------------------------------<>-------------------------------------------
----------------------------XEEE--E------------<>---------------------------------------------------------------------------------------------S----SSSS------------------------------------------------------------------------------------[]-------------------------------------------
-----------------------------XXXXXXXX----------[]------------------X-------------------------------------------------------------------------------SSSS-----------------------------------------------------------------------------XXXX---[]-----------------------------E-------------
-----------------XX---------?----------------XXXXXX-----------------------------------------------------------------------------------XXXXX----S--SSSSS-----------------------SQQQQQQQQ----------SSS--S-------------------------E----------------XXXX-----------------------------------
-----------------XX-------------------------------------------------------------------------------------------------------------------------------------------------------------------------------------------------------------XXX----?------------------------------------------------
-S---------------XX-----------------------------------------------------------------------------------------------------------------------------------S---------------------------------------------------------------------------------------------------------------------------------
SS--------------XXX------------------------------------S--------------------------------------------XX------------------------------------------E-----S----------------------------------------------------------------------------------------------------X----------------------------
SS--------S-----XXXX--X-----XXXXX------------XXXXX--------------------------------E-----------------X--------------------------X---------------SSSSSSSS-------------------E---Q--SQSQQ-?-Q----------SQSQS-------------XX--------X-XX------------XXXXX----------------------------S------
[-------------X-XXXXX-X----X-----------EXX------------XX----------E--------------<>---------------XXX----------------------------------------SES-----SS--------E---E-----<>-------------------------------------------X----E------XX------------------------------------X---------------
]------------XXXXXXX--X----X-------X-----------------------------<>--------------[]--------------XXXXX---------------------------------------SSSSS---SS-------<>--<>-----[]-------------------------------------------X---<>-------X------------------------------------X---------------
]-----------XXXXXXXX--X----X---------------------XX----------E---[]--------------[]--E-E--------XXXXXX---------------------------------------SS------SS-------[]--[]-----[]----------------EE-E-----------------------X---[]-------X--------------------------------E---X--------EEE----
XXXXXXXXXXXXXXXXXXXX-XXXXXXX----------------------------XXXXXXXXXXXXXXXXXXXXXXXXXXXXXXXXX--XXXXXXXXXXXXXX---XXXX--------XXXXX---XXXX-------XXXXXXXXXXXXXXXXXXXXXXXXXXXXXXXXXXXXXXXXXXXXXXXXXXXXXXXXXXXXXXXXXX-XXXX-XXXXXXXXXXXXX----------------------------XXXXXXXXXXXXXXXXXXXXXXXXXXXX
