----------------------------------------------------------------------------------------------------------------------------------------------------------------------------------------------------------------------------------------------------------------------------------------
----------------------------------------------------------------------------------------------------------------------------------------------------------------------------------------------------------------------------------------------------------------------------------------
--------------------------------------------------------------------------------------------------------------------------------------------------------------------------------------------------------------------------------SSSSSSSSSSSSSSSSSSSSSSSSSS------------------------------
----------------------------------------------------------------------------------------------------------------------------------------------------------------------------------------------------------------------------------------------------------------------------------------
----------------------------------------------------------------------------------------------------------------------------------------------------------------------------------------------------------------------------------------------------------------------------------------
--------------------------------------------------------------------------S---XXX------------------------------------------------XX-------------------------------------------------------------------------------------------------------------X------------XXX------------------------
--------------------------------------------------X------------------------------------------------------------------------------XX-------------------------------------------------------------------------------------------------------------X---------------------------------------
--------------------------------------------------------------------------X-----------------------------------------------------XXX-----------------------------------------------------XXXX----------------------------------------------------XX--------------------------------------
--------------------------------------------------------S-----------------X-------------------------------------SS-------------XXXX-------------------------------------------------------------------------------------------------------------XX-S------------------------------------
----------------X---------------------------XX----------X----------------XEX----------------------------------S-X------------XXXXXX---------Q-----------------XX----------------------------------------------------------------<>---------XXX--X-----X---------------------------SSSSSS
---------------XX----------E----------------------------X-------------EXXXXX------------------------------------X------------XXXXXXX----------------------EXXX-------------------------------------------------XXX--------------[]-------X--XXX-X----XX----E----------------------------
--------------XXX---------<>----------------------------]-------------X-XX--------------------------------------]-----------XXXXXXX----------------------------------------------------------------------------XXX--------------[]-------X--XXXXXX---XX---<>----------------------------
-E-E-------E-XXXX---------[]-------------E--------------]----------------------------------E--------------------]---------XXXXXXXXX---------------------------------------E---E-E-EEE-E-------E-EE-E--------EXXXX-EE--------EE-E[]--E-------XXXXXX---XX---[]-----EEEE---E--------E-E----
XXXXXXXXXXXXXXXXXXXXXXXXXXXX--------XXX-XXXXX---XXXXXXXXXXXXXX--XXXXXXX----X-----XXXXXXXXXXXXXXX-XXXXXXXXXXXXXXXXXXXXXX--XXXXXX-XXXX----XXXXXXXX----XXXXXXX---------XXXXXXXXXXXXXXXXXXXXXXXXXXXXXXXXXXXXXXXXXXXXXXXXXXXXXXXXXXXXXXXXXXXXXXXX---XX---XXXXXXXXX--XXXXXXXXXXXXXXXXXXXXXXXXX
