----------------------------X-----------------------------------------------------------------------------------------------------------------------------------------------------------------------------------------------------------------------------------------------------------
----------------------------------------------------------------------------------------------------------------------------------------------------------------------------------------------------------------------------------------------------------------------------------------
----------------------------SSSSSSSSSSSSSSSSSSSSSSSSSSSS-------------------------------------------------------------SSSSSSSSSSSSSSSSSSSSSSS----------------------------------------------------------------------------------------------------------------SSSSSSSSSSSSSSSSSSSSSSSSSSSS
----------------------------SSSSSSSSSSSSSSS-----------SS-----------------------------------------------------------------------------------------------------------------------------------------------------------X--------------------------------------------------------------------
----------------------------SSSSSSSSSSSSSSS-----------SS-----------------------------------------------------------------------------------------------------------------------------------------------------------X--------------------------------------------------------------------
-----------------------------S-S-SSSSSSSSS------------SS-----------------------------------SSSSS-----------------SSS----S------------------------------------------------------------------------------------------XSSS-------------------------S-S-------------------------------------
----------------------------XE-S----------------------------------------------------------------------------------------------------------------------------------------------------------------------------------XXX-------------------------------------------------------------------
--------------------------------------S--------------------------------XX----------------------------------------------------------------------------------------------------------------------------------------XXXX----E---------------------------------------------------------E----
--------------------------------E----?S------------S?-----------------------------------------E------------E------------------------------------------------E----------------E----------E-----------------------XXXXXE------------------------------------------------E-----------<>----
------------------------------E--SSSSSSS---------------X------------------------------E--SS--SS-----------<>----SSSSS---S----------------------------------<>---------------<----------<>------------E---------XXXXXX----------E-E---E----------X--------------S-----<>-----------[]----
------------XX---------------<E--S---SS---------E------X---------------------E-----<-<>------SS-----------[]-----------------------X-------------E---------[]---------------[E---------[]-----------<>---E----XXXXXXX----X----<><>--<>---E-----XX----X--------SS-----[]--------E--[]----
-----------XXX--------------S[]SSS---SS--------<>------X---------------X-----------[-[]------SS-----------[]--------------------<XXXX-----------<>---------[]---------------[]---------[]-----------[]--<>-----XXXXXX----X----[][]--[]--------XXX----XX------S-S-----[]--------[X-[]----
---------XXXXX-------EE-E----[]------SS--------[]----XXX-EE-E-----EE--EE----------E[-[]------ES-----------[]----------E---------[]-X------------[]---------[]---------------[]---------[]-----------[]--[]---X-XXXXXX----X----[][]--[]-----E-XXXX----X]----X------E--[]--------[--[]----
XXXXXXXXXXXXXXXXXXXXXXXXXXXXXXXXXXXXXXXXXXXXXXXXXXXXXXXXXXXXXXXXX-XXXXXXXXXXXXXXXXXXXXXXXXXXXXXXXXXXXXXXXXXXXXXXXXXXXXXXXXXXXXXXXXXXXXXXXXXXXXXXXXXXXXXXXXXXXXXXX--XXXXXXXXXXXXXXXXXXXXXXXXXXX-XXXXXXXXXXXXXXXXX---XXXXXXXXXXXXXXXXXXXXXXXXX--XXX---XXXXXXXXXXXXXXXXXXXXXXXXXXXXXXXXXXXX
