----------------------------------------------------------------------------------------------------------------------------------------------------------------------------------------------------------------------------------------------------------------------------------------
--------------------------------------------------------------------------------------------------------SS-----S------------------------------------------------------------------------------------------------------------------------------------------------------------------------
---------------------------------------------------------------------------------------SSSSSS-----<>----SS----SS------------------------------------------------------------------------------------------------------------------------------------------------------------------------
---------------------------------------------------------------------------------------SSSSSS-----[]----SS--SSSS------------------------------------------------------------------------------------------------------------------------------------------------------------------------
-------------------------------XXX-----------------------------------------------------SSSSSS------]----SSS-SSSS------------------------------------------------------------------------------------------------------------------------------------------------------------------------
-----------------------X---------------------SSSS-----------------------------------S-SSSSSSSS---SSS---SSS-----S----------------------------------------------------------------------------------------SSSSQQSSS--------------S---------------X--------------XX------------------------
----E------------------------------------------------------------------------------------------------------------------------------------------------------------------------------------------------------------------------------------------X----------------------------------------
-------------------------------------------------------------------------X-----------------------------------------------------------------------------------------------------------------X--------X-----------------------------------------XX----------------------------------------
------------------------------------------------------------------------XX------------EE-----------------------------------------------E------------------XX---------------------------------------------------------------------------------XXX----------------------------------------
X--------------EXXXX---------XXXX--------------X-X----X----------------XXX----------SXS?SSSS------E----E-----XXX---------Q------E-----<>---E------------XXXX----------------------------------S----------SSSSSSSQQ-----------X---------------XXX----------------------------------------
X-------------EXXX-X---------------E---EXX----------------------------XXXX--------------SSSSS--EX-----<>-----------------E-----<>-----[]--<>----------XXXXXX-----------------E----E-----E------------------------------------X------------XXXXXX----------------------------------------
X---------------------------------XX------------------X--------------XXXXX--------------SSSS--------X-[]------X----------------[]-----[]--[]---------XXXXXXX----------------<>----E----<>------------------------------------XX-----------XXXXXX----------------------------------------
-------------------------------------------XX----XX--------E--------XXXXXX--------------------------X-[]E-E--XXX---------------[]-----[]--[]--------XXXXXXXX--------E-------[]----E----[]---------EE-------------------EE-E--XX--E-E-----XXXXXXXX-------------------E-E-E---------------
XXXXXXX---XXXXX---XXXXXXXXXXXXX---XX--------------------XXXXXX-XXXXXXXXXXXXX----XXXXXXX--XXXXXXXXX-XXXXXXXXXXXXXXXXXXXXXXXXXXXXXXXXXXXXXXXXXXXXXXXX-XXXXXXXXXXXXXXXXXXXXXXXXXXXXXXXXXXXXXXXXXXXXXXXXXXXXXXXXXXXXXXXXXXXXXXXXXXXXXXXXX-XXXXXXXXXXXXXXXXXXXXXXXXXXXXXXXXXXXXXXXXXX-XX-XXXX
