----------------------------------------------------------------------------------------------------------------X-----------------------------------------------------------------------------------------------------------------------------------------------------------------------
--------------------------------------------------------------------------------------------------------------------------------------S-------------------------------------------------------------------------------------------------------------------------------------------------
----------------------------------------------------------------------------------------------------------------SSSSSSSSSSSSSSSSSSSSSSSSSSSS--------------------------------------------------------SSSSSSSSSSSSSSSSSSSSSSSSSSSS--------------------------------------------------------
----------------------------------------------------------------------------------------------------------------SSSSSSSSSSSSSSSS----SSSSSSSS--------------------------------------------------------------------------------------------------------------------------------------------
-----------------------------------------------------------------XXX--------------------------------------------SSSSSSSSSSSSSSSS----SSSSSSSS--------------------------------------------------------------------------------------------------------------------------------------------
----------Q----------------------------------------------------------QQ-----------------------------------------SSSSSSSSSSS--SSS-------SS-SSSSSSS--SSS----------------------------------------------------------------------------------------------------------------------------------
----------------------------------------------------------------------------------------------------------------------------------------------------------------------------------------------------------------------------------------------------------------------------------------
------------------------------------------X-XXXX------------------------------------------------------------------------------------------------------------------------------------------------------------------------------------------------XXXX------------------------------------
-------------------------------------------------------------SSS----------------------------------------------------E------------------S?---------------------------------------------------------------------E-------------------------------------------------------------------------
-------------------------------------------------------------------EQQQQQ---------E---Q--------------------------SSSSSSSSSSS-------E-------X-----------------------------------------------------<>->--S-----<>---------E------X-----------------------------X----------------------SSSS
---------------------------------------------------------------------------------<>-------------------------------SSSSSSSSS-------<>-------------------------------E-----------------------------[]-SSSS-----[]--------<>------X--------------------------------------------------------
---------------------------------------------------------------------------------[]------------------------------SSSSSSSSSS-------[]------------------------------<>-X---------------------------[]-SS-S-----[]--------[]------X----------------------------XX--------------------------
------------------------------E--EE-E-E-E---------EE-E-E---------E---------------[]------------------------------SSSSSSSSSS-------[]------------------------------[]-X---------------------------[]-S-----E--[]--------[]-----XX--E--E--E-E--------------EE-XX-----EEE------------------
XXXXXXXXX--XXXXXXXXXXXXX-XXXXXXXXXXXXXXXXXXXXXXXXXXXXXXXXXXXXXXXXXXXXXXXXXXXX--XXXXXXXXXX---XXXX---XXX-------X-XXXXXXXXXXXXXXXXXXXXXXXXX-XXXXXXXXXXXXXXXX--XXX----X--XXXXXXXXXXXX----XXXXXXXXXXXXXXXXXXXXXXXXXXXXXXXXXXXXXXXXXXXXXXXXXXXXXXXXXXXXXX-XXXXXXXXXX-XXXXXXXXXXXXXXXXXXXXXXXXX
