----------------------------------------------------------------------------------------------------------------------------------------------------------------------------------------------------------------------------------------------------------------------------------------
----------------------------------------------------------------------------------------------------------------------------------------------------------------------------------------------------------------------------------------------------------------------------------------
SSSSSSSSSSSSSSSSSSSSSSSSSSSS---------------------------------SSSSSSSSSSSSSSSSSSSSSSS----------------------------------------------------------------------------------------------------------------------------------------------------------------------------------------------------
----------------------------------------------------------------------------------------------------------------------------------------------------------------------------------------------------------------------------------------------------------------------------------------
----------------------------------------------------------------------------------------------------------------------------------------------------------------------------------------------------------------------------------------------------------------------------------------
-----------------------------XXX------------------------SSS----------------------------------------X-----------------------------------------------------------------------SSSSSSSS------------SSSSS------SSSSSS------------SSSS----------------------------X-------QQSSSS--------------
--------------------------------------------------------------------------------------------------XX------------------------------------------------------------------------------------------------------------------------------------------------------------------------------------
--------------------------------------------------------------------------------------------------XX------------------------------------------------------------------------------------------------------------------------------------------------------------------------------------
----------E-------------------------------------------------------------------------------------XXXX---------------------------------------------------------------------------------------------------------------------------------------------------------XX-------------------------
---S-----<>---------------------------------------SSSSSSSSSSS-------------XXX------X-----------X--XX------------------------X--------------------------------------------------SS------------------------SSS-SS---------------------------------E------------------S?--SSSSS---------<>-
--E------[]--------<E------X-----------------------------------E---------XXXX------X----------XXXXXX-----E-----------------XXX-----------------------------------------------------------------------------------------------------------------<>------------------------------------[]-
---------[]--------<>------X----------------------------------<>--------XXXXX------X----------XXXXXX-----X-----------------XXX-----------------------------------------------------------------------------------------------------------------[]------------------------------------[]-
---------[]--------[]------X-----EEEE---E--------E-E----------[]-------XXXXXX----XXX-E-EE---XXXXXXXX-----X--------------EX-XXX-------EE-EE-E------------EE---------E----------------------E---------------------------EE-----------------------[]------------------------------E-----[]-
XXXXXXXXXXXXXXXXXXXXXXXXXXXXXXXXXXXXXXXXXXXXXXXXXXXXXXXXXXXXXXXXXXXXXXXXXXXXXXXXXXXXXXXXXXXXXXXXXXXXX-XXXXXXXXXXXXXXXXXXXXXXXXXXXXXXXXXXXXXXXXXXXXXXXXXXXXXXX----X--XXXXXXXXXXXXXXXXXXXXXXXXXXXXXXXXXXXXXXXXXXXXXXXXXXXXXXXXXXXXXXXXXXXXXXXXXXXXXXXX--XXXXXXXXXXXXXXXXXXXXXXXXXXXXXXXXX-
