----------------------------------------------------------------------------------------------------------------------------------------------------------------------------------------------------------------------------------------------------------------------------------------
-------------------------------------------------------------------------------------------------------------------------------------------------------------------------------------------------------------------E-----------S--------------------------------------------------------
--------------------------------------------------------------------------------------SSSSSSS-----S-----SSSS--SS--------------------------------------------------------------------------------------------------->-----S-----S--------------------------------------------------------
--------------------------------------------------------------------------------------SSSSSSSSSSSSS-----S-----SS--------------------------------------------------------------------------------------------------[]-----S---S-S------E-------<>----------------------------------------
---------------------------------------------------------------------------------------SSSSSSSSSSSS-----SS----SS---------------------------------------------------------------------------------------EE---------[]-----S---SSS-------XX-----[]----------------------------------------
---------------------------------------------------------------------------------------SSSSSSSSSSSSS----------SS--XX-------------------------------------------------XXX----------------------------?--SSS??S--------??SSS------X------------SS---XXXXX---------------------------------
------------------------------------------------------------------------------------EE--------------------------------------------------------------------------------------------------------------------------------------------------------------------------------------------------
-------------------------------------------------------------------------------------------------------------------------------------------------------------------------------------------------------E--------------------------------------------------------------------------------
---------------------------------E----------E-------------------------------------------E-------------------------------------------------------------------------------------------------------------EX------------------------XXXXXXX--------------------S----------------------------
-------------------------QQ-----<>---------<>-----------------------------------------E-SSSSSSSS-----------------------------------------------------------------SSSSSS------QQ--ES-----E------------XXXXS-------XX----X-X---XXX------------XXX-----------------------------------------
----------E---------------------[]---------[]-----------------------------------------E--------------------E---------------------------------------------------------------------------<>-----------------SE---EX------------XX-------------------------XXXX----------------------------
--------------------------]-----[]---------[]----------------------------------------SS--X----------------<>---------------------------------------------------------------------------[]----------------SSX--------X--------XX---------------------------------------------------------
-------E-EE--------------EE-----[]---------[]----------------------EE--E-------------[]------E--------EEE-[]------E-------E-E------------E---------E-----------------------------------[]-E-------------------------X---X-X--XX---------------------------------------------------------
XXXXXXXXXXXXXXXXXXXXXXXXXXXX-XXXXXXXXXXXXXXXXXXX---XXXXXXXXXXXXXXXXXXXXXXXXXXXXXXXXXXXXXXXXXXXXXXXXXXXXXXXXXXXXXXXXXXXXXXXXXXXXXXXXXXXXXXXXXXXXXXXXXXXXXXXXXXXXXXXXXXXXXXXXXXXXXXXXXXXXXXXXXXXXXXXXXXX----XXX-------XXXXXXXXXXX-----------------XXXXXXX-----XXXXXXXXXXXX--XXXXXXXXXXXXXX
