----------------------------------------------------------------------------------------------------------------------------------------------------------------------------------------------------------------------------------------------------------------------------------------
----------------------------------------------------------------------------------------------------------------------------------------------------------------------------------------------------------------------------------------------------------------------------------------
------------------SSSSSSSSSS----------------------------SSSSSSSSSSSSSSSSSSSSSSSSSSSS---------------------------------------<>---------------SSSSSSSSSSSSSSSSSSSSSSSSSSSS----------------------------------------------------------------------------------------------------------------
--------------------------------------------------------SSSSSSSSSSSSS-S------SSS--SS---------------------------------------[]------<>-------SSSS-SSSSSSS--------------------------------------------------------------------------------------------------------------------------------
--------------------------------------------------------SSSSSSSSSSSS-SS------SSS--SS--------------------------------XXXX---[]-------]-------SSSS--SSSSS---------------------------------------------------------------------------------------------------------------------------------
---------------------------------------?SSS-------------SSSSSSSSSSS--SS--------------------QQ-QQQQ--------------E-------------------XXXX-----SSS--SSSSS----------------------------XXX-------------------------------------XX---S-------------------------------------------------------
----------------------------------------------------------------------------------------------------------------XXXX-XX?-----------------X---S------------------------------------------------------------------------------------------------------------------------------------------
------------------------------------------------------------------------------------------------------------------X-----------------------------------S---------------------------------------------------------------------------------------------------------------------------------
----------E------------------XSSSS--------------------E------------------------E----------------------------------------------------------------E-----S------------S------------------------------XX------------------------------------------------------------------------------------
---------<>-----------------------------SS-----------<--SSSSSSSSSSS--------E--<>--------E-Q---QQQQ-?QQ--------E-X--X------------XXXXXX---------SSSSSSSSS--------E------X-X----------------------------------------XXX-----------SQQQ--------------XX------------------------------------
---------[]------------------------------------------E]----SSSSSSS--------<>--[]-----------------------------<>---XX-------------------------SSSSS--SSS--------<>------X-X-----------------------------------------------------------------------XXX------------------E-----E-----------
---------[]--------<X------X------------------------------SSSSSSSSS-----XX[]--[]-----------------------------[]----X------------------------SSSSSSS-SSS--------[]------X------------------------------------------------------------------------XXXX-----------------<>-----------------
---------[]----------------X-------------------------------SSSSSSS------X-[]--[]-----------------------E--E--[]-----------------------------SSSSS-SSSSS--------[]----XXX-X---------------------------------------------------------------------XXXXX-----------------[]-----------------
XXXXXXXXXXXXXXXXXXXXX-XXXXXX---XXXXXX----XXXXXXXXXXXXXX-XXXXXXXXXXXXXXXXXXX---XX-XXXXXXXXXXXXXXXXXXXXXXXXXXXXXXX----------------------------XXXXXXXXXXXXXXXXXXXXXXXXXXXX------XXXXX---XX--XXXXXXXXXX--------XXXX----------------XXXXXXXXXXXXXXXXXXXXXXXXXXXXXXXXXXXXXXXXXXXXXXXXXXXXXXXX
