--------------------------------------------------------------------------------------------------------------------------------------------------------------------------------------------------------------------------------X-------------------------------------------------------
---------------------------------------------------------------------------------------------------------------------------------------------------------------------------------------------------S------------------------------------------------------------------------------------
------------------------------------------------------------------------------------------------------------------------------------------------------SSSSSSSSS-----------------------------SS----SS----------------------------SSSSSSSSSSSSSSSSSSSSSSSSSSSS-------------------SSSSSSSSS
---------------------------------------------------------------------------------------------------------------------------------------------------------------------------S----------------SS---SSS----------------------------SSSS-SSSSSSSSS------------------------------------------
--------------------------------------------------------------------------------------------------------------------------------------------------------------------------XSE---------------SS--SSSS----------------------------SSSS--SSSSSSSS------------------------------------------
-------------------------------------------------------------------SS--------------------------XXX----------------------------------------------------------------SSS---?--SSSSSS----S---??SS------S-----------QQQQ--------------S-S--SSSSSSS-------------SS----------------------------
--------------------------------------------------------------------------------------------------------------------------------------------------------------------------------------------------------------------------------X-------------------------------------------------------
----------------------------------------------------------------------------------------------------------------------------------------------------------------------------------------------------E------S------------------------------S---------------------------------------------
-------------------------------------------------------------E----------E-------------------------------------XX----------------------------------------------------------EX--------------------------S-SSSSS-----------------E-----E----?S------------SS-------------------XS-S--------
------------------X-------------------------X---------------<>---------<>----------E-XX--------------SS-------------------------------------SSQ---------------X---------SXXXXSS-------E---XX-----XXX-----------SSSSS---------<>----S-SS--SSS---------------X<>----------X---X-----------
--------------EXXX-------------------------XX----------E----[]---------[]---E-----<>-XXX--------------------------------------------------E-----------------XXXX--------------SX?--EX-----X----------------------------------[]--SSS-S---SS--------<>------X[]-------E------X-----------
-------------------------------------------XXX--------<>----[]---------[]---------[]-XXX-------------------------------------------------<>-------<--------XXXXX-------------SSS--------X-[]---------------------------------[]-SS?SSS---SS--------[]------X[]----------XXXXXX----------
-------------------------XX--------------XXXXX--------[]----[]---------[]---------[]XXXX-------------------------------------------------[]-------[]-------XXXXX--------------S]-------XX-[]E-E---XX-------------------E-----[]-S[SS-----SS--------[]------X[]----------XXXXXX----------
XXXXXXX--XXXXXX----XXXXXXXXXXXXXXXXXXXXXXXXXXXXXXXXXXXXX--XXXXXXXXXXXXXXXXXXXXXXXXXX---------X--------XXXXXXX---XXXXXXXXXXXXX--X------X--XXXXXXXXXXXXXXXXXXXXXXX-----XXXXXX--XXXX--XX--XXXXXXXXXXXXXXXXXXXXXXXXXXXXXXXX-XXXXXXXXXXXXXXXXXXXXXXXXXXXXXXXXXXXXXXXXXXXXXXXXXXXXXXXX---XXXXX
