----------------------------------------------------------------------------------------------------------------------------------------------------------------------------------------------------------------------------------------------------------------------------------------
----------------------------------------------------------------------------------------------------------------------------------------------------------------------------------------------------------------------------------------------------------------------------------------
----------------------------------------------------------------------------------------------------------------------------------------------------------------------------------------------------------------------------------------------------------------------------------------
-------------------------------------------------------------------------------------------------------------------------------X---------------------------------------------------------------------------------------------------E----------------------------------------------------
-------------------------------------------------------------------------------------------------------------------------------X-------------------------------------------------------------------------------------------------XXXXXXX-----------------------------XXX----------------
-------------------------------------------------------------------------------------------------------------------------------X---------------------------X------------SSSS---SSS-----------------------------------SSS--------?----------------SSSSSS---------------------------------
------------------------------------------------------------------------------------------------------------------------------XX---------------------------X----------------------------------------------------------------------------------------------------------------------------
-----------------------------------------------------------------------------------------------------------------------------XXX--------------------------XX----------------------------------------------------------------------------------------------------------------------------
----------------------------------------------SS---E------------------------------------------------------------------------XXXX--------------------------XX-----------------------------------E------XXX--------------------------------------------------------E----------E-----------
-------------------------------------<>-----E-----<>---E--------------------------SS---------------------------------------XXXXX-----------------------X--XX------------SSSSS-------------XX--<>----------------XXX----------X--XXXXX-------------XXXX----XX---------------<>-----SS----
----------E--------------------------[]-----------[]--<>---------------------------------E----------E----------E----------XXXXXX-----E-----<-----------XXXXX-----------E-------E----------XX--[]-----------------------------XX--------X---EXX-------------------E---------[]-----------
---------<>--------------------------[]-----E-----[]--[]-------------------------------------------<>----------[---------XXXXXXX-----X-----[-----------XXXXX-----------[------<>--------XXX]--[]-----------------------------XX-------XX------------------------<>---E-----[]-----------
-------E-[]---------------E-E--------[]--E--------[]--[]--------E-----------------------EE---------[]---------E[-E-EE---XXXXXXXX-----X--E--[-E-EE----XXXXXXX----------E[------[]-------XXXX]--[]------------------------E-E--X-----------------XX---XXX---------[]---E-----[]-----------
XXXXXXXXXXXXXXXXXX------XXXXXXXXXXXXXXXX-XXXXXXXXXXXXXXX-----XXXXXX---XXX-----XXXXXXXXXXXXXXXXXX-XXXXXXXXXXXXXXXXXXXXXXXXXXXXXXXXXXX-XXXXXXXXXXXXXXXXXXXXXXXX-XXXXXXXXXXXXXXXXXXX-XXXXXXXXXXXXXXXXXXXXX---XXXXXX---XXXXXXXXXXXXXX-----------------------------XXXXXXXXXXXXXXXXXXX--XXXXX
