----------------------------------------------------------------------------------------------------------------------------------------------------------------------------------------------------------------------------------------------------------------------------------------
------------------------------------------------------------------------------------X---------------------------------------------------------------------------------------------------------------------------------------------------------------------------------------------------
------------------------------------------------------------------------------------SSS----------------SSSSSSSSS------------------------------------------------------------------------------------------------------------------------------->----------------------------------------
-------------------------------E--------------------------------------------------------------------------------------------------------------------------------------------------------------------------------------------------------------------------------------------------------
-----------------------------XXXXXXX-----------------------------------------------------------------------------------------------------------------------------------------------------------------------------------------------EE----------]-----E-----S----------------------------
------------------------XXX-?----------------SSSSSSSS-----------------------------------------?SS----------------X---------------------------------------------------------SSSSSSSSS---S----S-----------------SS-S-----------S--S-SSSSSSSS-----S---S------------------------------------
----------------------------------------------------------------------------------------------------------------------------------------------------------------------------------------------------------------------------------------------------------------------------------------
----------------------------------------------------------------------------------------------S-----------------------------------------------------------------------------------------------------------------------------------------------------------------------------------------
---------------------------------------------------------------------------------------------?E------------E-----------------------------------------------------------------------------------E--?--XS---------------------------EE----------------------------------------------------
--------------XX------------XXXXX-------------XXXX----------------------------SSSSSS--E--SS--[]-----E-----<>----------------------------------------------------SS-SSSSS----SSSSSS------------<>-----------S?--SSSS----------------?SSSSS----EE-----------------------------------------
--------------XX-------------------E---EXXX-----------------------E------------------<>------[]----<>---E-[]---------------------------E------------------------------------------------------[]--------------------------------------SS------------------------------------------------
-------------XXX------------------XX-----------------------------<>-----------------S[]--X---[]----[]--<>-[]---X----------------------<>------------------------------------------------------[]-------------------------------------X----------X--------XX-----------------------------
-----------EXXXX---------------------------XX------------------E-[]------------------[]------[]----[]--[]-[]--------------------------[]-----------EE-----------------------------------------[]----------------------------------------------------XXX--XX---------------------------E-
-XXXX---XXXXXXXXXXXXXXX-XXXXX--------XX-----------------XXXXXXXXXXXXXXXXXXXXXXXXXXXXXXXXXXXXXXXXXXXXXXXXXXXXXXXXXXXXXXXXXXXXXXXXXXXXXXXXXXXX---XXXXXXXXXXXXXXXXXXXXXXXXXXXXXXXXXX--XXXXXXXXXXXXXXXXXXXXXXXXXXXXXXX-XXXXXXXXX----XXX--XXXXXX-----------------XXXXXXXXXXXXXXXXXXXXXXXXXXXX
