----------------------------------------------------------------------------------------------------------------------------------------------------------------------------------------------------------------------------------------------------------------------------------------
------------------------------------------------------------------------------------------------------------------------------------------------------------------------------------------------------------------------------------------------------------X---------------------------
--------------------------------------------------------SS--------------------SSSSSS----------------------------------------------------------------------------------------------------------------------------------------------------------------------------------------------------
----------------------------------------------------------------------------------------------------------------------------------------------------------------------------------------------------------------------------------------------------------------------------------------
---------------------------------------------------------------------------------------------------------------------------------------------------------------------------------------------------------------------------------------------------------------------XXX----------------
----------------XXX--------------SSQQQQQQQQ------------S-----------------------------------Q--QQQQQ---------SSSS------------------------------------------------------------------------------SSSSS----S---------------------------------------------------X----------------------------
---------------XXXX---------------------------------------------------------------------------------------------------------------------------------------------------------------------------------------------------------------------------------------------------------------------
---------------XXXX---------------------------------------------------------------------------------------------------------------------------------------------------------------------------------------------------------------------------------------------------------------------
--------------XXXXX-----------------------------------------------E------------E---------------------------------------------------------------------------------------------------------------------------------------------------------------------------------E----------Q-----------
----------X--XXXXXX---------------SS?-QSSSQQ--------------E--S---<>-----E-----<>--------E-Q---QQQQQQQQ---------------------------------------------------------------S----------------X--------------------------------------------------------------SSSSSS----------------->-----S-----
----------X-EXXXXXX--------------------------------------<>------[]----<>---E-[]--------------------------------------------------X-------------------------------------------------------------------------------------------------------E----------------------E----E----[]-----------
>---------XXXXXXXXX-------XX-----------------------------[]--X---[]----[]--<>-[]---X--------------------------------------------XXX-----------------------------------------------------------------------------------X------------------<>---------------------<>---<>----[]-----------
EE-E------XXXXXXXXX-------XX-------------------E---------[]------[]----[]--[]-[]-----------------------E------------------------XXX-----------------E----E---------E--------------------------------------------------X--------------E---[]---------------------[]---[]----[]---------E[
XXXXXXXXXXXXXXXXX------X----XXXXXXXXXXXXXXXXXXXXXXXXXX--XXXXXXXXXXXXXXXXXXXXXXXXXXXXXXXXXXXXXXXXXXXXXXXXXXXXXXXXXXXXXXXXXXXXXXXXXXXXXXXXXXXXXXXXXXXXXX-XXXXXXXXXXXXXXXXX-------XXXXXXXXXXXXXXXX--XXXXXXXXXXXXXXXXXXXXXXXXXXXXXXXXXXXXXXXXXXXXXXXXXXXXXXXXXXXXXXXXXXXXXXXXXXXXXXX--XXXXXX
