----------------------------------------------------------------------------------------------------------------------------------------------------------------------------------------------------------------------------------------------------------------------------------------
----------------------------------------------------------------------------------------------------------------------------------------------------------------------------------------------------------------------------------------------------------------------------------------
-------------------------------------------------------------SSSSSSSSSSSSSSSSSSSSSSS------------------------------------------------------------------------------------------------------------------------------------------------------------------------------------>---------------
-----------------------------------------------------------------------------------------------------------------------------------------------------------------------------------------------------------------------------------------------------------------------[]---------------
------------------------------------------------------------------------------------------------------------------------------------------------------------------------------------------------------------------------------------------------------------------------]----E----------
----------------------------------------?SS----------------------------------------------------------SSS------------------------------------S----------------------S-------------------XXS-----------------Q-----------------------------------E-----------------------XXXX-----XXX-----
--------------------------------------------------------------------------------------------------------------------------------------------------------------------------------------XXX------------------------------------------------------X-------------------------------XX-------
--------------------------------------------------------------------------------------------------------------------------------------------------------------X----------------------XXXX-----------------------------------------------------XX----------------------------------------
------------------------------------------------------XX------------------X----------------------------------------------------------------------------------XX---------------------XXXXXE---------------------------------------------------XXX--------------------------------------XX
-------------------------SS--X-------------------------SSS---------------XX-----------------------------------------------------E-----------QQQ--------------XXX---------E---------XXXXXX-----------------Q---QQQ--?Q-----------------------XXXX-------------XX-----------------S-------
----------E------------------X------------------------------------------XXXX---------------------------------------------------<>----------E---------------XXXXXX-------<>-------XXXXXXXX----X--------------------------------------------XXXXXX-------------XX-------------------------
---------<>-----------------XX-----------------------------------------XXXXX---------------------------------------------------[]---------<>]--------------XXXXXX-------[]-------XXXXXXXX----X-------------------------------X-----------XXXXXXX------------XXX-------------------------
-------E-[]-----------------XXX----E--------------------]-----E-------XXXXXX-----------------------------------------------E---[]---------[]]-------------XXXXXXX-------[]-EE----X-XXXXXX----X-----X-------------------------X----------XXXXXXXX--------E--EXXX-------------------------
--XXXXXXXXXXXXXXXXX---XXXXXX---XXXXXXXX-XXXXXXXXXXXXXXXXXXXXXXXXXXXXXXXXXXXX---XXXXXXXXX--XXXXXX----XXXXXXXXXXXXXXXXXXXXXXXXXXXXXXX----X-XXXXXXXXXXXXXXXXXXXXXXXXXXXXXXXXXXXXXXXXXXXXXXXXXXXXXXXXXXXXXXXXXXXXXXXXXXXXXXXXXXXXXXXXXXXXXXXXXXXXXXXXXXXXXXXXXXX--------XXX-------X---------
