----------------------------------------------------------------------------------------------------------------------------------------------------------------------------------------------------------------------------------------------------------------------------------------
--------------------S-------------------------------------------------------------------------------------------------------------------------------------------------------------------------------------------------------------------------------------------------------------------
---SSSS-------<>----SSS---SS--------------------------------------------------------------------------------------------------------------------------------------------------------------------------------------------------------------------------------SSSSSSSSSSSSSSSSSSSSSSSSSSSS
---SSSSSS-----[]----SSSSSSSS------------------------------------------------------------------------------------------------------------------------------------------------------------------------------------------------------------------------------------------------------------
---SSS-S-------]----SSSSSSSS------------------------------------------------------------------------------------------------------------------------------------------------------------------------------------------------------------------------------------------------------------
?-SSSSSSSS---SSS----SSSSSSSS----------------XX--------------------------------------------------------------------------------------------------------------------------Q------------------------------------------------------------------------------------SS-----S-------------------
-------------------------------------------XXX-----------------------------------------------------------------------------------------------------------------------------XX-----------------------------------------------------------------------------------------------------------
-------------------------------------------XXX------------------------------------------------------------------------------------------------------------------------------------------------------------------------------------------------------------------------------------------
--EX--------------------------------------XXXX------------------------------------------S-----------------------------------------------------------------------------------------------------------------------------------------------------------------------------------------------
-XS?SSSS------E----X-X---XXX--------Q-X--XXXXX-------------------------QQ-----------------------S------------<E----------------------S--S--Q----------------E----------EX------------XXXXXX---------SQQQ--------------XX----------------------XXXX----------SSSSS---SQS-----------------
----SSSSS--EX-------------------------X-EXXXXX---------------------------------------------------------------<>--------------------------------------------<>---------<>X-----------XXX-------------------------------XX-------------------------------------------------------XX-------
----SSSS--------X-X--------------------XXXXXXX------------------------------------E--------------------------[]--XXX---------------------------------------[]---------[]-----------XXX--------------------------------XX----------------------------------------------------<>-XX-------
------S---------X-X-E-------EE-E-------XXXXXXX------------------------------------E--------E-E---------------[]---------E----E-------E-E--------E------E---[]---------[]----------XXXX-------E--E------------------XX-XX------------------------------------------E---------[]-XX-------
XXX--XXXXXXXX--XXXXXXXX--XX-XXXXXXXXXXXXXXXXXXXXX--XXXXXXXXXXXXXXXXXXXXXX--------XXX--XXXXXXXXXXXXXXXXXXXXXXXXXXXX---XXXXXXXXXXXXXXXXXXXXXXXXXXXXXXXXXXXXXXXXXXXXXXXXXXXXXXXXX---XXXXX----XXXXXXXXXXXXXXXXXXXXXXXXXXXXXXXXX-XXXXX---XX---XXXXX-------XXXXXXXXXXXXXXXXXXXXXXXXXXXXXXXXXXX
