----------------------------------------------------------------------------------------------------------------------------------------------------------------------------------------------------------------------------------------------------------------------------------------
----------------------------------------------------------------------------------------------------------------------------------------------------------------------------------------------------------------------------------------------------------------------------------------
--------------------------------------------------------------------------------------------------------------------------------------------------------------------------------------------------------------------------------SSSSSSSSSSSSSSSSSSSS------------------------------------
----------------------------------------------------------------------------------------------------------------------------------------------------------------------------------------------------------------------------------------------------------------------------------------
--------------------------------------------------------------------------------------------------------------------------------------------------------------------------------------------------------------------------------------------------------------------------E-------------
--------------------------------------------------------Q-------------------------------------------------------------------------------------------------------------------------------------XXXXX----------------------------------------------------------XXXXX----------------------
----------------------------------------------------------------------------------------------------------------------------------------------------------------------------------------------------------------------------------------------------------------------------------------
--------------------------------------------------------------------------------------------------------------------------------XXXX-------------------------------------------------------------------------------------------------------------S--------------------------------------
------------------------------------------------------------------------------------------------------------------------------------------------------------------------------------------------------------------------------------------------XXXS------------------------------------
-------------XXXX----------------------------------------------------XXXXX------------------------------------------------------------SS--------------------------------Q-Q--------------XXXXX------------------------------SSSS<>------Q--------X----X-----------------X---------------
-------------X------------------------------E---------E---------------------------------------------------------------------X-------------------------E---------------E---------------XX----------------------E-----------------[]--------------XX----X----E------------X---------------
------------XX-----------------------------<>---------E--------------X------------------------------------------------------X------------------------->--------------<>--------------------------------------<>-----------------[]----------XXXXXX----X---<>------------X---------------
-----------XXX----------E------------------[]---------E-------------EX-------E-EE-----------------------------E---E--EE-E-E-X--------EE-EE-E---------E]--------------[]------------------------------------E-[]-----------------[]----------XXXXXX----X---[]------E-E---X--------EEE-E-E
XXXXXX---XXXXX-----XXXXXXXXXXXXXXXXXXXXXXXXXXXXXXXXXXXXXX---X---XXXXXX-------X--X-XXXXXXXXX---XXXXXX---XXXXXXXXXXXXXXXXXXXXXXXXXXXXXXXXXXXXXXXXXXXXXXXXXXXXXXXX-XXXXXXXX---------XXXXXXXXXXXXXX--XXXXXXXXXXXXXXXXXXXXXX---XXXXXXXXXXXXXXXXXXXXXXXX--XXXXXXXXX---XXXXXXXXXXXXXXXXXXXXXXXX
