----------------------------------------------------------------------------------------------------------------------------------------------------------------------------------------------------------------------------------------------------------------------------------------
----------------------------------------------------------------------------------------------------------------------------------------------------------------------------------------------------------------------------------------------------------------------------------------
-----------------------------------------------------------------------------------------------<>-----------------------------------------------------------------------------------------------------------------------------------------------------------SS--SSSSSSSSSSSSSSSSSSSSSSSS
-----------------------------------------------------------------------------------------------[]---------------------------------------------------------------------------------------------------------------------------------------------------------------------------------------
-----------------------------------------------------------------------------------------XXX---[]---------------------------------------------------------------------------------------------------------------------------------------------------------------------------------------
-SSS---SS-----------------------------------XXX----------X-X------------------------E------------------XXXX----------------------------------------SSSSS---------------------------------------XXX------------------XX----------Q----------------------X--------------------------------
-------------------------------------------XXXX-------------------------------------XXX---XX-------------------------------------XXX-------------------------------------------------------------------------------XXX-------------XXX--------------------------------------------------
------------------------------------------XXXXX-------------------------------------------------------------------------------------------------------------------------------------------------------------------XXXX--------------------------------------------------------X---------
-----------------------------------------XXXXXX--------------------------------------------------------------------------------------------------------------------E---------------------------------------------XXXXX-------------------------------------------------------XX---------
--SSS---------------------------------XX-XXXXXX---X---------------------------------X-XX------------XXXXSX-------X-----------------------?SS-----SS--SS-----------<>----X-------------XXXXX--------------------X-XXXXX----------X------------XXXXXXX----------------Q-S------XX---------
------------------X--------->---------XXXXXXXXX---X-----------------------------------XX-------------------------X---------------------------->-------------------[]------------------------------------------XXXXXXXX----------X-------------X--X-X------------------------XXXX--------
------------------X--------->--------XXXXXXXXXX---X----X------------------------------XX------------------------XXX-----------------------------------------------[]-----------------------------------------XXXXXXXXX----------X-----------------------------------------XXXXXX--------
------------------X---------EE-E-----XXXXXXXXXX---X----X------------------------------XX------------------------XX--------------------------------------------E---[]---------------------------------E-E-----XXXXXXXXX---------X----------------------------]-----E------XXXXXXX--------
XXXXXXXXXXXXX--XXXXXXXXXXXXXXXXXXXXXXXXXXXXXXXXX-XXXXXXXXXXXXXXXXXXXXXXX--------XXXX------------------XXXXXXXXXXXXXXXXXXXXX--XXXXXXXXXXXXXXXXXXXXXXXXXXXXXXXX-----XX-XXXXXXXXX---XXXXXX----XXXX-XXXXXXXXXXXXXXXXXXXXXX-XXXXXX--XXXXXXX----XXXXX----X-X--XXXXXXXXXXXXXXXXXXXXXXXXX---XXXX
