----------------------------------------------------------------------------------------------------------------------------------------------------------------------------------------------------------------------------------------------------------------------------------------
----------------------------------------------------------------------------------------------------------------------------E-----------------------------------------------------------------------------------------------------------------------------------------------------------
---------------------------------------------------------------------------------------------------------------------------<>---------------------------------------------------------------------------------------------------SSSSSSSSSSSSSSSSSSSSSSSSSSSS----------------------------
---------------------------------------------------------------------------------------------------------------------------[]---------------------------------------------------------------------------------------------------SSSSSSSSSSSSS-------SSSSSSSS----------------------------
-----------------------------------------------------------------------------------S---------------------------------------[]----E----------------------------------------------------------------------------------------------SSSSSSSSSSS---------SSSSSSSS----------------------------
---------------------------------------------------------------S---------SSS-------------------------SSS-------------------XXX---------------XXX--------------------------SSSSSSSS---SSS------SSSSSS----------------------------SSSSSSSSSS---SS-----------SS----------------------------
----------------------------------------------------------------------------------------------------------------------XX----------XXXX--X-----------------------------------------------------------------------------------------------------------------------------------XXXX--------
------------------------------------------------------------------------------------------------------------------X---------------------------------------------------------------------------------------------------------------------------------------------------------------------
--------------------------------------E---------------------------------------------------------------------------------------------------XX-------------------------------E-----------------------------------------------------?EE-------------------E------------------------------E-
-------------X-XX----------------E---<>-----E-----------SXXXX-------------XX------XXSQQXX-------------XX--<>----XXXX-------------SSSS--------------------------------SSS--SSSSSSSS---------E------------------------------------SSSSSSSSS----------EX-<>---X-X------------------------SS
------------XX-----------------------[]----<>---E--E---E-------E---EX-----XX------------------------------[]-----XXX-----------------------------------------------------------S----------<>------------------E---------------E-----SSSSSS--------<>--[]-----X--------------------------
------------XX-----------------------[]----[]--<>-<>--XX------<>----------XX------X-------------------X---[]----XXXX---------------------------------------------------------X------------[]-----------------<>--------------<>----SSSSSS-------XX[]--[]----XXX-------------------------
-----------XXX-------E--E------------[]----[]--[]-[]--XX------[]-------XX-XXX-E--XXX----------------------[]----XXXX-------------------------------EE--------------E----------------------[]-----------------[]--------------[]----SSSSSS-------XX[]X-[]---XXX--------------------------
XXXXXXX-XXXXXXXXXXXXXXXXXXXXXXXXXXXXXXXXXXXXXXXXXXXXXXXXXXX--XXXXXXXX--XXXXXXXXXXXXXXXXXXXXX---XX--XXXXXXXXXXXXX------------------XXXXXXXXXXXX--XXXXXXXXXXXXX----XXXXXXXXXXXXXXXXXXXXXXXXXXXXXXXXXXXXXXXXXXXXXXXXXXXX-------XXXXXXXXXXXXXXXXXXXXXXXXXXXXXXXX-----XXXXXX---XX------XXXXXX
