----------------------------------------------------------------------------------------------------------------------------------------------------------------------------------------------------------------------------------------------------------------------------------------
----------------------------------------------------------------------------------------------------------------------------------------------------------------------------------------------------------------------------------------------------------------------------------------
----------------------------------------------------------------------------------------------------------------------------------------------------------------------------------------------------------------------------------------------------------------------------------------
-----------------------------------------------------------------------X----------------------------------------------------------------------------------------------------------------------------------------------------------------------------------------------------------------
-----------------------------------------------------------------------X----------------------------------------------------------------------------------------------------------------------------------------------------------------------------------------------------------------
------------------------XXXX-------------------------------------------X----------------------QQ-------------------------------------------------------------------------------------------------------------------------------------------X-----XXXX-----------------------------------
----------------------------------------------------------------------XX----------------------------------------------------------------------------------------------------------------------------------X-----------------------------------------------------------------------------
---------------------------------------------------------------------XXX-----------------------------------------------------XX---XX-------------------------------------------------XX-XXXX--------------------------------------------------------------------------------------------
--------------------------------------------------------------------XXXX----------------------------------------------------------------------------------------------------------------------------------------------------------------------------------------------------------------
-----------------------SS------------------------------------------XXXXX-----------------QQ---QQ---?Q---------------------------------SS-----------------------------QQ-----------------------SS------------------XXXXXX---------XXX-------------SSSSS------------------------------S---
------------------------------------------------------------------XXXXXX-----E-----<--------------------------------------E-----E-------------------------------------------------------E-----------------------------------------XX----------------------------------------------------
-----------------------------------------------------------------XXXXXXX-----X-----[--------------------------------------E----<>-------------------------------------------------E-----------------------------------------------------------------------------------------------------
----------------------------------------E------------EE--E-EE---XXXXXXXX-----X--E--[------------------E-------------EE----S----[]-----E--E-EXX-----E-E----------------E---E-EE----S----E------E--E-E------------------------------XX-------------------------------E--------------------
---XXXXXXXXXXXXXXXXXXXX--XXXXXXXXXXXXXXXXXXXXX-XXXXXXXXXXXXXXXXXXXXXXXXXXXXXXXXXXXXXXXXXXXXXXXXXXXXXXXXXXXXXXXXXXXXXXXXXXXXXXXXXXXXX-XXXXXXXXXXXXXXXXXXXXXXXXX-----XXXXXXXXXXXXXXXXXXXXXXXXXXXXXXXXXXXXXXXX-----XXX---XXXXXXXXXX--------------XXXXXXXXXXXXXX---XXXXXXX--XXXXXXXXXXXXXX-X
