----------------------------------------------------------------------------------------------------------------------------------------------------------------------------------------------------------------------------------------------------------------------------------------
----------------------------------------------------------------------------------------------------------------------------------------------------------------------------------------------------------------------------------------------------------------------------------------
---------------------------------------------------------------------------------------------------------------------------------------S--------------------------------------------------------------------------------------------------------------------SSSSSSSSSSSSSSSSSSSSSSSSSSSS
----------------------------------------------------------------------------------------------------------------------------------------------------------------------------------------------------------------------------------------------------------------------------------------
------------------------------------------E--------------------XX-----------------------------------------------------------------------------------------------------------------------------------------------------------------------------------------------------------------------
X-------QQSSSSS-------------E----------------E----------------------SSS----XXXX--------------------X---------------S-SSSSSSS--------------SS-----------------X------------------------------------XX--------------------------------------------------------SSS--------------------SS---
-------------------------------XXXXX-------------XXXXX---------------------------------------------XX------------------------------------------------------XXX--------------------------------------------------------------------------------------------------------------------------
E-------------------------------------------------------------------------------------------------XXX-----------------------------------------------------XXXX----------------------------------------------------XX--------------------------------------------------------------------
XXX-----------------------E-----------------------------XXXXXXX-------------------XX-------------XXXX----------------------------------------------------XXXXX---------------------------------------------------XXX---------------------------------------------------------------SS---
-------S?S-SSSSS---------<---------------XXXXXX---------------------XX-----------X---------------XXXX---------------SSSSSSS------------------------------XXXXX---------E----------------------SSSSSS-------------XXX---------------------------------S--S---SSSS---------------XX-------
-------------------------[]-----------------------------------------------------XXXS----------XXXXXXX----------E--E-----------------------------------X-XXXXXX--------<>--------------------------------------XXXXXX-----------<-----------------------------------E---------X-XX-------
-------------------------[]------------------------------------------------------------------XXXXXXXX---------<[------------------->-----------------XXXXXXXXX--------[]-------------------------------------XXXXXXX-----------[----------------------------------<>--------XXXXX-------
-------------------E-----[]----------------------------------------------------------E-E----XXXXXXXXX---------[[---------E--------E]-----------E-----XXXXXXXXX--------[]-------E-EE-------------------------XXXXXXXX--------E--[----------------------------]-----[]-------XXXXXX-------
---XXXXXXXX-XXXXXXXXXX-----------X--------------------------------------XXXXXXXXX---XXXXXXXXXXXXXXXXXX-----XX--XXXXXXXXXXXXXXXXXXXXXXXXXXXXXXXXXXXXXXXXXXXXXXXX--XXXX-XXX-XXXXXXXXXXXXXXXXXXXXXXXXXXXXXXXXXXXXXXXXXXXXXXXXXXXXXX-------XXXX--XXXXXXXXXXXXXXXXXXXXXXXXXXXXXXXXXXX----XXXX
