----------------------------------------------------------------------------------------------------------------------------------------------------------------------------------------------------------------------------------------------------------------------------------------
----------------------------------------------------------------------------------------------------------------------------------------------------------------------------------------------------------------------------------------------------------------------------------------
----------------------------------------------------------------------------------------------------------------------------------------------------------------------------------------------------------------------------------------------------------------------------------------
----------------------------------------------------------------------------------------------------------------------------------------------------------------------------------------------------------------------------------------------------------------------------------------
-------------------------------------XXX------------------------------------------------------------------------------------------------------------------------------------------------------------------------------------------------------------------------------------------------
-------SQQSS-------------------------------------------------------------XX-------------------------S--------------------------------------------------------S--------------------------------------------------------------------------------------------------------------------------
------------------------------------------------------------------------XXX-------------------------------------------------------------------------------------------------------------------------------------------------------------------------------------------------------------
-----------------------------------------------------------------------XXXX---------------------------------------------------------------------------------E---------------------------------------------------------------------------------------------------------------------------
----------------------------------------------------------------------XXXXX--------------------------------------------------------------------------------<>---------------------------------------------------------------------------------------------------------------------------
------SSS--SSSS----------<>----------------Q----------E-----------X--XXXXXX-------------------------X----------E-----E----------E--------------------------[]----------E-----------------------S---------E----------E----------E------------------X------------------------QQ-----------
-------------------------[]-----------E--------------<>-----------X-EXXXXXX------------------------XX---------<>----<>---------<>----------------E---------[]---------<>--------------------------------<>---------<>------E--<>--------------EXXXX-------------------------------------
-------------------------[]----------<>--------------[]-----------XXXXXXXXX------------------------XX---------[]----[]---------[]----<---------------------[]---------[]------------X-------------------[]---------[]-----<>--[]---------------XXXX-------------------------------------
-------------------EE-E--[]----------[]--------------[]-----------XXXXXXXXX----------E--E------E-XXXX---------[]EE--[]-----E-E-[]----[----------E------E---[]---------[]------E-E---X--------EEE-E------[]---------[]-----[]--[]---------------XXXX-------XX--------------------------E-
XXXXXXXXX---XXXXXXXXXXXXXXXXXXXXXXXXXXXXXXXXXXXXXXXXXXXXXXXXXX--XXXXXXXXXXXXXX-XXXXXXXXXXXXXXXXX-XXXXXXXXXXXXXXXXXXXXXXXXXXXXXXXX--XXXXXXXXXXXXXXXXXX-XXXXXXXXX---XX-XXXXXXXXXXXXXXXXXXXXXXXXXXXXXXXXXXXXXXXXXXX-X-XXXXXXXXXXXXXXXXXXXXX--XXXXXXXXXXXXXXX-XXXXXXXXXXX--XXXXXXXXXXXXX-XXX
