------------------------------------------------------------------------------------------------------------------------------------------------------------------------------------------------------------------------------------------------------------X---------------------------
----------------------------------------------------------------------------------------------------------------------------------------------------------------------------------------------------------------------------------------------------------------------------------S----S
------------------------------------------------------------------------------------SSSSSSSSSSSSSSSSSSSSSSSSSSSS--------------------------------------------------------------------------------------------------------------------------------------------SSSSSSSSSSSSSSSSSSSSSSSSSSSS
------------------------------------------------------------------------------------------------------------------------------------------------------------------------------------------------------------------------------------------------------------SSSSSSSSSSSSSSSS----SSSSSSSS
------------------------------------------------------------------------------------------------------------------------------------------------------------------------------------------------------------------------------------------------------------SSSSSSSSSSSSSSSS----SSSSSSSS
-----------S--------------------------------XX---------------------------------SS------------------------------------------------SXX-------------------------------XXX--------SQQQQQ---------------S-----------------SS---------------------?SS-------------SSSSSSSSSSS--SSS----SSSSSSSS
-------------------------------------------XXX---------------------------------------------------------------------------------------------------------------------------------------------------------------------------------------------------------------S--------------------------
------------------------------------------XXXX----------------------------X--------------------------S----------------------------------------------------------------------------------------------------------------------------------------------------------------------------------
----------------E------------------------XXXXX----------------------------X-------------------------XSXS------------XX------------------------------------------------------------------------------------------------------------SSSSSSS-----------------------E------------------??---
-----E---------<>----------------------X-XXXXX----------QQ---------------XX---------<>------QQS------X----X------------------------------Q----------------XXX-----------------S---QQ----------------------------------X---------------------SSS---------------SSSSSSSSS--------E-----XXX
----<>---------[]---------------------XXXXXXXX--------<E--------------EXXXXX--------[]---------------]----X----X-------------------------E-----------------------------------------------------E--------------------------------------------------------------SSSSSSSS--------<>--------
----[]---------[]--------------------XXXXXXXXX--------[]---------------XXXXX--------[]-----------XXX[]-X--X----X-------------------------X----------------------------------------------------<>-------------------------------------------------------------SSSSSSSSSS-------[]--------
----[]---------[]------------E-E-----XXXXXXXXX--------[]---------------XXXXX--------[]----E-----XXX-[X----X----X--------------------------------------------------------------------------E---[]-------------------------------------------------------------SSSSSSSSS--------[]E-------
XXXXXXXXXXXXXXXXXXXX-XXX-XXXXXXXX-XXXXXXXXXX---XXXXXXXXXXXXXXX--XXXXXXXXXXXXXXXXXXXXXXXXXXXXXXXXXXXXXX-XXXXXXXXX------XX-------XXXXXXXXXXXXXXXXXX---XXXXXXX----XXX--XXXXXXXXXXXXXX-XXXXXXXXXXXXXXXXX---X-------XXXXX---XXXXXXXXX---XXXXXXXXXXXXXXXX---------XXXXXXXXXXXXXXXXXXXXXXXXXXXX
