----------------------------------------------------------------------------------------------------------------------------------------------------------------------------------------------------------------------------------------------------------------------------------------
----------------------------------------------------------------------------------------------------------------------------------------------------------------------------------------------------------------------------------------------------------------------------------------
--------------------S-----SS----------------------------------------------------------------------------------------------------------------SSSSSSSSSSSSSSSSSSSSSSSSSSSS----------------------------------------------------------------------------------------------------------------
--EE----------------SSSSSS-S------------------------------------------------------------------------------------------------------------------------------------------------------------------------------------------------------------------------------------------------------------
-XXXX---------------SSSSSSSS------------------------------------------------------------------------------------------------------------------------------------------------------------------------------------------------------------------------------------------------------------
SSS----S-----S--------SSS---Q---------------------------X-------E?SSSSS----SSSS--S----------------------------XX------------------------------------------------------------------------------------X---SSSSSQSSS--------S-----------------X-X-------------------------------XX---------
-------------------------------XXX-----------------------------------------------------------------------------------------------XX-----------------------------------------------------------------------------------------------------------------------------------------XXX---------
----------------------------------------------------------------------------------------------------XXXX------------------------XXX-----------------------------------------------------------------]----------------------------------------------------------------------XXXX---------
--E-----------------------------------------------------XXXXX------------------------------------------------------------------XXXX-------------------E---------------------------------E-----------X-X-------------------------------------------------------------------XXXXX---------
SXXXX-------------XXXX----XXX------------XXXXXX----------------S?---SSS-----------------------------------SS--------------X-----XXX--------->--S----S<>---------E------X---------------<>------------------S?S-S?SS----------X----XX-------------SSSSS------E------------XXXXXX---------
-------X---EXX----XX------------------------------------------------------------XXXX------------------------------------------XXXXX--------E---S-----[]--------<>------X-----E---------[]------------------------------------XX--XXX----------------------------------X-XXXXXXX---------
------<>----------XX---------------------X-----------------------------------------------------------------------------------XXXXXX-------X>S--S-----[]-----<>-[X------X---------------[]------------------------------------XX---XX------------------------]---------XXXXXXXXX---------
------[]-------XX-XXX-------------------------------E---------------------------------E-EE--E-EEE-EE------E--E-EE--E--------XXXXXXX-------X]S-----E--[]-----[]-[X------X----E----------[]------------------------------EE-E--XX---XX------------------------]---------XXXXXXXXX-----E---
XXX--XXXXXXX----------------XXXXXX---XXXXX-----XXXX-X-XX-----XXXXXX-XXXXXXXXXXXX----XXXXXXXXXXXXXXXXXXXXXXXXXXXXXXXXXXXXXXXXXXXXXXX---XXX-XXXXXXXXXXXXXXXXXXXXXX--XXXXXXXXXXXXXXXXXXXXXXXXXXX--XXXXX-XXXXXXXX----X--XXXXXXX-XXX-XXX-----XX----XXXXXXXXXXXXXXXXXXXXX--XXXXXXXXXXXXX--XXXX
