----------------------------------------------------------------------------------------------------------------------------------------------------------------------------------------------------------------------------------------------------------------------------------------
----------------------------------------------------------------------------------------------------------------------------------------------------------------------------------------------------------------------------------------------------------------------------------------
---------------------------------------->-------------------------------------------SSSSSSSSSSSSSSSSS---SS------------------------------------------------------------------------------------------------------------------------------------------------------------------------------
--------------------------------------------------------------------------------------SS-SSSSSSSSS--------------------------------------------------------------------------------------------------------E-----------------------------------------------------------------------------
----------------------------------------]----E-----------------------------------------SSSSSSSSSSS---------------------------------------------XXXXX--------------------------------------------------XXXXXXX---------------------------------------------------------------------------
-----------Q---------------------------XXXX--------------------------------------------SSSSSSSSSS--S------------------------------E---------E-----------------SSSSSSS---------------XE-------------------------------XSSS------------------------------------------QQQQQQ--------------S
----------------------------------------------XXXX-----------------------------------E------------------------------E-------------------------------------------------------------------XXXXX-------------------------------------------------------------------------------------------
----------------------------------------------------------------------------------------------S-----------------------------------------------------------------------------------------------------------------------------------------------------------------------------------------
-----E----------E-------------------------------------XX--------------------------------E-----S------------E--------------------------------------------------------------------------------------E----XXXX-----------------------------------------------------------------------------
----<>----??---<>------------XX--------------?S-S------S---S-----QQ-------------------E--SSSSSSS----------[>----X-------------XEXXXX--------XXXXX-------------XX-X---------------------------------S-XXXX-------XXX-----XX---X------------------------SS------E--QQ--SQQQ---------------
----[]---------[]------E--E-XXX--------------------------------------------E---------SE------SS-----------[]----X-------------XXXX---------------------EXXX--------------E--------------------------------------------------XXXX----------------E------------<>--------------------E----
----[]---------[]-----<>----XXX--------------------------------------------X---------SSS-S---SS-------<---[]---------------------------------------X--------------------XXX--------------------------------------------------------------------<>------------[]-------------------<>----
----[]---------[]-----[]----XXXX-------------------------------------------[---------[]------ES-------[]--[]------------------------------------------------------------XX-----------------------------------------------XX----------E----E----[]------------[]---------------EE--[]----
-XXXXXXXXXXXXXXXXXXXXXXXXXXXXX--XXXX------XXXXXXXXXXXXXXXXXXXXXXXXXXXXXXXXXXXXXXXXXXXXXXXXXXXXXXXXXXXXXXXXXXXXXXXXXXXX----XXXXX----XXXX-XXXX----------------------------X----XXXXX-----X-----XXXXXXX----------------------------XXXXXXXXXXXXXXXXXXXX---XXXXXXXXXXXXXXXXXXXXXXXXXXXXXXXXX
