----------------------------------------------------------------------------------------------------------------------------------------------------------------------------------------------------------------------------------------------------------------------------------------
------------------------------------------------------------------------------S-----------------------------------------------------S------S--------------------------------------------------------------------------------------------------------------------------------------------
-----------------------------------------------------------SSSSSSSSSSSSSSSSSSSSSSSSS------------------------------------------------SS----SS----------------------------SSSSSSSSSSSSSSSSSSSSSSSSSSSSSSSSSSSSSSSSSSSSSSSSSSSSSSSS--------------------------------------------------------
----------------------------------------------------------SS----------------SSSSSS-S------------------------------------------------SS--SSSS----------------------------SSSSSSSSSS------------SS----------------------------------------------------------------------------------------
---------------------------------------X-----------------SSS----------------SSSSSSSS-------------------------------EE---------------SS--SSSS----------------------------SSSSSSSSSS?------------S----------------------------------------------------------------------------------------
---------------X----------------------------------------SSS----S-----S--------SSS---------SQQQQQQ---------------SSSSSSSSS----------S------------------------------------SSSSS--SS----S---------SS----SSS---SSS----------------S-----SSSSSSSSS---------------------SQQQSQ----------------
--------------XX------------------------------------------------------------------------------------------------------------------------------------------------------------------------------------------------------------------------------------------------------------------------
-------------XXX--------------------------------------------------------------------------------------------------------------------------------------------XXXX------------------------------------------------------------------------------------------------------------------------
------------XXXX------------------------------------------E--------------------SS--------------------------E------EX---------------------------------------------------------------------------SS------------------------------------------------------E---------------------------E----
------------XXXX----------------------------------------SSS??-------------XXX-----XX------S--SQSQ---------<>-----XS?SSS-------E----X------XX----------------------------SSSSS--SSSS--------E?----------SS--SSSS----------------------SSSSSSS----------<>---------SS--SSQ----------<>----
----------XXXXXX-----------<----------E------------------------E----X----XXXX-----------------------------[]---------SSS---EX----------------------------------------------SS-SSSS--------->-----------S-----SS--------<-------X-->-------------------[]--------------------------[]----
---------XXXXXXX-----------[---------<>-----------------------<>--------XXXXX-----------------------------[]---------SSS--------X-X------XX--------------------------------SSSSSSS------<XXXX----------S-----SS--------[]------X-[--------------------[]--------------------------[]----
--------XXXXXXXX--------E--[---------[]-----------------------[]-------XXXXXX--------------------------E--[]-------------------XX---XXX---XX--E--EE-E-E-E---------E--E-E---SSSSSSS------[][]X-------------E--S---------[]----XXX-------------------E--[]--------------------------[]----
XXXXXXXX-XXXXXXX-XXXXXXXXXXXXXXXXXXXXXXXXXXXXXXX--XXXXXXXXXX-XXXXXXXX--XXXX------XX-XXXXXXXXXX-XXXXXXXXXXXXXXXXXXXX--XXXXXX-----------------XXXXXXXXXXXXXXXXXXXXXXXXXXXXXXXXXXXXXXXXXXXXXXXX------XXXXXXXXXXXXXXXXXXXXXXXXXXXXXXXXXXXXXXXXXXXXXXXXXXXXXXXXXXXXXXXXXXXX-XXXXXXXXXXXXXXXXX
