----------------------------------------------------------------------------------------------------------------------------------------------------------------------------------------------------------------------------------------------------------------------------------------
--------------------------------------------------------------------------------------------------------------------------------------------X-------------------------------------------------------------------------------------------------------------------------------------------
----------------------------------------------------------------------------------------------------------------------------------------------------------------------------------------------------------------------------------------------------------------------------------------
-------------------------------------E--------------------------------------------------------------------------------------------------------------------------------------------------------------------------------------------------------------------------------------------------
-------------------------------------XXX-----------------------------------------------------------------------------------------------------E--XX--------------------------------------------------------------------------------------------------------------------------------------
-------------------------------------------------------------------------------XXXXX--------------------------------------------------------S--------------------------------------------------------------------------------------------------------------------------------XX---------
----------------------------------------------------------------------------------------------------------------------------------XX-------------------------------------------------------------------------------------------------------------XXX------------------------XXX---------
---------------------------------------------------------------------------------------------------------------------------------------------------------------------------------------------------------------------------------------------------------------------------XXXX---------
----------------------------------SSS-----------------------------------------------------------------------------------------------------E-------------------------------------------------------E-------------------------------------------------------E---------------XXXXX---------
X----------------XXX----------------------QQ---------QQ---------------------------------------------Q------------X-----------------------QQSQQQQ--------------EXX-----XX-X-----------------------QQS-QQQ--------------XX----------------------------------SS----------X--XXXXXX---------
--------------EXXXXX--------------E---E--------------------------------------------------------------------------X---------------------------------------XXXXXXXX--------X--------------------------------------------X----E-----X------------------------------------X-XXXXXXX---------
-----------------X-------------------<>-------------------------------------------------------------------------XX--------------------------------<>-----------XX-----XXX---------------------------------------------X---<>----XXX-----------------------------------XXXXXXXXX---------
-------------------------------------[]--------------EE---------------------------------------------------------XX-----E--------------------------[]-----------XX----XXXXXX----E-----------------------------------X------[]-X--XX--------------------------]---------XXXXXXXXX---------
XXXXXXX--XXXXXXX-XXXXXXXXXXXXXXXXXXXXXXXXXXXXXXXXXXXXXXX--------XX--XXXXXXXXXXXXXXXXXXXXXXXXX--XXXXXXXXXX----X-X-X-XXXXXXXX--XXXXXX-XXXXXXXXXXXXXXXX--XXX-----------X-X-XXXXXXXXXXX-XXXXXXXXXXXXXXXXXXXXXXXXXXXXX--X-----XXXXXXXXXX--XXXX-----XX----XXXXXXXXXXXXX---XXXXXXXXXXXXXX--XXXX
