----------------------------------------------------------------------------------------------------------------------------------------------------------------------------------------------------------------------------------------------------------------------------------------
----------------------------------------------------------------------------------------------------------------------------------------------------------------------------------------------------------------------------------------------------------------------------------------
----------------------------------------------------------------------------------------------------------------------------------------------------------------------------------------------------------------------------------------------------------------------------------------
-------------------------------------------X--------------------------------------------------------------------------------------------------------------------------------------------------------------------------------------------------------------------------------------------
-------------------------------------------X--------------------------------------------------------------------------------------------------------------------------------------------------------------------------------------------------------------------------------------------
----SS--SSSS-------------------------------X-------------------------S--------------------------EQQ-----------------------------------------------------------------------------------------------------------------------SSS---S-SSSSSSSSSS--SS-----------S----------------------------
------------------------------------------XX--------------------------------------------------------------------------------------------------------------------------------------------------------------------------------------------------------------------------------------------
-----------------------------------------XXX----------------------------------------------------------------------------------XXXXXX---------------------------------------------------X------------------------------------------------------------------------------------------------
----------------------------------------XXXX-------------XSSSS--------------------E---SSSSSSS------------------------------------------------------------------------------------------X------------------------------------------------------------------------------------------------
-------SS---SS-------------------------XXXXX------------------------SS-----------Q-------------SS?SS---------Q-----------------------------------E----------E---------------------------------------Q-Q---------------XX-----------?SSSSSS---------------------------------X------------
-------------------------[]-----------XXXXXX-----E-----<-------------------------E---------------------------------------------------E----------<>---------<>---E----------------------X--------------------------XXX-------------------------------------------------------------------
-------------------------XX----------XXXXXXX-----X-----[-----------------------------------------------------------------------X----<>-----[----[]---------[]--<>----------------------X--------------------------------------------------------------<--XX-----------------------------
-------------------------XX--E-E----XXXXXXXX-----X--E--[-------------------------------------E-------------------EE-EE----EE--EE----[]-----[----[]---------[]--[]--------E--------EE--EX------------------------------------------------------------E-E--XX-----------------------------
XXXXXXXXX--XX---XXXXXXXXXXXXXXXXXXXXXXXXXXXXXXXXXXXXXXXX----XXXX------XXXXXXXXXXXX--XXXXXXXXXXXXXXXXXXXXX--XXX--XXXXXXXXXXXXXXXXXXXXXXXXXXXX-XXXXXXXXXXXXXXXXXXXXX-XXXXXXXXXXXXXXXXXXXXXXXXXXXXXXXXXXXXXXX-XXXXXX---------------XXXXXXXXXXXXXX--XXX------XX-XXXXXX--XXXXXXXX---XXXXXXXXX
