X---------------------------------------------------------------------------------------------------------------------------------------------------------------------------------------------------------------------------------------------------------------------------------------
----------------------S----S------------------------------------------------------------------------------------------------------------------------------------------------------------------------------------------------------------------------------------------------------------
SSSSSSSSSSSSSSSSSSSSSSSSSSSS------------------------------------------------------------------------------------------------------------------------------------------------------------------------------------------------------------------------------------------------------------
SSSSSSSSSSSSSSSS----SSSSSSSS------------------------------------------------------------------------------------------------------------------------------------------------------------------------------------------------------------------------------------------------------------
SSSSSSSSSSSSSSSS----SSSSSSSS------------------------------------------------------------------------------------------------------------------------------------------------------------------------------------------------------------------------------------------------------------
SSSSSSSSSSS--SSS----------SS---------------X------------------------------------------------------------------------------------------------SSSS---SS-----------------------------------------------------------------E-------------------------X---------------------------------------
-S-S--------------------------------------XX--------------------------E-------------------------------------------------------------------------------------------------------------------------------------------------------------------------X---------------------------------------
----------S-------------------------------XX-------------------------XXXXXXX----------------------------------------------------------------------------------------------------------XXXXXX----------------------------------------------------XX--------------------------------------
----?------------------??----------------XXX----------------------------------------------------------------------------------------------------------------------------------------------------------------------------------------------------XX------------------------------------E-
-SSSSSSSSSSS-------E------XX------------XXXX----------------------------------S----------E---E------E----------E-----Q----------E-----------SSSS----------------------------------------------------X-------------XEXXX------------------------XXX--------------------------------------
-SSSSSSSSSS-------<>------------------XXXXXX---------------------------------E----------<>---E-----<>---------<>---------------<>---E-------------------------XX--------------------------------------------------XXXX-------------------X--EXXXXX---------E----------------------------
SSSSSSSSSSS-------[]--->---X---------XXXXXXX--------------------------------<>-----[----[]---------[]----<>---[]---------------[]---------------------------XXXX--------------------------------------------------X-------------------------XXXXXX----X---<>----------------------------
SSSSSSSSSSS-------[]--[]--XX--------XXXXXXXX--------E--E-EE-EE----E---EE----[]---E-[-E--[]-----E-E-[]----[]---[]---------------[]-----------------E--------XXXXX-------X-EE-EE--E-EEE-EE---------E-E----------------------------EE-E--------XXXXXX----X---[]----------------------------
XXXXXXXXXXXXXXXXXXXXXXXXXXXXXXXXXXXXXXXXXXXXXXXXXXXXXXXXXXXXXXXXXXXXXXXXXXXXXXXXXXXX-XXXXXXXXXXX---XX---XXXXXXXXXXXXXXXXXXXXXXXXXXXXXXXXXXXXXXXXXXXXXXXXXXXXXXXXXXXXXXXXXXXXXXXXXXXXXXXXXXXXXXXXXXXXXXXXXX---XXXXX----------X-X-XXXXXXXXXXXXXXXXX---XXXXX-XX------XX-X----XXXX-----XXX--
