----------------------------------------------------------------------------------------------------------------------------------------------------------------------------------------------------------------------------------------------------------------------------------------
----------------------------------------------------------------------------------------------------------------------------------------------------------------------------------------------------------------------------------------------------------------------------------------
-----------------------------------------------------------------------------------------------------------------S--------------------------SSSSSSSSSSSSSSSSSSSSSSSSSSSS--------------------------------------------------------SSSSSSSSSSSSSSSSSSSSSSSSSSSS----------------------------
----------------------------------------------------------------------------------------------------------------------------------------------------------------------------------------------------------------------------------------------------------------------------------------
----------------------------------------------------------------------------------------------------------------------------------------------------------------------------------------------------------------------------------------------------------------------------------------
------------------------------------------------------------X-------------------------------------------------------------------X-------------------------------------------------------------------------------------------------------S-----------------------------------------------
--------------------------------------------------------------------------------------------------------------------------------X-------------------------------------------------------X-----------------------------------------------------------------------------------------------
---------------XXXXX----------------------------------------------------XXXX-----------------------X----------------------------XX---------------------------S--------------------------------------------------------------------------------------------------------------X-----------
--------------------------------------------------------------------------------------------------XX----------------------------XX--------------------------XSSS--------------------------------------------------------------------------E--------------------------------XX-----------
-------------------------------------------------------------------------------------------------XXX------------<>----------X---XX---------E<>--------------------X----------------------------SSSSS-----E---E------E--------------S-----<>---------E------X---------------XX-----------
---------------------E----------------------E---------------------------------------------------XXXXX-----------[]-------E--X---X-----X---<>[]-------E-----------XX-------------------------------------<>---E-----<>---E------E---S-----[]--------<>------X--------------XXX-----------
--------------------<>---------------------<>-------------------------------------------------XXXXXXX-----------[]----------XXXXXX----X---[][]-----------XXXX>---XX------XX-----------------------------[]---------[]--<><>---<>---S-----[]--------[]------X-------------XXXX-----------
-EE-EE----EE--EE----[]E--------------E-----[]-------------E--EE-E-E-E------------E-E----------XXXXXXXX------E--E[]----------XXXXXX----X---[][]-----------XX-[]----X-------------E------------E-E--------[]---------[]--[][]---[]------E--[]--------[]----XXX-E-EE------E-XXXX-----------
XXXXXXXXXXXXXXXXXXXXXXXXXXXXXXXXXXXXXXXXXXXXXXXXXXXXXXXXXXXXXXXXXXXXXXXXXXXXXXXXXXXXXXXXX---XXXXXXXXXXXXXXXXX-XXXXXXXXXXXXXXXXXXXXX---XXX-XXXXXXXXXXXXXXXXXXXXXX--XXXXXXX---XXXXXXXXXXXXXXXXXXXXXXXX-XXXXXXXXXXXXXXXXXXXXXXXXXXXXXXXXXXXXXXXXXXXXXXXXXXXXXXXXXXXX--XXXXXXXXXXXXXXX--XXXX
