----------------------------------------------------------------------------------------------------------------------------------------------------------------------------------------------------------------------------------------------------------------------------------------
------------------------------------------------------------------------------------------------------------------------------------------------------------------S---------------------------------------------------------------------------------------------------------------------
--SSSSSSSSSSSSSSS---SSSSSSSS----------------------------------------------------------------------------------------------------------------SSSSSSSSSSSSSSSSSSSSSSSSSSSS----------------------------------------------------------------------------------------------------------------
--SSSSSSSSSSS-S------S----SS------------------------------------------------------------------------------------------------------------------SSSSSSSSSSSSSS-----SSSSSSS----------------------------------------------------------------------------------------------------------------
--SSSSSSSSS-S-------SS----SS----------------------------------------------------------------------------------------------------------------S-SSSSSSSSSSSSS------SSSSSS-----------------------------------------------------------------------------------------------------------------
SSSSSSSSSSSS-SSS----------SS---------------------------------------------E----------------------------------SSSS----------------------------SSSSSSSSSSS--SSS------SSSSSS---------------------------X------------------------------------------------------------------------------------
--------------------------------------------------------------XX------------------------------------------------------------------------------------------------------------------------------------------------------------------------------------------------------------------------
-----------------------------------------XX---XX--------------------------------------------------------------------------------------------------------------------------------------------------------------------------------------------------------------------------XX------------
----E-------------------------------------------------------------------------------------------------------------------------------------------E------------------SS--------------------------------XXXXX---------------------------------------------------------------XXX------------
---SSSSSSSS---------------------------------------SS-------------------XXXX---------------------SS--------------SSS---------------XX----------SSSSSSSSS--------E-----------------------------SSSSSSS------------XX--------------------Q---------E-----------------------XXXX------------
--E---------------<>------------------------E------------------------------------------------------------------------------------XXX----------SSSSSSSS--------<>------------------------------------------------------------X------------------<>---------------------XXXXXX-----------<
---S-X------------[>--------------------------------------XX-------------------------------------------------------------------XXXXX-------X--SSSSSSSS--------[]-------------------------------------------------------------------------------[]--------------------XXXXXXX-----------[
------------------[]E---------E-EE----E-----------E--E-E-----------------------------------------------------------------------XXXXX-----XXX---SSSSSSS--------[]---------------EE------------E-E-----------------------------------------------[]-E-----------------XXXXXXXX--------E--[
XXXXXXXXXXXXXXXXXXXXXXXXXXXXXXXXXXXXXXXXXXXXXXXXXXXXXXXXXX----------XXX-----XXXXXXXXXXXXXXXXXXXXXXXXXXXXXXXX-XXXXXXXXXXXXXXXXXXXXXXXXXXXXXXXXXXXXXXXXXXXXXXXXXXXXXXXXXXX---XXXXXXXXXXXXXXXXXXXXXXXXX------XX----------X---------XXXXXXXXXXXXXXXXXXXXXXXX-XXXXXXXXXXX-XXXXX---XXXXXXXX-XX
