----------------------------------------------------------------------------------------------------------------------------------------------------------------------------------------------------------------------------------------------------------------------------------------
----------------------------------------------------------------------------------------------------------------------------------------------------------------------------------------------------------------------------------------------------------------------------------------
----------------------------------------------------------------------------------------------------------------------------------------------------------------------------------------------------------------------------------------------------------------------------------------
------------------------------------------------------------------------------------------------------------------------------------------------------------------------------------------------------------------<>-------------------------------------------------E------------------
------------------------------------------------------------------------------------------------------------------------------------------------------------------------------------------------------------X-----[]-------------------------------------------------XX-----------------
------------------E-----------------------------------------------------------------------------------X-------------------------------------------------S-------------------------------------------X---S??-E?-------??SSS-------------Q--QQQ--------------S------------EQQ-------------
-------------------------------------------------------------------------X---------------------------XX---------------------------------------------------------------------------------------------------------------------------------------------------------------------------------
-------------------------------------------XXX-------------------------XXX--------------------------XXX------------------------------------------------------------------------------------------------E--------------------------------------------------------------------------------
----------------------------------------------------------------------XXXX----------SS-------------XXXX------------------------------------------E----------E---------------------------------------X-XX------------------------------------------------------SSSSSSS-----------------E-
--------------XXXX---------------------------------------------------XXXXX----------E------------XXXXXX------------------------------S----------<>---------<>----------E----------------------------------------XXX----------X------E-Q---QQQQ-QQQ----------------------S?SS---------QQ-
-------------XXXXX---------------------X---------E------------------EXXXXX----------X------------XXXXXX-----------------------------------------[]---------[]---------<>----------------------------------------------------XXXX--------------------------------------------------------
------------XXXXXX-------------------------X----<>-----------------XXXXXXX----------------------XXXXXXX-----------------------------------------[]---------[]----<>---[]-----------------------------------------------------X---------------------------X------------------------------
----------XXXXXXXX-----------EE-E---E-EEE-EE----[]-----E----------XXXXXXXX--------------------XXXXXXXXX---------------------EE-------E-E--------[]---------[]----[]---[]------------------------------------------------E-E------------------------------X-----------E------------------
XXXXX----XXXXXX-------------XXXXXXXXXXXXXXXXXXXXXXXXXXXXXXXXX--XXXXXXXXXXXXXXX--XXXXXXXXXX--XXXXXXX--XXXXX--XXXX-----X--XXXXXXXXXXXXXXXXXXXX-XXXXXXXXXXXXXXXXXXX-XXXXXXXXXXXXXXXX---XXXXXXXXXXXXXXXX------XXXXX-----XXXXXXXXXXX-XXXXXXXXXXXXXXXXXXXXX--XXXXXXXXXXXXXXXXXXXXXXXXXXXXXXXXX
