----------------------------------------------------------------------------------------------------------------------------------------------------------------------------------------------------------------------------------------------------------------------------------------
--------------------------------------------------------------------------------------------------------------------------------------------X-------------------------------------------------------------------------------------------------------------------------------------------
---------------------------------------------------------------------------------------SSSSSSSSS-----------S--SS------------------------------------------------------------------------------------SS----------------------------------------------------------------------------------
---------------------------------------------------------------------------------------S---SS-------------------------------------------------------------------------------------------------------------------------------------------------------------------------------------------
---------------------------------------------------------------------------------------S---SS-----------------S------------------------------------------------------------------------X------------------------------------------------------------------------------------------------
------------SS-----------------------------------------X------------------S----------SSSSSSSSS---SSS----------SS-----------------------------------------------------------------------X-S----------------------------------------------------------------------------------------------
--------------------------------------------------------------------------------------------------------------------------------------------------------------------------------------XX-----------------------------------------------------------------------------------X------------
--------------------------------------------------------------------------X---------------------------------------------------------------------------------E------------------------XXX----------------------------------------------------------------------------------XXX-----------
-XXXX---------------------------------------------------------------------X------------E---------------------------------------------------------E---------X------------------------XXXX----------------------E------------E----------------------------------------------XX------------
------------SSS----------X-------------------------S-------------------X--X----------SSSSSSSSS---------E------X-------Q----QQ--QQ---------------<>---------------------E-----------XXXXX-----------------S---<>-----E-----<>----------------------------------------------XX------------
------------------------XXX-------------------------------------------EXXXX-------------SSSSS---------<>----------------------------------------[]----------E----E----<>----------XXXXXX-----E---------------[]----<>---E-[]---E-------------------------------------------X-----E------
----------------------------------------------------------------------XXXX-------------SSSSS--------X-[]----------------------------------------[]---------<>---<>----[]---------XXXXXXX----<>-----[---------[]----[]--<>-[]--<>------------------------------------------XX-----X------
--------------------------------------E---------------------------------------------------------------[]E---------------------------------------[]---------[]---[]----[]-E-EE---XXXXXXXX----[]-----[---------[]----[]--[]-[]--[]-----------------------------E--E------E--XX------------
XXXXXXXXXX--XXXXXXXXXXXXXX----XXXXXXXXXXXXXXXXXXXXXXXXXXXXXXXX---XXXXXX----XXXXXXXXXXXXXXXXXXXXXXXXXXXXXXXXXXXXXXXXXXXXXXXXXXXXXXXXXX--XXXXXXXXXXXXXXXXX-XXXXXXXXXXXXXXXXXXXXXXXXXXX-XXXX-XXXXXXXXXXXXXXXXXXXXXXXXXXXXXXXXXXXXXXXXXXXXXX------XXXXXXXXXXXXXXXXXXXXXXXXXXXXXXXXXXXX-XXXXX
