----------------------------------------------------------------------------------------------------------------------------------------------------------------------------------------------------------------------------------------------------------------------------------------
-----------------------------------------------------------------------E----S------S----------------------------------------------------------------------------------------------------------------------------------------------------------------------------------------------------
----------------------------------------------------------------------<>----SS----SS----------------------------------------------------------------------------------------------------------------SSSSSSSSSSSSSSSSSSSSSSSSSSSSSSSSSSSSSSSSSSSSSSSSSSSSSSSS----------------------------
-------------------------------------------------------------S--SS---S[]----SS---SSS----------------------------------------------------------------------------------------------------------------------------------------------------------------------------------------------------
----------------------------------------------------------------------[]----SS---SSS-X-XXXX---------------------------------------------------------------------------------------------------------------------------------------------------------------------------------------------
--------------------------------------------------------X--SSSSSSSSSSSSS----SSS-SSSSS---------------------SSSS---------------------------------------------------------------------------------XX-----------------------------------------------------------Q---------------------------
--------------------------------------------------------XE------------------------------------------------------------------------------------------------------------------------------------------------------------------------------------------------------------------------------
-----------------------------------------XX-XXXX--------X------------------------------------------------------------------------------------------------------------------------------------------------------------S------------------------------------------------------------------
--------------------------------------------------------X-----------------------------------------------------------------E------------E----------------------------------------------------------------------------XXXS--------E---------E------SSS------------------------------------
-------------XXX----------------------------------S---------SSSSSSSSQS-----------XXXXXXXX-------------XX-X---------------<>-----------<>---------E----------E----------E----------------------------<>------QQS------X----X----->--S-----<>------------------------------X-XX-----------
-----------XXXX-----------------------------E----E-----------------------------------------E---EXXXXX---------------------------------[]--------<>---------<>------E--<>----------------------------[]---------------]----X--------------[]---------?------X----------------------------
-----------XXX-----------------------------<>---------------------------------------------XX------------------------------------------[]--------[]---------[]-----<>--[]----------------------------[]----------XXXX[]-X-XX----XSS-------[]--------EX-----XX----------------------------
---------XXXXX----------E-----E-EE----E----[]-----E--E-E-------------------EE-E--------------------X---------------------E------------[]--------[]-----E---[]-----[]--[]----------------------------[]----E-----XXX-[X----X----XS--------[]--E-----------XXX------------E----------E----
XXXXXXX-XXXXXX---XXXXX--X---XXXXXXXXXXXXXXXXXXXXXXXXXXXXXXXXXXXXXXXXXXXXXXXXXXXXXXXXXXX-----XXXX----------------XXXXXXXXXXXXXXXXXXXXXXXXXXXXXXXXXXXXXXXX-XXXXXXXXXXXXXXX-------XXXXXXXXXXXXXX-----XXXXXXXXXXXXXXXXXXX---XXXXXXXXXXXXXXXXXXXXXXXXXXXX--XX--XXX---XX--XXXXX---------------
