----------------------------------------------------------------------------------------------------------------------------------------------------------------------------------------------------------------------------------------------------------------------------------------
-----------------------------------------------------------------------------------------------------------------------------------------------------------------------------------------------------------------------------------------------------------S----------------------------
---------------------------------------------------------------------------------------------------------SSSSSSS-------------------------------------------------------------------------------------------------------------------------------------S-----S----------------------------
-----------------------------------------------------------------------------------------------------------------------------------------------------------------------------------------------------------------------------------E----------------SS---S-S----------------------------
-------------------------------------------------------------------------------------------------------------------------------------------------------X-------------------------------------------------------------------------XXXXXXX------------SS---SSS----------------------------
--------------------------------------------S---------------------ESS--------------------------SS-------------------------------------------------------------------------------------------------------------------------------?----------------??SSS---------------------E------------
----------------------------------------------------------------------------------------------------------------------------------------------------------------------------------------------------------------------------------------------------------------------------------------
-----------------------------------------------------------------------------------------------------------------------------------------------------------------------------------------------------------------------------------E----------------------------------------XXXX--------
-----------------------E--------------------XE------------------------------------------------E-----------------------------------------------------------------------------------E------------E-----------------------------------X----------------------------------------------------
------Q----Q---<>-----<>----<E---E------X---X-------------E--QQ--S??----E-------------E--E---<>-----E------------------------X-XX-------------------------Q-----------E------S---<>-----E-----<>---------------------------------XXXXS--------E----XXX---XXX------------X---------------
---------------[]-----[]--E-<>--<>---X--X--XX----X-----E-<>------------<>---E--E--------<>---[]----<>---E-------------------XX--------------------E---E--------------<>--<>------[]----<------[]-------------------XX-----------------SX---EXX------------XX-----------XXX--------------
---------------[]-----[]----[]--[]------XXXXX----XX---XX-[]--X---------[]-----<>--------[]---[]----[]--<><------------------XX-----------------------<>--------------[]--[]------[]----[------[]-------------------XX----------------SSX--------X--------XX------------XX---------------
---------------[]-----[]----[]--[]------XXXXX----XX----X-[]------------[]--E--[]--------[]---[]----[]--[][-----------------XXX----------EE-E-------E-[]--------------[]--[]------[]----[------[]-------------------XX--------------------------XX---XXX-------E--EE-EXXXX-EE------E-EE-E
XXXXXXXXX--XXXXXXXXXXXXXXXXXXXXXXXXXXXXX--XXX---XXXXXXXX-XXXXXXXXXXXXXXXXXXXXXXXXXXX--XXXXXXXXXXXXXXXXXXXXXXXXXXXXXXXXX---XXXX----XXXXXXXXXXXXXXXXXXXXXXXXXXXXXXXXXXXXXXXXXXXXXXXXXXXXXXXXXXXXXXXXXXXXXXXXXXXXXXXXXXXXXX-------XXX--------------------------XXXXXXXXXXXXXXXXXXXXXXXXXXXX
