----------------------------------------------------------------------------------------------------------------------------------------------------------------------------------------------------------------------------------------------------------------------------------------
----------------------------------------------------------------------------------------------------------------------------------------------------------------------------------------------------------------------------------------------------------------------------------------
----------------------------------------------------------------------------------------------------------------------------------------------------------------------------------------------------------------------------------------------------------------------------------------
---------------------------------------------------------E----E-------------------------------------------------------------------------------------------------------------------------------------------------------------------------------------------------------------------------
------------------------------------------E--------------XXXXXXXX---------------------------------------------------------------------------------------------------------XXX----------------E-----------------X------------------------------------------------------------------------
--------------------------------------------------------?----------------SSSSXXX---------------------------------XXXXX---------E------------------------------X---XXX---?--S---------------SSSSSSS---------------------------------------------E----------------------------------------
----------------XXXX--------------X--------------XXXXX--------------------------------------------------------------------------------------------------------X-------------------------------------------------------------------------------E-----------------------------------------
-------------------------------------------------------------------------------------------------------------------------------------------------------------XX-------------------------------------------------------------------------------XXXXXX------------------------------------
--------------------------------------------------------------------------------------------------------------------------------------------SS---------------XX------------X----------------------------------------------------------------X-------------------------------------------
------------------------SSSS--------------XXXX----------XXXXX------------XXXXX--------------------------SS-SSSSS------------X---------------E---------------XXX----------XXXX--------XX------X---------------------QQ-----------------------X---------------X-----------------EX--------
-------------------------------------------------------------------EXXX-----------------------------------------------------X-----------------------------XXXXXX---------------E---EX------------------------------------------------------XXX-------E------X-------------EXXXXX--------
XXX------------------------------------------------------------------------------------------------------------------------XXX--------------X-------------XXXXX---------------XX--------X-------------------------------------------------XXX?------<------[----------------------------
XX-----EE--------------------------------E-------E------------------------------------------E-------------------------E-EX--X---------EEEE-E--------------XXXXX-------------------------X--------------------E-------------------EE-EEE-XXXXX-EE--------EE-E----------------------------
XX-XXXXXXXXXXXXXXX---XXXXXXXX----X--XXXXXX-------X--X-XX----------------------------XXXXXXXXXXXXXXXXXXXXXXXXXXXXXXXXXXXXXXXXXXXXXXXXXXXXXXXXXXXXX--XXXXXXXXXXXXX-----XXXX------XXX------------------XXXXXXXXXXXXXXXXXXXX--XXXXXXXXXXXXXXXXXXXXXXXXXXXXXXXXXXXXXXXXX---XXXXX------XXXXXXX
