----------------------------------------------------------------------------------------------------------------------------------------------------------------------------------------------------------------------------------------------------------------------------------------
--------------------------------------------------------X-------------------------------------------------------------------------------------------------------------------------------------------------------------------------------------------------------------------------------
SSSSSSSSSSSSSSSSSSSSSSSSSSSS----------------------------SSSSSSSSSSSSSSSSSSSSSSSSSSSS----------------------------------------------------------------------------------------------------------------------------------------------------------------------------------------------------
-------------------------------------SS-S-----------------------------------------------------------------------------------------------------------------------------------------------------------------------------------------------------------------------------------------------
-------------------------------------SSS------------------------------------------------------------------------------------------------------------------------------------------------------------------------------------------------------------------------------------------------
----------------------------------SSSSSSS-------S------------------------------------SSSSSSSSSSS-------------------------------------------------------------XX---------X-----------SSS----------S--S---------------------SSS--------------------------------------QQQQQQ-----------SSSS
----------------------------E------------------------------------------------------------------------------------------------------------------------------XXXX-------------------------------------------------------------------------------------------------------------------------
----------------------------X---------S-------------------------------------------------------------------------------------------------------------------XXXXX-------------------------------------------------------------------------------------------------------------------------
----------E---------------------------S------------E--?-----------E------SSS-------------------------------E---------------------------------------------XXXXXX---------XXXXX-----------------------------------------------------------------------------------------------------------
---S----SSS---------E---------E--SSSSSSS----------<>----<>---S---<>-----------X---------SSSSSSS-----------<>----------------X-------------------------X--XXXXX-----------------S?---SSS-------------QQQQ--------------XXX---------------------XXX----------------QQ---QQQ--?------------
---------S---------<>------X-<>-------------------[]----[]-------[]----------XX----E--E-------------------[]---------------XXX------------------------XXXXXXXX----------------------------------XXXX-------E------XXXXXXX--------------------XX--------------<>-------------------------
---------S---------[]-------X[]--X----------------[]----[]-------[]---X-E--EXXX---<>------------------X---[]---------------XXX-----------------------XXXXXXXXXX-------------------------------------------<>--------XXXXX--------------------XX--------------[]-------------------------
------E--S---------[]--------[]------E--------EE--[]----[]--E----[]--XX------XX---[]------------------E---[]------------EXXXXX----------EE-E---------XXXXXXXXXX-----E-------------------------------]-----[]-------XXXXXX------------------X------------E-EE-[]---------------EE--------
XXXXXXXXXXXXXXXXXXXXXXXXXXXXXXXXXXXXXXXXXXXXXXXXXXXXXXXXXXXXXXXXXXXX--XXX---XXXXXXXXXXXXXXXXXXXXXXXXXXXXXXXXXXXXXXXXXXXXXXXXXX-X--XXXXXXXXXXXXXXX---XXXXXXXXXXXXXXXXXXXX----XXXXXXX----XXXXXXXXXX---XXXXXXXXXXXXXXXXXXXX----XXXXXXXXXXX---XXXXX---XXXXXXXXXXXXXXXXXXXXXXXXXXXXXXXXXX-XXX
