----------------------------------------------------------------------------------------------------------------------------------------------------------------------------------------------------------------------------------------------------------------------------------------
--------------------------------------------------------------------------------------------------------------------------------------------------------------------------------------------------------------------------------X-------------------------------------------------------
-----------------------------------------------------------------------------------------------------------S----------------------------------------------------------------------------------------------------------------------------------------------------------------------------
---------E------------------------------------------------------------------------------------------------------------------------------------------------------------------------------------------------------------------------------------------------------------------------------
---------XXX----------------------------------------------------------------------------------------------------------------------------------------------------------------------------------------------------------------------------------------------------------------------------
-------------------------------------------------------------------------------------------------------------------------------XXS------------------------------------------------------------------------------------------------------------------------------------------------------
------------------------------------------------------------------------------------------------------------------------------XXX-------------------------------------------------------XXXX--------------------------------------------------------------------------------------------
-----------------------------------------------------------------------------------------------------------------------------XXXX------------------------XX--XXX---------------------------------------------------------------------E----------E---------------------------------------
----------------------------------------------------------------------------------------------------------------------------XXXXXE----------------------------------------------------------------E----------------------------------E---------<>---------------------------------------
---------------Q----------E--------------------------------------------<>----------------E----------E------------E---------XXXXXX---------------------------------S------X-----------------------QQS------Q---------E---------------<>---------[]---------------------------------------
----------E--------------<>---------------------------E----------------[]---------------<>---E-----<>-----------<>-------XXXXXXXX----X----------------E-----E------------X-----------------------------------------<>---------------[]---------[]----E----------------------------------
---------<>--------------[]--------------------------<>----------------[]---------------[]---------[]----<>------]-------XXXXXXXX----X----------------E-----------------XXXX---------------------------------------[]---------------[]---------[]---<>-------------------X--------------
---------[]--------------[]--------------------------[]----------------[]-----------EE--[]-----E-E-[]----[]-----[]-EE----X-XXXXXX----X-----X--E--E----S-----------EE-E-EXXXX---------------------------------------[]-E-------------[]---------[]---[]------------------E---------------
XXXXXXXXXXXXXXXXXXXXXXXXXXXXXXXXXXXXXXXXXXXXXXXXXXXXXXXXXXXXXXXXXXXXXXXXXXXX--XXXXXXXXXXXXXXXXXXXXXXXXXXXXXXXXXXXXXXXXXXXXXXXXXXXXXX-XXXXXXXXXXXXXXXXXXXXXXXXXXXXXXXXXXXXXXXXXXXXXX--XXXXXXXXXXXXXXXXXXXXXXXXXXXXXXXXXXXXXXXXXXX-XXXXXXXXXXXXXXXXXXXXXXXXXXXXXXXXXX-XXXXXXXXXXXXXXXXXXXX
