----------------------------------------------------------------------------------------------------------------------------------------------------------------------------------------------------------------------------------------------------------------------------------------
----------------------------------------------------------------------------------------------------------------------------------------------------------------------------------------------------------------------------------------------------------------------------------------
----------------------------------------------------------------------------------------------------------------------------------------------------------------------------------------------------------------------------------------------------------------------------------------
----------------------------------------------------------------------------------------------------------------------------------------------------------------------------------------------------------------------------------------------------------------------------------------
--XXXXX-----------------------------------------------------XX-----------------------------------------------------------------------------------------------E--------------------------------------------------------------------------------------------------------------------------
-----------------SSSSSSSS------------------------------------------------------------XXX-----------------------------------------------------------------E----------------XX----------------------------------------------------X---SSSSSQSSS-------------------------------------------
--------------------------------------------------------------------------------------------------------------------------------------------------XX------------XX--X-------------------------------------------------------------------------------------------------------------------
--------------------------------------------------------------------------------------------------------------------------------------------------------------------------------------------------------------------------------X-------------------------------------------------------
----------------------------------------------------------------------------------------------------------------------------------------------------------------------XX--------------------------------------------E-----------X-------------------------?-----------------E-----------
XXXXX-------------XXXX----XX----------------E-----------XQQ--------------XEXXX------------------------------------------------------------E---XX------------XSS------------------------------------------E---------<E-----------------SSSSSSQS-----------<>------E---------<>----------E
-------E---EXXX----------------------------<>------------------------XXXXXXXX------------------------------------X-----------------------<>--XXX--------------------------------------------------------<>---------[>---E------------------------------E-[]-----<>---------[]------E--<>
------XX-----------------------------------[]------------------------------X-------------------------------------------------------------[]--XXX--------------------------------------------------------[]---------[]---------------------------------[]-[]-----[]---------[]-----<>--[]
---------------XX---X-X---------E----------[]-----------------------------------------------E--------------------X-----------------------[]---XX--------------------------------E---E----------E-E------[]---------[]------------------------------EE-[]-[]-----[]---------[]-----[]--[]
XXX---X--------XXXXXXXXXXXXXXXXXXXXXXXXXXXXXXXXXX--X-XXXXXXXXXX---XXXX-----XXXX-XXXXXXXXXXXXXXXXX--X----------X-XXXXXXXXX------X--------XXXX----------------------------XXXXXXXXXXXXXXXXXXXXXXXXXXXX-XXXXXXXXXXXXXXXXXXXXX-XXXXXXXXXXXXXXX--XXX-XXX-XXXXXXXXXXXXXXXXXXXXXXXXXXXXXXXXXXXX
