------------------------------------------------------------------------------------------------------------------------------------------------------------------------X---------------------------------------------------------------------------------------------------------------
------------------------------------------------------------------------------------------------------------------------------------------------------------------------------------------------------------------------------------------------------------X---------------------------
--------------------------------------------------------------------------------------------------------------------------------------------SSSSSSSSSSSSSSSSSSSSSSSSSSSSSSSSSSSSSSSSSSSSSSSSSSSSSSSS--------------------------------------------------------SSSSSSSSSSSSSSSSSSSSSSSSSSSS
------------------------------------------------------------------------------------------------------------------------------------------------------------------------SSSSSSSSSSSSSSS--------S--SS------------------------------------------------------------------------------------
------------------------------------------------------------------------------------------------------------------------------------------------------------------------SSSSSSSSSSSSSS------------S----------XXX------------------------------------------------------------------------
----------------------XXXX-------SSSSSSSS-----------SSSS-------------------------------------------------------------------------------------S-----SS--------------------SSSSSSSSSS--S------------SS----------------------------S-SSSSSSSS----SS----SS-----S----------------------------
------------------------------------------------------------------------------------------------------------------------------------------------------------------------ES-S------------------------------------------------------------------------------------------------------------
----------------------------------------------------------------------XX----------------------------------------------------------------------------------------------------------S-----------------------------------------------------------------------------------------------------
---------------------------------------------------------------------XXXX---------------------------E--------------------------------------------------------------E--------E-----S------------SS--------S----------E-------------EE----------------------------------E-----------------
X--------------XXXXXXX-----------SSSSSSS-----------------------------XXX-----------------E---------<>----------ESQQQ--------------XXX-------SSSSS--SS----------XX-<>---X---SSSSSSSSS--------E------X----E------E--QQQ---------E----?SSSSS-----E-----------X------S---[]----------------X
------------------------------------------------------------------XXXXXXX---------------<>---------[]------E--<>-------E---------XXXX--------------S---------X-XX-[]---X-SSSSS--SSS--------<>------X--------------------------E------------------------------<>------[]---------E------X
-----------------------------------------------------------------XXXXXXXX---------------[]---------[]-----<>--[]------<>--------XXXXX-------------<>--------XXXXX-[]---XSS?SSSSSSSS--------[]------X-------------------------[]-----------------------------S[]------[]--------<>------X
----------------------------------------------EE----------------XXXXXXXXXX------E-------[]---------[]-----[]--[]------[]-------XXXXXX------X]-----[]-------XXXXXX-[]--XXSSSSSSSSSSS--------[]------X---------E---------E-----[]---------------------E-E-----S[]------[]--------[]------X
-----------XXXX---XXXXXXXXXXXXXXXXXXXXXXXXXXXXXXXXXXXXXXXXXXXXXXXXXXXXXXXXXXXXXXXXXXXXXXXXXXXXXXXXXXXX----XXXXXXXXXXXXXXXXXXXXXXXXXXXXXXXXXXXXXXXXXXXXXXXXXXXXXXXXXXXXXXXXXXXXXXXXXXXXXXXXXXXXXXXXXXXXXXXXXXXXXXXXXXXXXXXXXXXXXXXXXXXXXXXXXXX---XXXXXXX--XX-XXXXXXXXXXXXXXXXXXXXXXXXXXXX
