------------------------------------------------------------------------------------------------------------------------------------------------------------------------------------------------------------------------------------------------------------X---------------------------
----------------------------------------------------------------------------------------------------------------------------------------------------------------------------------------------------------------------------------------------------------------------------------------
------------------------------------------------------------------------------------SSSSSSSSSSSSSSSSSSSSSSSSSSSSSSSSSSSSSSSS--------------------------------------------------------------------------------------------------------------------------------SSSSSSSSSSSSSSSSSSSSSSSSSSSS
------------------------------------------------------------------------------------------------------------------------------------------------------------------------------------------------------------------------------------------------------------SSS----SSS------------------
------------------------------------------------------------------------------------------------------------------------------------------------------------------------------------------------------------------------------------------------------------SSS----SSS?-----------------
----------------------------------------------------------SSSSSSSS-----S-------SSSSS---------------------------------------------------------------SQSSSS-------------------------SSSS--------------Q-------------------------------------------------XXXX---SSS---SS----S--------------
----------------------------------------------------------------------------------------------------X---------------------------------------------------------------------------------------------------X------------------X------------------------------------------------------------
-----------------------------------------------------------------------------------------------------S----------------------------------------------------------------------------------------------------------------------------------------------------------------------------------
----------------------------------------------------------------------------------------------------XXXS-----------------------------------------------------------E-----XXSX---------------------E--------------------------------------------------------------------------------SS---
---------------<X-------------------------------------E----SS--SS-------------------<>------Q--------X----X-------------QQ--------------------E--SS--SSS----------<>-----------S?--SSSSS---------<>--------------XXXXX----------Q-Q-------------------------SSSSS--SSSS---------?------X
---------------XX------------------------------------<>-----------------------------<>--------------XX---XX----------------------X---------X-<>-------------------[]-----------------------------[]------------------------------------------XXX------------X--S---SSS---------XX------X
---------------[]------------------------------------[]-------------------X---------[]----------XXXXXX---XX---------------------XX-X--X---XX-[]--X----------------[]-----------------------------[]------------------------------------------------------------SS-SSSSS-----<>-[X-------
-----------E---[]------------------E-E---------------[]-------------------X---------[]----------XXXXXX---XX-----------E-------X-[X----X---XX-[]---------------EE--[]-----------------------E-----[]---------------------------------------------------------E--SSSSSSS------[]-[X-------
XXXXXXXXXXXXXXXXXXXXXXXXXXXXXXXXXXXXXXXXXXXXXXXXXXXXXXXXXXXXXXXXXXXXXXXXXXXXXXXXXXXXXXXXXXXXXXXXXXXXXX--XXXXXXXXXXXXXXXXXXXXXXXXXXXXX-XXXXXXXXXXXXXXXXXXXXXXXXXXXXXXXXXX--XXXXXXX---XXXXXXXXXXXXXXXXX--------XXXX---------------XX------XXXX----------------XXXXXXXXXXXXXXXXXXXXXXXXXXXX
