----------------------------------------------------------------------------------------------------------------------------------------------------------------------------------------------------------------------------------------------------------------------------------------
----------------------------------------------------------------------------------------------------------------------------------------------------------------------------------------------------------------------------------------------------------------------------------------
----------------------------------------------------------------------------------------------------------------------------------------------------------------------------------------------------SSSSSSSSSSSSSSSSSSSSSSSSSSSS--------------------------------------------------------
----------------------------------------------------------------------------------------------------------------------------------------------------------------------------------------------------------------------------------------------------------------------------------------
----------------------------------------------------------------------------------------------------------------------------------------------------------------------------------------------------------------------------------XXXXXXX-----------------------------------------------
----------------------------------------------------------------------------------------------------------------------------------------------------------------------X-------------------S------------------------------------------------------SSSSSSSSS------------------------------
----------------------------------------------------------------------------------------------------------------------------------------------------------------------------------------------------------------------------------------------------------------------------------------
------------------------------------------------------------------------------------------------------------------------------------------------------------X----------------------------XX---------------------------------------------------------------------------------------------
----------------------------------------------------------------------------------------------------------------------------------------------------------------------------------------XXX-------------------E-------------------------------------------------------------------------
--------------------------------------------------------------------------------SSS------------------------------------------------------SSS-----------------------S--------------S-----XXX---X----------S---<]------------------XXXX---------X-----XX--------------------XXXXXX--------
------------------------------------------------------------------E-------------------------------------------------------------------------------------X-------------------------------XXX---X------<>------[]---------E------X--------------------------------------------------------
-------------------------XX--------------------------------------<>-------------------------------------------------------------------------------------X-----------------------------XXXXX-------XXS[?------[]--------<>------X--------------------------------------------------------
-----------------------------------------------------------------[]-----------------------------EE---------E-----------E-EE------------E--E---E---E-E-EEX-E------EE-EE--]------------XXXXXX-------XX-[]------[]--------[]----------------------X----------------------------------------
XXXXXXXXXX-XXXXXXXXXX----XX-XXXX-XXXXXXXXXXXX----XXXXXXXXXXXXXXXXXXXXXXXXXXXXXXXXXXXXXXXXXXXXXXXXXXXXXXXXXXXXXXXXXXXXXXXXXXXXXXXXXXXXXXXXXXXXXXXXXXXXXXXXXXXXXXXXXXXXXXXXXXXXXXXXXXXXXXXXXX---XX----XXXXXXXXXXXXXXXXXXXXXXXXXXXX--------XXX-----------------XXXXXXX-------X----XXXXXXXXX
