----------------------------------------------------------------------------------------------------------------------------------------------------------------------------------------------------------------------------------------------------------------------------------------
----------------------------------------------------------------------------------------------------------------------------------------------------------------------------------------------------------------------------------------------------------------------------------------
--------------------------------------------------------------------------------------------------------------------------------------------SSSSSSSSSSSSSSSSSSSSSSSSSSSS-----S-SSSSS------------------------------------------------------------------------SSSSSSSSSSSSSSSSSSSSSSSSSSSS
--------------------------------------------------------------------------------------------------------------------------------------------SSS----SSSS-----------------------------------------------------------------------------------------------------SSS----SSS------------------
------------------------------------------------------------XXX------------------------------XXX---------------------------------------------------SSSS-----------------------------------------------------------------------------------------------------SSS----SSS?-----------------
--------------------------------------------------------E----------------------------------------QQ---------SSSXX---SSSSQQSSSSS----------------S---SSSS---------------S-----------------XX-----------------------------------------SSSSSSSSSS-SS------------[SSS---SS-------------------
----------------------------------------------------------------------------------------------------------------------------------------------------------------------------------------XX-------------------------XXX------------------------------------------------------------------
-------------------------------------------XXXXX----------------------------------------------------------------]-------------------------------------S---------------------------------XX------------------------XXX-------------------------------------------------------------------
-----------------------------------------------------------------------------------------SS---------------------X-X-----------------------E-----E-----E------------SS------------------XXXX----------------------XXXXX---------------------------------E---------------------------SS---
--------------------------------------------------------X---------------XXXX-------------------EQQQQQQ------S---------SS?S-SSSS----------<>----SSS-SSSSS--------E---------------Q-X-----XX----X------------------XXXX---------------SSSSSSSS----------<>----SSSSS--SSSS---------E------X
----------E--------------------------------------E------X------------XXXXX-X-------------------------------------------------------------[]-SSSSSS--SSS--------<>------X------------EXX-XX----X----E----------XXXXXXXX--------------------------------[]-------SS--SSSS--------<>------X
---------<>--------------------------------------------[---------------------------------------------------------------------------------[]-SSSSSSSSSSS--------[]------->-----------XXXXXX----X---XX---------XXXXXXXXX---------[----------------------[]-X---]SSS-SSSSS-----<>-[]-------
---------[]--------------EE--EE-E---E-EEE-EE--------EE-[-------------------------------------E--------E----------------------------EE-E--[]-SSSSSSSSSSS--------[]-------EE-E--------XXXXXX----X---XX---E----XXXXXXXXXX------E--[--------------------E-[]-X--S-SSSSSSSSS-----[]-[]-------
XXXXXXXXXXXXXXXXXX----XXXXXXXXXXXXXXXXXXXXXXXXXXXXXXXXXXXXX-------XX--------------X-XXXXXXXXXXXXXXXXXXXXX--XXXXXXXXXXXXXX---XXXXXXXXXXXXXXXXXXXXXXXXXXXXXXXXXXXXXXXXXXXXXXXXXXXXXXXXXXXXXX---XXXXXXXXXXXXXXX-XXXXXXXXXXXXXXXX-XXXXXXXXXXXXXXXXXXXXX-XXXXXXXXXXXXXXXXXXXXXXXXXXXXXXXXXXXX
