----------------------------------------------------------------------------------------------------------------------------------------------------------------------------------------------------------------------------------------------------------------------------------------
----------------------------------------------------------------------------------------------------------------------------------------------------------------------------------------------------------------------------------------------------------------------------------------
----------------------------SSSSSSSSSSSSSSSSSSSSSSSSSSSS----------------------------------------------------------------------------------------------------------------SSSSSSSSSSSSSSSSSSSSSSSSSSSS------------------------------------------------------------------------------------
----------------------------------------------------------------------------------------------------------------------------------------------------------------------------------------------------------------------------------------------------------------------------------------
--------------------------------------------------------------------------------------------------------------------------------------------------------------------------------------------------------XX------------------------------------------------------------------------------
-----------?SSS---------------------------------------------------------X----------------------?SSS-----------------------------------------SS----------------------------------------------------------------------------SSS----SSS--SSSSSS----------------------------------------SSSX
------------------------------------------------------------------------X---------------------------------------------------------------------------------------------------------------------------------------------------------------------------------------------------------------
---------------------------------------------S------------------------------------------------------------------------------------------------------------------------------------------------------------------------------------------------------------------------------------------
-XXXXX--------------------E------------------SSS------------------------XX-S---------XSSSSSSS-----------------E-------------------S----E------------------------------------------E--------------------------------------------------------------------E--------------------E-----------
------------SSS----------<--<>------QQS------X----X-----<>----------X---X----------------------SSSSS---------<>---------Q-------------<>----SSSQ--------------XXX------->--S-----<>-----------------XQQQ--------------XX-------------SSSSSSS----------<>--------E------E---<>-----------
-------------------------E]-[----------------X----X----X<>-------E--X---X----XX------------------------------[]-----------------------[]---E-------E---------XXXX----------------[]---------?------X-------------XXXXX-X------------------------------[]-------------------[]-----------
-------------------------[--[]------------XX[]-X--X---XX[]----------XXXXXX---XX------------------------------[]-----------------<>----[]--<>------<>--------XXXXX-------S--------[]--------<>-----XX--------------------------------------------------[]-------------------[]-----------
XX--------------------------E]----E------XX-[]-X--X---XX[]----------XXXXXX---XX----X-------------------E-----[]-------E---------[]----[]--[]------[]-------XXXXXX-------S--------[]--------[]----XXX----------------------------------------------E---[]-------------------[]-E---------
----XXXX-----XXXXXXXXXXXXXX-XXXXXXXXXXXXXXXXXX-XXXXXXXXXXXXXXXXXXXXXXXXXXX---XXXXXXX--XXXXXXXXXXXXXXXXXXXXXXXXXXXXXXXXXXXXXXXXXXXXXXXXXXXXXXXXXXXXXXXXXXXXXXXXXXXXXXXXXXXXXXXXXXXXXXXXXXXXXXXXXXXXXXXXX-----XXXX----------------XXXXXXXXXXXXXXXXXXXXXXXXXXXXXXXXXXXXXXXXXXXXXXXXXX-XXXXX
