----------------------------------------------------------------------------------------------------------------------------------------------------------------------------------------------------------------------------------------------------------------------------------------
------------------------------------------------------------------------------------------------------------------------------------------------------------------------X---------------------------------------------------------------------------------------------------------------
--------------------------------------------------------SSSSSS------------------------------------------------------------------------------------------------------------------------------------------------------------------SSSSSSSSSSSSSSSSSSSSSSSSSSSS--SSSSSSSSSSSSSS----SSSSSSSS
--------------------------------------------------------------------------------------------------------------------------------------------------------------------------------------------------------------------------------------------------------------SSSSSSSSSSSSSS----SS---SSS
---------------------------------------------------------------------------------------------------------------------------------------------------------------------------------------------------------------------------------------------------------------SSSSSSSSSSSS-----SS----SS
------------------------------------------------------S------------------------------------------------------------------------E-------------XXX---------------------------------------------------------------------------------S---------------------------SSSSSSSSSSSSSSS----------SS
--------------------------------------------------------------------------------------------------------------------------------------------------------------------------------------------E---------------------------------------------------------------EE--------------------------
------------------------------------------------------------------------------------------------------------------------------XX---------------------------------------------E----------E----E------------------------------------------------------------------------------------------
------------------------------------------------------------------E------------>---------------------------------------------XXX---------------------------------------------E---------<>-------------------------------------------------E---------------------E-----------------------
------------------X-------------------------E----------------S---<>-----------[]----XQQQ--------------XX--------------------XXXX--------------------------------------------<>---------[]----------E-------------------------QQ->S-S----S<>---------E------X---?SSSSSSSS----------------
--------------EXXXX------------------------<>------------<>------[]-----------[]--E--------E-----XXXX-XX------------------XXXXXX--------------------------------------------[]---------[]----E----<>------E---E-----------------S--S-----[]--------<>------X--E-------------------------
---------------XXXX------------------------[]-----------S[]------[]-----------[]----------<>-----------X-----------------XXXXXXX-----------[--------------------------------[]---------[]---<>----[]---------<>-----------------SS-S-----[]-----<>-[]-----XX-SS--X------------<>--------
---------------X-XX------------------------[]-E----------[]------[]-----------[]----------[]-------X--------------------XXXXXXXX--------EE-[----------E-E----------------E--[]---------[]---[]----[]-------E-[]--------------EE-S--S--ES-[]-----[]-[]----XXX------------------[]E-E-----
XXXXXX--XXXXXXXXX--XXXXXXXXXXXXXXXXXXXXXXXXXXXXXXXXXXXXXXXXXXXXXXXXXXXXXXXXXXXXXXXXXXXXXXXXXXXXX----------------XXXXXXXXXXXXXXXXXXXXXXXXXXXXXXXXXXXXXXXXXXXXXXXXXXXXXXXX-XXXXXXXXXXX-XXXX-XXXXXXXXXXXXXXXXXXXXXXXXXXXXXXXXXXXXXXXXXXXXXXXXXXXXXXXXXX--XXXXXXXXXXXXXXXXXXXXXXXXXXXXXXXXXX
