----------------------------------------------------------------------------------------------------------------------------------------------------------------------------------------------------------------------------------------------------------------------------------------
----------------------------------------------------------------------------------------------------------------X-----------------------------------------------------------------------------------------------------------------------------------------------------------------------
--------------------------------------------------------------------------------------------------------------------------------------------SSSSSSSSSSSS--------------------------------------------------------------------------------S-SS---------------S----------------------------
----------------------------------------------------------------------------------------------------------------------------------------------------------------------------------------------------------------------------------------------------------------------------------------
----------------------------------------------------------------------------------------------------------------------------------------------------------------------------------------------------------------------------------------------------------------------------------------
---------------------------------------------------------------------------------------------------XSS-------------------------XSSS-----------------------------------------------------------SSSS----X-------------------------SSSSS--SS----------------------------------------------X
--------------E-----------------------------------------------------------------------------------XXX-------------------------XX----E---------------------------------------------------------------------------------------------------------------------------------------------------
-------------XXXXXXX------------------------------------------------------------------------------XXX-------------------------XXX----E--------------------------------------------------------------------------------------------------------------------------------------------------
------------------------------------------------------------------------------------------------XXXXXE---------------E--------XXXE--<>----------------E------------E--------------------------------------------------------------------------------------------------------------------
----------------------S-------------------XXXX---------------------------------------E---------XXXXXX------------E--<>-----X--XXX----------------S---<>-----------<>----SSSQ--------------XX------------------------------S--SS-SSSSS--------------X------XX-----------------------SSS--
---------------------E----------------------------------------------X---------------<>-------XXXXXXXX----X------<>--[]-----XX-XXX----X-----E---------[]-----------[]-----------E---------XXX-------------------------------------------E----------XX------------------------------------
--------------------<>-----[---------------------------------------XXX--------------[]-------X-XXXXXX----X------[]--[]--------XXX---<>----<>SS-------[]-----------[]----------<>--------XXXX------------------------------------------<>--------XXXX------------------------------------
-EE-EEE-E-EEE-EE----[]X-EE-[---------------------------------------XXX----------EEE-[]-EE------XXXXXX----X------[]--[]-----E-XXXX---[]----[]---------[]-----------[]----------[]-------XXXXX----------E--E-EE-E------------E-EE-------[]-------XXXXX------XX-------E--E-----------------
XXXXXXXXXXXXXXXXXXXXXXXXXXXX---XX-----XXXXX----XXXXXXXXXXXXXXXXX--XXXXXX-XXXXXXXXXXXXXXXXXXXXXXXXXXXXXXXXXXXXXXXXXXXXXXXXXXX--XXXXXXXXXXXXXXXXXXXXXXXXXXXXXXXXXXXXXXXXXXXXXXXXXXXXXXXXXXXXXXXXXXXXXXXXXXXXXXXXXXXXXXXXXXXXXXXXXXXXXXXXXXXXXXXXXXXXX-----XXXXXXXXXXXXXXXXXXXXXXXXXXXXXXXX
