----------------------------------------------------------------------------------------------------------------------------------------------------------------------------------------------------------------------------------------------------------------------------------------
------------------------------------------------------------------------------------------------------------------------------------------------------------------------------------------------------------------------------------------------------------X---------------------------
SS---S----------------------------------------------------------------------------------------------------------SSSSSSSSSSSSSSSSSSSSSSS------------------------------------------------------------------------------------------------------------------------------------------SSSSSSS
----------------------------------------------------------------------------------------------------------------------------------------------------------------------------------------------------------------------------------------------------------------------------------------
----------------------------------------------------------------------------------------------------------------------------------------------------------------------------------------------------------------------------------------------------------------------------------------
------------------------------------------------------------------------------SSS--------------------------------S-----------------------------------------X------------------------------------------------E--------SSSSSS--S--------------XX--------XXXXX-----------?SS---------------
-----------------------------------------------------------------------------------------------------------------------------------------------------------X----------------------------------------------------------------------------------------------------------------------------
----------------------------------------------------------------------------------------------------------------------------------------------------------XX----------------------------------------------------------------------------------------------------------------------------
---------------------------------------------------------------------------------------------------------------------------------------E----------------X-XX-----------------E----------E-------------XX-------------------------------------------------------------?E-----------------
-S------Q--------X----X-----Q----------------XXX--------QQQ---------------XX----------------------XXX-----------SS-S----SQS-----------<>---------------XX-X-----------------<>---------<>----------E--XXX-------XXX------X-----------------------SSSSS--------E--QQ--S?S----E-----------
-----------------X-----]------------------XXX------------------------XXXXXXX-------------------------------------------------------X--[]--------------XXXXXX----------------[]---------[]------E--<>--------------------------XX--X--------------------------<>-------S----<>---E-------
---------------XXX-X--[]---X----------------------------------------------------------------------------------------------------<>-X--[]---X----------XXXXXX----------------[]---------[]-----<>--[]--------------------------------------------------------X[]--X----S----[]--<>------X
------E-------XXXX----X]--XX------------------------------------------------------------------------------------E-----E---------[]-X--[]---X-E------XXXXXXXX--------E-------[]---------[]-----[]--[]--------------------E---------X--------------------------[]------E-----[]--[]-------
XXXXXXXXXXXXXXXXXXXXXXXXXXXXXX-XXXX----XX-----XXXXXXXXXXXXX-----XXXXX---------------XXXXXXX---XXX---------------XXXXXXXXXXXXXXXXXXXX--XXXXXXXXXXXXXXXXXXXXXXXXXXXXXXXXXX-XXXXXXXX-XXXX-XXXXXXXXXXXXXXXXXXXXXXX-XXXXXXXXXXXXXXX--XXX----XXXXX--XXXXXXXXXX--XXXXXXXXXXXXXXXXXXXXXXXXXXXXXX
