----------------------------------------------------------------------------------------------------------------------------------------------------------------------------------------------------------------------------------------------------------------------------------------
----------------------------------------------------------------------------------------------------------------------------------------------------------------------------------------------------------------------------------------------------------------------------------------
------------------------------------------------------------------------------------------------------------------------------------------------------------------------SSSSSSSSSSSSSSSSSSSSSSSSSSSS------------------------------SS-SSSSSSSSSSSSSSSSSSSSSS--------SSSSSSSSSS-----------
----------------------------------------------------------------------------------------------------------------------------------------------------------------------------------------------------------------------------------------------------------------------------------------
----------------------------------------------------------------------------------------------------------------------------------------------------------------------------------------------------------------------------------------------------------------------------------------
-------Q--QQQ----------------X--------------------------X-------E?S-S-----XS-S--------------------------------------------------------XXXX-------------------------------S---------------------------------------S----------------SS----S-------------------SSS-------------------------
-----------------------------------------------------------------------------------------------------------------------------------------------------------------------------------------------------------------------X----------------------------------------------------------------
-----------------------------------------------------------------------------------------------------------------------------------------------------------------------------------------S----------------------------------------------------------------------------------------------
-----------------------E--------------------------------XXXXX---------------------E------------------------------------------------------------------------------------------------------XX-----------------------------------XE--------------------------------------------------------
--E-EQQ---QQQ--?QQ----<>---------------------------------------S?---XXX----------<>-----------------E--------------------------XXXXSSS----------------------------------SSSS----S-S------X-X--X------X-------------------------S-SSSS---SQS-----------------SSSSS-------------XXX-------
-<>-------------------[]--E------------------------------------------------------[]----------------<>-------------------------------------------------------------------[----------------X-XX-X----X-X---------------------------------------------E---------------E---------XXXX--E----
-[]-------------------[]---------------------------------------------------------[]----------------[]-------------------------------------------------------------------]--------------XXXXXX-X---XX----------------------------------------------<XX-------------<>--------XXXXX-----XX
-[]----------------E--[]---------------EE----------------------------------EE-E--[]-----E------E---[]--------------------------------------------------EE---------------E-----E------XXXXX-X--X--XXXXX-----E-E------------------------E------------X--------------[]-------XXXXXX----XXX
XXXXXXXXXXXXXXXXXXXXXXXXXXXXXXXXXXXXXXXXXXXXXX------X--------XXX-----XXXXXXXXXXXXXXXXXXXXXXXXXXXXXXXXXXXX--XXXXX--------XXXX----XXXXXXX---XXXXXXXXXXXXXXXXXXXXXXXXXXXXXXXXXXXXXXXXXXXXXXXX----XXX-XX---XXXXXXXXX--XX--------XX--XXXXXXXXXXXXXXXXXXXXXXXXXXXXXXXXXXXXXXXXXX-XX-----XX--XX
