----------------------------------------------------------------------------------------------------------------------------------------------------------------------------------------------------------------------------------------------------------------------------------------
----------------------------X-----------------------------------------------------------------------------------------------------------------------------------------------------------------------------------------------------------------------------------------------------------
--------------------------------------------------------------------------------------------------------------------------------------------SSSSSSSSSSSSSSSSSSSSSSSSSSSS----------------------------------------------------------------------------------------------------------------
--------------------------------------------------------------------------------------------------------------------------------------------SSSSSSSSSS-----------SSSS--S----------------------------------------------------------------------------------------------------------------
---E-------------------------------------------------------------------------------------------------E--------------------------------------SSSSSSSSSS?-----------SSS-SS----------------------------------------------------------------------------------------------------------------
SSSSSSSSSS-------?SS------------------?SS----------------------------------S-----------E--E-----XXX--E--------------------------------------SSSSSS-SS----SS--------S---------------------------SS-----------------------------XX--------------------------------------------------------
--------------------------------------------------------------------------------------X--XXXX-----------XXXXXX--------------------------------------------------------------------------------------------------------------------------------------------------------------------------
--------------------------------------------------------------------------------------X-------------------------------------------------------------------------------------------------------------------------------------------------------------------------------------------------
--EE-------------------E-------------?E------------E-----------------------------------------------------------X---------------------------------------------------SS-------------------------------------------------------------------------------------------------------------------
-SS?SSS-----------XX--<>------E--E---S?-----E-----<>------XXX-------------------------XX-----------XXSSS------------------------------------SSSSSSSSSS---------EX------XX------------------------------------------------S-SSSS-------------XX-----------------------------X------------
------SS----X-----X---[]-----<>-<>---------<>---E-[]---------------------------------EXX--------------------------------------------------------S-SSSS--------<>X------XX-------------XXXXXX-----------------------------------------------XXX------------------------------------------
-----SSS--------X-X---[]-----[]-[]---------[]--<--[]--------------------------------XXXX------------------------------------X------------------SSSSSS-------XX[]X-------------------------------------------------------------------------XXXX------------------------------------------
----------------X-X-E-[]-----[]-[]---E-----[]--[]-[]----------------------------------XX--------------------------------E---EE---------E-EE----SSSSSS-------XX[]X------X-----------------------------------EE---------------------------XXXXXX-E------E-EE-E--------------------------E-
XXXX-XXXX-XX----X---XXXXXXXX--XXXXXXXXXXXXXXXXXXXXXXXXXXXXXXXXXXXXXXX--XXXXXXXXXXXXX----------------------------XXXXXXXXXX--XXXXXXXXXXXXXXXXXXXXXXXXXXXXXXXXXXXXXXXXXXXXXXXXXX-XXXXXX---------------XXXXXXXXXXXXXXXXXXXXXXXXXXXXXXXXXXXXXXXXXXXXXXXXXXXXXXXXXXXXXXX-XXXXXX------------X-
