----------------------------X-----------------------------------------------------------------------------------------------------------------------------------------------------------------------------------------------------------------------------------------------------------
--------------------------------------------------S----S--------------------------------------------------------------------------------------------------------------------------------------------------------------------------------------------------------------------------------
SSSSSSSSSSSSSSSSSSSSSSSSSSSSSSSSSSSSSSSSSSSSSSSSSSSSSSSSSSSSSSSSSSSSSSSSSSSSSSSSSSSS----------------------------SSSSSSSSSSSSSSSSSSSSSSSSSSSS------------------------------------------------------------------------------------SSSSSSSSSSSSSSS-SSSSSSSSSSSS----------------------------
----------------------------SSSSSSSSSSSSSSSS----SSSSSSSS--------------------------------------------------------S-S----SS---------------------------------------------------------------------------------------------------------SS--SSSSSSS-------------------------------------------
----------------------------SSSSSSSSSSSSSSS-----SSSSSSSS--------------------------------------------------------S-S----SSS?-----------------------------------------------------------------------------------------------------------SSSSSSS-------------------------------------------
-S---------------------S----SSSSSSSSSSS--SSS----S-----SSSSS----SS--------------------------QQQQQQ--------SSSSSSSSSSSS--SS----S---------SS-----XXXX-----------------------XXX------------------------------------------X----------S-S-SSSSSSSS-------------------------------------------
-----------------------------S-S--------------------------------------------------------------------------------------------------------------------------------------------------------------------------------------X---------X-------------------------------------------------------
-S------------------------------------S------------------------------------------------------------------------------------------------------------------------------------------------------------------------------XX-------------------S---------------------------------------------
-----------------------SS-------?------------------??--------------------------SS------------------------------------------------------SS----------------------------------------------------------------------------XX-------------E-----S------------E--------------------------------
SSSS----S-----------X--------SSSSSSSSSSS-------E--<>---XSSSSS--SS----------XX------X------SS--QQQQ--------------SSSSS--SS----------EX-------------------------------------------------------------------------------XXX-----------E--SSSSSSS----------[]--------------------------------
[------E---------X-XX-------XSSSSSSSSSS-------<>--[]-----------SS--------X-XX------X-----------------------------------SSS--------<XX-------------------X---------------------------------------------------------EXXXX----------<E------SS-----------[]--------------------XX----------
------<>--------XXXXX-------SSSSSSSSSSS-------[]--[]----------<S--------<XXXX------X-------------------------------S--SSS-------XXXXX-------------------X---------------------------------------------------------XXXXX----------[]--X---SS-----------[]-------------------XXX----------
]-----[]------XXXX-XX-------SSSSSSSSSSS-------[]--[]---X]--E--[]-------XXX-XX------X------------------E------------S--SSS-------XX[XX------------EE-E---X---------EE-E-E--------E---E-----------------------------XXXXX----------[]------ES-------EE--[]------------------XXXX----------
XXXXXXXXXXXXXXXXXXXX------XXXXXXXXXXXXXXXXXXXXXXXXXXXXXXXXXXXXXXXXXXXXXXXXXX--XXXXXXXXXXXXXXXXXXXXXXXXXXXXXX-X-XXXXXXXXXXXXXXXXXXXXXX-X--XXXX-XXXXXXXXXXXXXXXXXXXXXXXXXXXX---XXXXXXXXXXXX-------XXXXXXXXXXXXXXXXXXX-------------XXXXXXXXXXXXXXXXXXXXXXXXXXXXXXXXXXXXXXXXXXXXXXXXX-XXXXXX
