------------------------------------------------------------------------------------X---------------------------------------------------------------------------------------------------------------------------------------------------------------------------------------------------
---------------------------------------------------------------------------------------------------------SS----S------------------------------------------------------------------------------------------------------------------------------------------------------------------------
--------------------------------------------------------SSSSSSSSSSSS----------------SSSSSSSSSSSSSSSSSSSSSSSSSSSS------------------------------------------------------------------------------------------------------------------------------------------------------------------------
------------------------------------------------------------------------------------SSSSSSSSSSSSSSSS----SSSSSSSS------------------------------------------------------------------------------------------------------------------------------------------------------------------------
------------------------------------------------------------------------------------SSSSSSSSSSSSSSSS----SSSSSSSS-XXXXXXXX---------------------------------------------------------------------------------------------------------------------------------------------------------------
----------?SS-----------------------------------------------------------------------SSSSSSSSSSS--SSS----SSS-S-SS-----------------SSSS------------------------E-------------S----SSS-----------------------------------SS-------------------------------------SSS--SSSSS-----------------
------------------------------------------------------------------------------------------------------------------------------------------------------------XXXX---------------------------------------------------------------------------------XXXX-----------------------------------
----------------------------------------------------------------------------------------------------------------------------------------------------------------------------------------------------------------------------------------------------------------------------------------
-------------------------------------------------------------------------SSS---------?-E-------------------??----------------------------------------------------------------------------------E------SXX---------------------E----------------------------E----------------------------
--E--QQ--S??----E-------------------------XXXXXX--------<--------QS-----------X----E-SSSSSSSSS---------E-----XXXXXXXX-------------XXXX---XX----------------------------S------S--SS-----------<>----------------SS-----------<>---------------------S------S------S---------------------
-<>------------<>---E--E-----------------------------------------E------------X---<>--SSSSSSSS--------<>-------------------EXX------------XX--------------------------------------------------[]-----------------------------[]--E------------------------------------------------------
-[]--X---------[]-----<>--------------------------------<]------------X-<>----X---[]--SSSSSSSS------X-[]---------------X--------------------XXXX----------------------------------------------[]-----------------------------[]-XX------------------------------------------------------
-[]------------[]-EE--[]-------------------------E------[]-----------XX-[]----X---[]--SSSSSSSS------X-[]E-E--XXX---------------X-----XX---------------------------------------------------E---[]-----------------------------[]-XX--------------------------------------------E---------
-XXXXXXXXXXXXXXXXXXXXXXXXXXXX---X----XXXXXX---XXXXXXXXXXXXXXXXXXXXXXXXXXXX-XXXXXXXXXXXX--XXXXXXXXXXXXXXXXXXXXXXX------------------XXXXXXXXX-XXXXXXXXXXXXX--X--------X-XXXXXXXXXXX--XXXXXXXXXXXXXXXXX---XXXXX------XXXXXXXXXXXXXX------XXXXX---XXXXXXXXXXXXXXXXXXXXXXXXXXXXXXXXXXXXXXXXXX
