----------------------------------------------------------------------------------------------------------------------------------------------------------------------------------------------------------------------------------------------------------------------------------------
----------------------------X-----------------------------------------------------------------------------------------------------------------------------------------------------------------------------------------------------------------------------------------------------------
----------------------------SS--------------------SSSSSS-----------SSSSSSSSSS-SSSSSS----------------------------------------------------------------------------------------------------------------------------------------------------------------------------------------------------
----------------------------------------------------------------------------------------------------------------------------------------------------------------------------------------------------------------------------------------------------------------------------------------
----------------------------------------------------------------------------------------------------------------------------------------------------------------------------------------------------------------------------------------------------------------------------------------
----------------------------X-----------S---------------S-----------------S----S-----------------------------------------------X--------------------------------------------------SQSQQ-------------Q-----------------------------------------------------------------------------------
-------------------------------------------------------------------------------------------------------------------------------X-----------------------------XX-----------------------------------------X-------------------------------------------------------------------------------
-----------------X---------------------------------------S----------------X------------------------X--------------------------XX----------------------------XXX-------------------------------------------------------------------------------------------------------------------------
----------------XXX-------------------E------------------S---------------XX-------------------------------------------------XXXX---------------------------XXXX-------------------------------------------------------------------------------------------------------------------------
--------Q-------XX---------------E---<>-----E-----------SQQ-------------XXXX------------------------------------------------XXXX--------------------------XXXXX--------------------SSSSS-------------------------XXXXX---------------E---------<>-----------------------XX--------------
----------------XX--------------<>---[]----<>---E------E[---------------XXXXX---------------------------------------------XXXXXX-------------------------XXXXXX----------------------------------E----------------------------------<>---------[]----------------------XXX--------------
-------------XXXXX--------------[]---[]----[]--<><>---<>]--------------XXXXXX----------------------X---------------------XXXXXXX------------------------XXXXXXX---------------------------------------------------------------------[]---------[]---------------------XXXX--------------
E--E--------XXXXXX--------------[]---[]E-E-[]--[][]---[]]-------------XXXXXX------------------EE--EX----------EE---E----XXXXXXXX--------E--E----------XXXXXXXXX---------------------------------------------------------------------[]-----E---[]-------------------EXXXXX-------EE-EE-E
XXXXXXXXXXXXXXXXXXXX----XXXX-XXXXXXXXXXXXXXXXXXXXXXXXXXXXXXXXXXXXXXXXXXXXX----------XXXXX-XXXXXXXXXXXXXX--XXXXXXXXXXXXXXXXXXXXXXXXXX-X--XXXXXXXXX----XXXXXXXXXXX---XXXXX--XXXXXXXX-XXXXXXXXXXXXXXX--XX--XXX---XXX---------------XXXXXXXXXXXXXXXXXXXX---XXXXXX-XXXXX-XXXXXXXXXXXXXXXXXXXX
