----------------------------------------------------------------------------------------------------------------------------------------------------------------------------------------------------------------------------------------------------------------------------------------
----------------------------------------------------------------------------------------------------------------------------------------------------------------------------------------------------------------------------------------------------------------------------------------
------------------------------------------------------------------------------------SSSSSSSSSS-----SSSSSSSSSSSSS------------------------------------------------------------------------------------------------------------------------------------------------------------------------
--------------------------------------------------------------------------------------------------------------------------------------------XEEE--------------------S-------------------------------------------------------------------------------------------------------------------
-------------------------------------------------------------------------------------------------------------------------------------------->XXXXXXX-------------E--S-------------------------------------------------------------------------------------------------------------------
--------------------------------------------XX---------------SSSQQQQQQ----------------------------------------------------------------------S------------S--------SSSS-----------------E--------------------------------------X-----------------------------SSSS---SSSS-----------------
-------------------------------------------XXX----------------------------------------------------------------------------------------------------------------------------------------E-------------------------------------------------------------------------------------------------
------------------------------------------XXXX----------X-----------------------------------------------------------------------------------------------------------------------------XXXXXX--------------------------------------------------------------------------------------------
-----------------------------------------XXXXX------------------------------------------------------XSSS-----------------------------------------------------------S----------------X---------------------------------------------------------------------------------------------------
---------------------------------------X-XXXXX---------E------SSSSQSQQ-----------<>-<>---E---E------X----------------E----------E----------EXXXXX-------------XXXX-----------------X--------------------------------------------------------X------------------S----S-------------------
-----------------X--------------------XXXXXXXX--------<>-------------------------[]-[]--->---E------X----XX---------<>---------<>---------<>-------X---EXXX---XX-------------------XXX-------E----------------------E-----------------------X---------------------------------X----E----
---------------XXXX------------------XXXXXXXXX--------[]-------------------------X]-[]------------XXX----XX---------[]---------[]---------[]------<>----------XX-------------------S--------<>-----[---------------<>-----------------------X---------------------------------X---<>----
---------------XXXX---------EE-E-----XXXXXXXXX--------[]-------------------EE-E--X]-[]--E--------XXXX----XX----X----[]---------[]---------[]------[]-------XX------------EE-EEE-EXXSS-EE----[]--EE-[---------------[]-----------------E-E---X--------EEEEE-E------------------X---[]----
XXXXXXXXXXXXXXXXXXXXXXXXXXXXXXXXXXXX-XXXXX-XXX-XXXXXXXXXXXXXXXXXXXXXXXXXXXX-XXX-XXXXXXXXXXXXXXXX-XXXX---XXXXXXXXXXXXXXXXXXXXXX-XXXXXXXXXXXXXXXX----XXXXX----------------XXXXXXXXXXXXXXXXXXXXXXXXXXXXXXXXXXXXXXXXXXXXXXXX-----XXXXXXXXXXXXXXXXXXXXXXXXXXXXXXXXXXXXXXXXXXXXXXXXXXXXXXXXXXX
