----------------------------------------------------------------------------------------------------------------------------------------------------------------------------------------------------------------------------------------------------------------------------------------
----------------------------------------------------------------------------------------------------------------------------------------------------------------------------------------------------------------------------------------------------------------------------------------
------------------------------------------------------------------------------------SSSSSSSSSSSSSSSSSSSSSSSSSSSS------------------------------------------------------------------------------------------------------------------------------------------------------------------------
-----------------------------------------------------------------------X----------------------------------------------------------------------------------------------------------------------------------------------------------------------------------------------------------------
-----------------------------------------------------------------------X----------------------------------------------------------------------------------------------------------------------------------------------------------------------------------------------------------------
----------------------SSSS---------------------------------------------X-S--------------------------------------------------------SSSS------X--SSSSSSSSSS-SS-----------S----------------------------------------------------------------------------------------------------------------
----------------------------------------------------------------------XX----E---------------------------------------------------------------------------------------------------------------------------------------------------------------------------------------------E-------------
---------------------------------------------------------------------XXXXXXX-E-----------------------S--------------------------------------X-----------------------------------------------------------------------------------------------------------------------------XXXXXX--------
--------------------------------------------------------------------X-XX----------------------------XXXS----------XXX------------------------------------------------------------------------------------E----------E-------------------------------------------------------------------
SQQQ--------------XX---------------------XXXX----------------------X--X-------------<>------SQS-X----X----X--------XX-------XXX-----------------SSSSSS---S-----------XX----------------XXX--------------<>---------<>-------------------------------------------------------------------
-------E------X---XX--------------------XXXXX----------------E-----XXXX------E-----<[]---------------]---XX----------------------------------------------------------X----------------------------------[]---------[]--------------------------------------------E---------------E-----<
------XX----------XX------------------XXXXXXX---------------------XSS--X----<>-----[[]----------XXXX[]-X-XX----------------------------------------------------------XX---------------------------------[]---------[]------------------------------------------------------X----<>-----[
---------------X--X------------------XXXXXXX--------E----E--EEE-XXXXS-EE----[]-----[[]----E-----XXX-[X---XX----------------------------------------------------EE-E--XX---------------------------------[]---E-----[]----------------------------------------EE-EE----EE--EE----[]-----[
XXX---XXXXXXXXXXXXXXXXX-XXXXXXXXXX---XXXXX-----X-X--X---XXXXXXXXXXXX-XXXXXXXXXXXXXXXXXXXXXXXXXXXXXXXXX--XXXXXXXXXXX----XXXX---------X-------XXXXXXXXXXXXXXXXXXXXXXXXXXXX--------XX--XXXXXXXXXXXXX-XX-XXXXXXXXXXXXXXXXXXX---X-XXX--------XXX---XXXX--------XXXXXXXXXXXXXXXXXXXXXXXXXXXXXX
