----------------------------------------------------------------------------------------------------------------------------------------------------------------------------------------------------------------------------------------------------------------------------------------
-------------------------------------------E----S------S--------------------------------------------------------------------------------------------------------------------------------------------------------------------------------------------------------------------------------
-------------------------------SSSS-------<>----SS----SS--------------------------------------------------------------------------------------------------------------------------------------------------------------------------------------------------------------------------------
-------------------------------SSSSSS-----S]----SSSSSSSS--------------------------------------------------------------------------------------------------------------------------------------------------------------------------------------------------------------------------------
-------------------------------SSS-S------[]----SSSSSSSS-----------------------------XXXXXXX---------------------------------------------------------------------------------------------------------------------------------------------------------------------------X----------------
SSS-------------------------S-SSSSSSSS---SSS---SSS----SS--XX-----------------------------------------SSSSSSSSS-----------------------------------------SS----------------------------------------------------------------------------------------------XXX------------QQQ---------------
----------------------------------------------------------------------------------------------------------------------------------------------------------------------------------------------------------------------------------------------------------------------------------------
----------------------------------------------------------------------------------------------------------------------------------------------------------------------------------------------------------------------------------------------------------------------------------------
------------------------------EE----------------------------------------------------------------------------------------------------------------------E------------E--------------------------------------------------------------------------------------------------------E------E----
SSSQ---------------X----------S?SSSSS-----E----E-----XXX-----------------------------XXXX-------------XXXX---------------------XX-------------E--QQ--S?-----E-----<>------------------------------------------------------------X-------------XXXXX-------------EQQ---QQQ--?Q-----<>----
-------E---------XXXX-----------SSSS----------<>--------------------X----------------------E---EXX-------------------------------------------<>------------<>-----[]--------------------------------------------------------------------------XXXX--------------------------------[]--E-
------<>--------XXXXX-----------SSSS--------X-[]--------------------X---------------------XX-------------------------------------------------[]--X---------[]-----[]---------------XXX-----------------------------X--------------------------------------------------------------[]----
------[]-------XXXXXX-----------------------X-[]E-E--XXX------E-E---X--------EEE-------------------XX----------------------------------------[]------E-----[]--E--[]--------------XXXXEE--------E-EE-EE-E-----EE--EX-----------------------------------------------------------E--[]----
XXXXXXXXXXXXXXXXXXXXX-XXXXXXXXX--XXXXXXXXX-XXXXXXXXXXXXXX-XXXXXXXXXXXXXXXXXXXXXXXXXX-------------------------------X-------XXXXXXXXXXXXXXXXXXXXXXXXXXXXXXXXXXXXXXXXXXXXXXXXXXXXX--XXXXXXXXXXXXXXXXXXXXXXXXXXXXXXXXXXXXXXXXXXXXXXXXXXXX---XXXXXX----XXXX-XXXXXXXXXXXXXXXXXXXXXXXXXXXXXXXX
