----------------------------------------------------------------------------------------------------------------------------------------------------------------------------------------------------------------------------------------------------------------------------------------
----------------------------------------------------------------------------------------------------------------------------------------------------------------------------------------------------------------------------------------------------------------------------------------
------------------------------------------------------------------------------------SSSSSSSSSSSSSSSSSSSSSSSSSSSS-----------------------------------------------------------S-SSSSSSSSSSSSSSSSSSSSSSSSSSSSSSSSSSSSSSSSSSSSSSSSSSSSSSSSSSSSSSSSSSSSSSSSS-S--------------------------------
--------------------------------------------------------------------------------------SSSSSSSSSSSS--------------------------------------------------------------------------------------------------------------------------------------------------------------------------------------
--------------------------------------------------------------------------------------SSSSSSSSSSSS------------S--------------------------------------XXX--------------------------------------------------------------------------------------------------------------------------------
------------------------XXXX-----------------------------------------------------------SSSSSSSSSSS-S----------SSX-SSSSSSSSSS------------------------------------------XXSSS--------------------S-------------------------------------------------------------------------S--------XXXXX-
-------------------------------------------------------------------------------------E--------------------------------------------------------------------------------------------------------------------------------------------------------------------------------------------------
----------------------------------------------------------------------------------------------S-----------------------------------------------------------------------------------------------------------------------------------------------------------------------------------------
----------------------------------------------------------------------------------------E-----S------------SS------------------------------------E----------E----------------------------------SS-------------E---------------------------E------------E--------------------------------
---------------------S-SSS-----------------------------S--------------QQ---------------SSSSSSSSS----------------------SSS---?SS----------------------------<>------S----SSSSS--------------XX----------S----SSS---------E------X---S-S---<>-----------<>--------------------------------
--------------------------------------------------------------------------------------E------SS--------E-----------------------------------------E---------[]------------------E---------XXXX---------SSS---SSS--------<>------X--E------[]-----------[]--------------------------------
-------------------------------------------------------------------------------------SSSSS---SS-------<>----------------------------------------<>---E-----[]-----------------<>--------XXXXX-------S--S-----SS--------[]------X-S?------[]-----------[]--------------------------------
-------E-EE------------------------------E---------E-------------E-------------------SS------SS-------[]------------------------------E---------[]---E-----[]-----------------[]-------XXXXXX-------S-SSS-ES-SS--------[]----XXX--S------[]-----------[]--------------------------------
---XXXXXXXXXXXXXXXXXXXXXXXXXXX--XXXXXX--XXXXXXXXXXXXXXXXXXXXXXXXXX-XXXXXXXXXXXXXXX-XXXXXXXXXXXXXXXXXXXXXXXXXXXXXXXXXXXXXXXXXX---X--------X----XXXXXXXXXXXXXXXXXX-----XXXXXXXXXXXXXXXXXXXXXXXXXXXXXXXXXXXXXXXXXXXXXXXXXXXXXXXXXXXXXXXXXXXXXXXXXXXXXXXXXXXXXXX-------XXXXX---XXXXXX-------
