----------------------------------------------------------------------------------------------------------------------------------------------------------------------------------------------------------------------------------------------------------------------------------------
----------------------------------------------------------------------------------------------------------------------------------------------------------------------------------------------------------------------------------------------------------------------------------------
--------------------------------------------------------------------------------------------------------------------------------------------------------------------------------------------------------------------------------SS-------------SSSSSSSSSSSSS----------------------------
----------------------------------------------------------------------------------------------------------------------------------------------------------------------------------------------------------------------------------------------------------------------------------------
----------------------------------------------------------------------------------------------------------------------------------------------------------------------------------------------------------------------------------------------------------------------------------------
-----------?SSS-----XXX------------QQ-QQ------------------------------------------------------------X------------------------------------------------------X-S----------------------EQS------------------------------X---------------------------------------XX-------------------------
----------------------------------------------------------------------------------------------------XX--------------------------XXXX----------------------XX-------------------------------------------------------XXXX-----------------------------------------------------------------
---------------------------------------------------------------------------------------------------XXX----------------------------------------------------XX------------------------------------------------------XXXX------------------------------------------------------------------
-XXXXX--------------------XX-----------------------E----------------------------------------------XXXX--------------------------------------------------X-XX--------------SSSSSSS-----------------E--------------XXXXX--------------------------XSSS------------------------------------
------------SS--------------------Q---QQQ---------<>----------------------X-----------------------XXXX---------------------------SS-S------S-----------X--X-------------------------S?S----------QQ--------------XXXXX----------<>--------------X---------------------------------------
-X------------------------------------------------[]--E---------------EXXXXX---------------------XXXXX---------E-E-------------------------------------XXXXX-----E------------E------------------X------------X-XXXXXX---------E[]-------E-----------XX---------------------------------
--------------------------------------------------[]---------------------XX---------------------XXXXXX---------XXXXX-----------------------------------X--XX----<>-------------------------------------------XXXXXXXXX---------[[]------------XXE----XX----X---------------<>-----------
XX------------------------------------------------[]----------------------X-------X--E-E-------XXXXXXX---------X-----------------------------E--E---XXXXX-EX----[]-----EXX-----E-E---------------------------XXXXXXXXX------E--X[]--E--------XX------XX----X---------------[----------E-
-------XXXX---XXXXXXXXXX----XXXXXXXXXXXXXXXXXXXXXXXXXXXXXXXXX---XXXXXXXX----XXXXXXXXXXXXXXXXXXXXXXXXX--XXXXXXXXX-----XXXX----XXXXXXXXXXXXXXXXXXXXXXXXXXXXXXXXXXXXXXXXXXXXXXXXXXXXXXXXXXXXXXXXXXXXXXXXXXXXXX--XXXXXX--X-----XX---XXXXXXXXXXXXXXXXXXX--XXXXXXXXXXXXXXXXXXXXXXXXX----------
