----------------------------------------------------------------------------------------------------------------------------------------------------------------------------------------------------------------------------------------------------------------------------------------
----------------------------------------------------------------------------------------------------------------------------------------------------------------------------------------------------------------------------------------------------------------------------------------
----------------------------------------------------------------------------------------------------------------------------------------------------------------------------------------------------------------------------------------------------------------------------------------
---------------------------------------------------------------------------------------------------------------------------------------------------------------------------------------------------------------------------------------------------------------------E------------------
---------------------------------------------------------------------------------------------------------------------------------------------------------------------------------------------------------------------------------------------------------------------XXX----------------
----------------------------------------------------X-X--------------------------------------------------------------------------SSS--------SSS--------------------S----------------------X----------XX---------------------------------SSS------------------------------QQ-------------
-----------------------------------------------------------------------------------------------------------------------------------------------------------------------------------------XX---------------------------------------------------------------------------------------------
-----------------------------------------------------------------------------------------------------------------------------------------------------------------------------------------XX---------------------------------------------------------------------------------------------
----------------E--------------------------------------------------------------------------------------------------------------------------------------------------------S--------------XXX----------------------------------------------------------------------SSSS-------------------
---------------<>------------------------XXX-----------------------------S---------------------------------------XXXX-------------XX--------SSSQ?-------------XX--------X-------------XXXXX-------------------------------------------------SS-------------------------QQQQQ------------
---------------[]----------------------XXXXX-------------------------------------------------------------------------------------------------------E----X-----XX---------------------XXXXXX---------------------------------------------------------------------------------------------
---------------[]---------------------XXXXXX-----------------------------------------XX-----------------------------------------------------------<>----------XX---------------------XXXXXX--------------------------------------------------------------XX-----------------------------
----E----------[]---------E----------XXXXXXX--------E---------------------------------------------------------------------------------------------[]-------XX-XX---------------------XXXXXX--------------------------------------------------------------X-----------E------------------
XXXXXXXXXXXXXXXXXXXX---XXXXXXXXXXXX-XXXXXXX--XXXXXX-XXXXXXXXXXXXXX----XXXXXXXXXXXXXXXXX----XX----XXXXXXXXXXXXXXXXXXX-XXX---XXXXXXXXXXXXXXXXXXXXX-XXXXXXXX--XXX------XXXXXXXXXXX--XXXXXXXXXXXXXX-XXXXXXXXXXXXXXXXXXXXXX------XXXXXXXXXXXXXX-XXXXXXXXXXXXXXXXXXXXXXXXXXXXXXXXXXXXXX-XXXXXX
