----------------------------------------------------------------------------------------------------------------------------------------------------------------------------------------------------------------------------------------------------------------------------------------
----------------------------------------------------------------------------------------------------------------------------------------------------------------------------------------------------------------------------------------------------------------------------------------
----------------------------------------------------------------------------------------------------------------------------------------------------------------------------------------------------------------------------------------------------------------------------------------
----------------------------------------------------------------------------------------------------------------------------------------------------------------------------------------------------------------------------------------------------------------------------------------
----XXX--------------------------------------------------------------------------------------------------------------------------------------------------------------------------------------------------------------------------------------------------------------XX-----------------
--------------------SSSSSS--X--SSSSSSSSSS-SS-----S--SSSSSSS-----------------------------------------------SSSSS-----------------------------------------------------------------------------------XX---------------------------------------------------------------------Q--------------
--------------------------------------------------------------------------------------------------------------------------------------------------------------------------------------------------------------------XXXX----------------------------------------------------------------
----------------------------X-----------------------------------------------------------------------------------------------------------------------------------------------------------------------------------------------------------------------------------------------------------
-------------------------------------------------------------------------------E---------------------------SS-----------------------------------------------------------------------------------------------------------------------S---------------------------SSSSS-------------------
XXXXX-------------XXXX----------SSSSSS--?SS----------X--SSSQ--------------XX--<>----SSSSS--------------X---------------------------------------------------X---------------------------------SSSSS----------------------------SS------------SSS-------------------------QQQQ----------E-
-------------XXX-----------------------------------------------E---------XXX--[]-----------E----------XX--------------------------------------------------------------E-----------E------------------E-------------------------------------------------------------------------------<>-
--------------------------------------------------------------<>--------XXXX--[]----------<>--------XXXX------------------------XX--------XX-------------------------<>----------<>-----------------XXX------------------------------------------------------------------------------[]-
---------------X--------------------------------E-------------[]-------XXXXX--[]---X------[]-------XXXXX------------------------XX--------XX-------------------------[]--------E-[]-----------------XX---------------------------------------------------------------E---------------[]-
---------XX--------X-------XXXXXXXXXXXXXXXXXXXXXXXXXXXXXXXXXXXXXXXXXXXXXXXXXXXXXXXXXXXXXXXXXXXXXXXXXXXXXXXXXXXXXXXXXXXXXXXXXXXXXXXX---XXXXXXXXXXXXX---XXXXX----XXXXXXXXXXXXXXXXXXXXXXXXXXXXXXXXXXXXXXXXXXXXXXXX-XXXXXXXXXXXXXXXX---XXXXXXXXXXXXXXXXXX-XXXX--XXXXXXXXXXXXXXXXXXXXXXXXXXXX
