----------------------------------------------------------------------------------------------------------------------------------------------------------------------------------------------------------------------------------------------------------------------------------------
----------------------------------------------------------------------------------------------------------------------------------------------------------------------------------------------------------------------------------------------------------------------------------------
----------------------------------------------------------------------------------------------------------------------------------------------------------------------------------------------------------------------------------------------------------------------------------------
----------------------------------------------------------------------------------------------------------------------------------------------------------------------------------------------------------------------------------------------------------------------------------------
----------------------------------------------------------------------------------------------------------------------------------------------------------------------------------------------------------------------------------------------------------------------------------------
----------------------------------------------------------------------------------------------------------------------------------------------XX----------------------------------------------------Q-----------------------------------------------------------------------------------
--------------------------------------------------------------------------------------------------------------------------------------------------------------------------------------------------------XX-------------------------------------X----------------------------------------
---------------------------------------------------------------------------------------------------X------------------------------------------------------------------------------------------------------------------------------------------XX----------------------------XX----------
---------------------------------------------------------------------------------------------------X-----------------------------------------------------------------------------------------------------------------------------------------XXXX---------------------------XX----------
-------------X--------------------------------------------------------XX-----------------------------------------------------XXXXX---------------------------------S---------------------------------------------XXXXXXX---------------------XXX--------------------Q-------XX----------
------------XX--------------------------X-----------------------------XX-----------------------XXXXX--------------------------------------------------------------------------------------------------------------------------------------XXXXXXX-------------------------X-XX---------E
-----------XXX--------------------------X----------------------------XXX----------------------XXXX-X-------------------------X----------------------------------------------------------X--X---------------------------------------------XXXXXXXX------------------------XXXXX----X---<>
-----------XXX-------EE-E---------------XE-------E-E---------------E-XXX--------------------XXXXXXEX--------E---------------EX-------E-EE-----------E---E--------------------------------------------------------E-------E--E------------XXXXXXXX-----------EE-E--------XXXXXX----X---[]
XXXXXXXXXXXXXX---XXXXXXXXXXX----XXXXXXXXXXXXXXXXXXXXXXXXXXXXX-----XXXXXX---XXXXXXXXXXXXXXXXXXXXXXXXXXXXX----XXXXX---XX--XXXXXX----XXXXXXXXXXXXXXXXXXXXXXXXXXXXXXXXXXXXXXXXXXXXXXXXXXXXXXXXXXXXXXXXXX---------XXXXXX---XXXXXXXXXXXXXXXXXXXXXXXXXXXXXXXXXXXXXXXXXXXXXXXXXXXXXXXXXX--XXXXXX
