33333333333333333333333333333333
33333333333333333333333333333333
33333333333333333333333333333333
33333333333333333333333333333333
33333333333333333333333333333333
33333333333333333333333333333333
33333333333333333333333333333333
33333333333333333333333333333333
33333333333333333333333333333333
33333333333333333333333333333333
33333333333333333333333333333333
33333333333333333333333333333333
33333333333333333333333333333333
33333333333333333333333333333333
33333333333333333333333333333333
33333333333333333333333333333333
11111111111333333333333333333333
11111111111333333333333333333333
11002000011333333333333333333333
11002000011333333333333333333333
11002000011333333333333333333333
11002000011333333333333333333333
11002000011333333333333333333333
11002000011333333333333333333333
11002000011333333333333333333333
11002000011333333333333333333333
11002000011333333333333333333333
11002000011333333333333333333333
11002000011333333333333333333333
11002000011333333333333333333333
11111111111333333333333333333333
11111111111333333333333333333333

