33333333333333333333333333333333
33333333333333333333333333333333
33333333333333333333333333333333
33333333333333333333333333333333
33333333333333333333333333333333
33333333333333333333333333333333
33333333333333333333333333333333
33333333333333333333333333333333
33333333333333333333333333333333
33333333333333333333333333333333
33333333333333333333333333333333
33333333333333333333333333333333
33333333333333333333333333333333
33333333333333333333333333333333
33333333333333333333333333333333
33333333333333333333333333333333
11111111111333333333333333333333
11111111111333333333333333333333
11000000011333333333333333333333
11022222011333333333333333333333
11020002011333333333333333333333
11020202011333333333333333333333
11000200011333333333333333333333
11000200011333333333333333333333
11000200011333333333333333333333
11000200011333333333333333333333
11020202011333333333333333333333
11020002011333333333333333333333
11022222011333333333333333333333
11000000011333333333333333333333
11111111111333333333333333333333
11111111111333333333333333333333

