33333333333333333333333333333333
33333333333333333333333333333333
33333333333333333333333333333333
33333333333333333333333333333333
33333333333333333333333333333333
33333333333333333333333333333333
33333333333333333333333333333333
33333333333333333333333333333333
33333333333333333333333333333333
33333333333333333333333333333333
33333333333333333333333333333333
33333333333333333333333333333333
33333333333333333333333333333333
33333333333333333333333333333333
33333333333333333333333333333333
33333333333333333333333333333333
11111111111333333333333333333333
11111111111333333333333333333333
11222022211333333333333333333333
11200000211333333333333333333333
11202222211333333333333333333333
11200000211333333333333333333333
11222220211333333333333333333333
11000020011333333333333333333333
11002000011333333333333333333333
11202222211333333333333333333333
11200000211333333333333333333333
11222220211333333333333333333333
11200000211333333333333333333333
11222022211333333333333333333333
11111111111333333333333333333333
11111111111333333333333333333333

