33333333333333333333333333333333
33333333333333333333333333333333
33333333333333333333333333333333
33333333333333333333333333333333
33333333333333333333333333333333
33333333333333333333333333333333
33333333333333333333333333333333
33333333333333333333333333333333
33333333333333333333333333333333
33333333333333333333333333333333
33333333333333333333333333333333
33333333333333333333333333333333
33333333333333333333333333333333
33333333333333333333333333333333
33333333333333333333333333333333
33333333333333333333333333333333
11111111111333333333333333333333
11111111111333333333333333333333
11000000111333333333333333333333
11000100011333333333333333333333
11000000011333333333333333333333
11000001011333333333333333333333
11000000011333333333333333333333
11000000011333333333333333333333
11000000011333333333333333333333
11000000011333333333333333333333
11000001011333333333333333333333
11000000011333333333333333333333
11000100011333333333333333333333
11000000111333333333333333333333
11111111111333333333333333333333
11111111111333333333333333333333

