33333333333333333333333333333333
33333333333333333333333333333333
33333333333333333333333333333333
33333333333333333333333333333333
33333333333333333333333333333333
33333333333333333333333333333333
33333333333333333333333333333333
33333333333333333333333333333333
33333333333333333333333333333333
33333333333333333333333333333333
33333333333333333333333333333333
33333333333333333333333333333333
33333333333333333333333333333333
33333333333333333333333333333333
33333333333333333333333333333333
33333333333333333333333333333333
11111111111333333333333333333333
11111111111333333333333333333333
11111000011333333333333333333333
11111000011333333333333333333333
11110001011333333333333333333333
11110000011333333333333333333333
11100000011333333333333333333333
11000000011333333333333333333333
11000000011333333333333333333333
11100000011333333333333333333333
11110000011333333333333333333333
11110001011333333333333333333333
11111000011333333333333333333333
11111000011333333333333333333333
11111111111333333333333333333333
11111111111333333333333333333333

