33333333333333333333333333333333
33333333333333333333333333333333
33333333333333333333333333333333
33333333333333333333333333333333
33333333333333333333333333333333
33333333333333333333333333333333
33333333333333333333333333333333
33333333333333333333333333333333
33333333333333333333333333333333
33333333333333333333333333333333
33333333333333333333333333333333
33333333333333333333333333333333
33333333333333333333333333333333
33333333333333333333333333333333
33333333333333333333333333333333
33333333333333333333333333333333
11111111111333333333333333333333
11111111111333333333333333333333
11000000011333333333333333333333
11111110011333333333333333333333
11000010111333333333333333333333
11110110011333333333333333333333
11010000011333333333333333333333
11011111011333333333333333333333
11000000011333333333333333333333
11010001111333333333333333333333
11010000011333333333333333333333
11011111011333333333333333333333
11001000011333333333333333333333
11001001111333333333333333333333
11111111111333333333333333333333
11111111111333333333333333333333

