33333333333333333333333333333333
33333333333333333333333333333333
33333333333333333333333333333333
33333333333333333333333333333333
33333333333333333333333333333333
33333333333333333333333333333333
33333333333333333333333333333333
33333333333333333333333333333333
33333333333333333333333333333333
33333333333333333333333333333333
33333333333333333333333333333333
33333333333333333333333333333333
33333333333333333333333333333333
33333333333333333333333333333333
33333333333333333333333333333333
33333333333333333333333333333333
11111111111333333333333333333333
11111111111333333333333333333333
11001010011333333333333333333333
11001010011333333333333333333333
11001010011333333333333333333333
11001010011333333333333333333333
11001010011333333333333333333333
11001010011333333333333333333333
11001010011333333333333333333333
11001010011333333333333333333333
11001010011333333333333333333333
11001010011333333333333333333333
11001010011333333333333333333333
11001010011333333333333333333333
11111111111333333333333333333333
11111111111333333333333333333333

