33333333333333333333333333333333
33333333333333333333333333333333
33333333333333333333333333333333
33333333333333333333333333333333
33333333333333333333333333333333
33333333333333333333333333333333
33333333333333333333333333333333
33333333333333333333333333333333
33333333333333333333333333333333
33333333333333333333333333333333
33333333333333333333333333333333
33333333333333333333333333333333
33333333333333333333333333333333
33333333333333333333333333333333
33333333333333333333333333333333
33333333333333333333333333333333
11111111111333333333333333333333
11111111111333333333333333333333
11000000011333333333333333333333
11000200011333333333333333333333
11002020011333333333333333333333
11000000011333333333333333333333
11000000011333333333333333333333
11000000011333333333333333333333
11000000011333333333333333333333
11000000011333333333333333333333
11000000011333333333333333333333
11002020011333333333333333333333
11000200011333333333333333333333
11000000011333333333333333333333
11111111111333333333333333333333
11111111111333333333333333333333

