33333333333333333333333333333333
33333333333333333333333333333333
33333333333333333333333333333333
33333333333333333333333333333333
33333333333333333333333333333333
33333333333333333333333333333333
33333333333333333333333333333333
33333333333333333333333333333333
33333333333333333333333333333333
33333333333333333333333333333333
33333333333333333333333333333333
33333333333333333333333333333333
33333333333333333333333333333333
33333333333333333333333333333333
33333333333333333333333333333333
33333333333333333333333333333333
11111111111333333333333333333333
11111111111333333333333333333333
11222022211333333333333333333333
11222022211333333333333333333333
11222022211333333333333333333333
11222022211333333333333333333333
11222022211333333333333333333333
11022022011333333333333333333333
11000200011333333333333333333333
11222022211333333333333333333333
11222022211333333333333333333333
11222022211333333333333333333333
11222022211333333333333333333333
11222022211333333333333333333333
11111111111333333333333333333333
11111111111333333333333333333333

