33333333333333333333333333333333
33333333333333333333333333333333
33333333333333333333333333333333
33333333333333333333333333333333
33333333333333333333333333333333
33333333333333333333333333333333
33333333333333333333333333333333
33333333333333333333333333333333
33333333333333333333333333333333
33333333333333333333333333333333
33333333333333333333333333333333
33333333333333333333333333333333
33333333333333333333333333333333
33333333333333333333333333333333
33333333333333333333333333333333
33333333333333333333333333333333
11111111111333333333333333333333
11111111111333333333333333333333
11000000011333333333333333333333
11011111011333333333333333333333
11010001011333333333333333333333
11010001011333333333333333333333
11010001011333333333333333333333
11010101011333333333333333333333
11010101011333333333333333333333
11011101011333333333333333333333
11011101011333333333333333333333
11000001011333333333333333333333
11111111011333333333333333333333
11000000011333333333333333333333
11111111111333333333333333333333
11111111111333333333333333333333

