33333333333333333333333333333333
33333333333333333333333333333333
33333333333333333333333333333333
33333333333333333333333333333333
33333333333333333333333333333333
33333333333333333333333333333333
33333333333333333333333333333333
33333333333333333333333333333333
33333333333333333333333333333333
33333333333333333333333333333333
33333333333333333333333333333333
33333333333333333333333333333333
33333333333333333333333333333333
33333333333333333333333333333333
33333333333333333333333333333333
33333333333333333333333333333333
11111111111333333333333333333333
11111111111333333333333333333333
11020002011333333333333333333333
11020002011333333333333333333333
11020002011333333333333333333333
11020002011333333333333333333333
11020002011333333333333333333333
11020002011333333333333333333333
11020002011333333333333333333333
11020002011333333333333333333333
11020002011333333333333333333333
11020002011333333333333333333333
11020002011333333333333333333333
11020002011333333333333333333333
11111111111333333333333333333333
11111111111333333333333333333333

