33333333333333333333333333333333
33333333333333333333333333333333
33333333333333333333333333333333
33333333333333333333333333333333
33333333333333333333333333333333
33333333333333333333333333333333
33333333333333333333333333333333
33333333333333333333333333333333
33333333333333333333333333333333
33333333333333333333333333333333
33333333333333333333333333333333
33333333333333333333333333333333
33333333333333333333333333333333
33333333333333333333333333333333
33333333333333333333333333333333
33333333333333333333333333333333
11111111111333333333333333333333
11111111111333333333333333333333
11000000211333333333333333333333
11020002011333333333333333333333
11200020011333333333333333333333
11000200011333333333333333333333
11002000011333333333333333333333
11020000011333333333333333333333
11000002011333333333333333333333
11000020011333333333333333333333
11000200011333333333333333333333
11002000211333333333333333333333
11020002011333333333333333333333
11200000011333333333333333333333
11111111111333333333333333333333
11111111111333333333333333333333

