33333333333333333333333333333333
33333333333333333333333333333333
33333333333333333333333333333333
33333333333333333333333333333333
33333333333333333333333333333333
33333333333333333333333333333333
33333333333333333333333333333333
33333333333333333333333333333333
33333333333333333333333333333333
33333333333333333333333333333333
33333333333333333333333333333333
33333333333333333333333333333333
33333333333333333333333333333333
33333333333333333333333333333333
33333333333333333333333333333333
33333333333333333333333333333333
11111111111333333333333333333333
11111111111333333333333333333333
11111011111333333333333333333333
11111011111333333333333333333333
11111011111333333333333333333333
11111011111333333333333333333333
11111011111333333333333333333333
11011011011333333333333333333333
11000100011333333333333333333333
11111011111333333333333333333333
11111011111333333333333333333333
11111011111333333333333333333333
11111011111333333333333333333333
11111011111333333333333333333333
11111111111333333333333333333333
11111111111333333333333333333333

