33333333333333333333333333333333
33333333333333333333333333333333
33333333333333333333333333333333
33333333333333333333333333333333
33333333333333333333333333333333
33333333333333333333333333333333
33333333333333333333333333333333
33333333333333333333333333333333
33333333333333333333333333333333
33333333333333333333333333333333
33333333333333333333333333333333
33333333333333333333333333333333
33333333333333333333333333333333
33333333333333333333333333333333
33333333333333333333333333333333
33333333333333333333333333333333
11111111111333333333333333333333
11111111111333333333333333333333
11111111111333333333333333333333
11100000011333333333333333333333
11101100111333333333333333333333
11101100011333333333333333333333
11113310011333333333333333333333
11133300011333333333333333333333
11133300011333333333333333333333
11113310011333333333333333333333
11101100011333333333333333333333
11101100111333333333333333333333
11100000011333333333333333333333
11111111111333333333333333333333
11111111111333333333333333333333
11111111111333333333333333333333

