33333333333333333333333333333333
33333333333333333333333333333333
33333333333333333333333333333333
33333333333333333333333333333333
33333333333333333333333333333333
33333333333333333333333333333333
33333333333333333333333333333333
33333333333333333333333333333333
33333333333333333333333333333333
33333333333333333333333333333333
33333333333333333333333333333333
33333333333333333333333333333333
33333333333333333333333333333333
33333333333333333333333333333333
33333333333333333333333333333333
33333333333333333333333333333333
11111111111333333333333333333333
11111111111333333333333333333333
11000000011333333333333333333333
11222220011333333333333333333333
11000020211333333333333333333333
11220220011333333333333333333333
11020000011333333333333333333333
11022222011333333333333333333333
11000000011333333333333333333333
11020002211333333333333333333333
11020000011333333333333333333333
11022222011333333333333333333333
11002000011333333333333333333333
11002002211333333333333333333333
11111111111333333333333333333333
11111111111333333333333333333333

