33333333333333333333333333333333
33333333333333333333333333333333
33333333333333333333333333333333
33333333333333333333333333333333
33333333333333333333333333333333
33333333333333333333333333333333
33333333333333333333333333333333
33333333333333333333333333333333
33333333333333333333333333333333
33333333333333333333333333333333
33333333333333333333333333333333
33333333333333333333333333333333
33333333333333333333333333333333
33333333333333333333333333333333
33333333333333333333333333333333
33333333333333333333333333333333
11111111111333333333333333333333
11111111111333333333333333333333
11000000011333333333333333333333
11000000011333333333333333333333
11000000011333333333333333333333
11000000011333333333333333333333
11000000011333333333333333333333
11000000011333333333333333333333
11000000011333333333333333333333
11000000011333333333333333333333
11110001111333333333333333333333
11111011111333333333333333333333
11111011111333333333333333333333
11111111111333333333333333333333
11111111111333333333333333333333
11111111111333333333333333333333

