33333333333333333333333333333333
33333333333333333333333333333333
33333333333333333333333333333333
33333333333333333333333333333333
33333333333333333333333333333333
33333333333333333333333333333333
33333333333333333333333333333333
33333333333333333333333333333333
33333333333333333333333333333333
33333333333333333333333333333333
33333333333333333333333333333333
33333333333333333333333333333333
33333333333333333333333333333333
33333333333333333333333333333333
33333333333333333333333333333333
33333333333333333333333333333333
11111111111333333333333333333333
11111111111333333333333333333333
11000000011333333333333333333333
11222222211333333333333333333333
11222022211333333333333333333333
11022000011333333333333333333333
11022000011333333333333333333333
11022000011333333333333333333333
11022000011333333333333333333333
11022000011333333333333333333333
11022000011333333333333333333333
11022222211333333333333333333333
11022222211333333333333333333333
11000000011333333333333333333333
11111111111333333333333333333333
11111111111333333333333333333333

