--------------------------------
--------------------------------
--------------------------------
--------------------------------
--------------------------------
--------------------------------
--------------------------------
--------------------------------
--------------------------------
--------------------------------
--------------------------------
--------------------------------
--------------------------------
--------------------------------
--------------------------------
--------------------------------
--------------------------------
--------------------------------
--------------------------------
--------------------------------
--------------------------------
--------------------------------
--------------------------------
---------XXX--------------------
---------XXX--------------------
---------XXX--------------------
------XX-XXX--------------------
-----XXX-XXX--------------------
----XXXX-XXX--------------------
---XXXXX-XXX--------------------
--XXXXXX-XXX-------XX-----------
XXXXXXX--XXXXXXXXXXXXXXX--------
