--------------------------------
--------------------------------
--------------------------------
--------------------------------
--------------------------------
--------------------------------
--------------------------------
--------------------------------
--------------------------------
--------------------------------
--------------------------------
--------------------------------
--------------------------------
--------------------------------
--------------------------------
--------------------------------
--------------------------------
--------------------------------
--------------------------------
--------------------------------
-------------------oo-----------
------------?-----XXXX----------
--------------------------------
--------------------------------
o----ooo------E--------XXXX--o--
----------XXXXXX------------XXX-
--------------------------------
------XXXX-----ooo--------------
-----------------E--------------
---------XXXXXXXXXX-------------
XXXXXX--------------------------
----------------------------XXXX
