--------------------------------
--------------------------------
--------------------------------
--------------------------------
--------------------------------
--------------------------------
--------------------------------
--------------------------------
--------------------------------
--------------------------------
--------------------------------
--------------------------------
--------------------------------
--------------------------------
--------------------------------
--------------------------------
--------------------------------
--------------------------------
--------------------------------
--------------------------------
SSSSSSSSSSSSSSSS-------SSSS-----
--------------------------------
------------------------?-------
-----------------------S??------
----------------------------XXX-
--------------------------------
------------E-------------------
-----------<>------XXX-SSSS-----
--------XX-[]--XXX--------------
-------XXX-[]--XXX--------------
---E-E-XXX-[]--XXX--------------
XXXXXXXXX--XX--XX------XXXX-----
