--------------------------------
--------------------------------
--------------------------------
--------------------------------
--------------------------------
--------------------------------
--------------------------------
--------------------------------
--------------------------------
--------------------------------
--------------------------------
--------------------------------
--------------------------------
--------------------------------
--------------------------------
--------------------------------
--------------------------------
--------------------------------
--------------------------------
--------------------------------
--------------------------------
--------------------------------
--------------------------------
---------XX---------------------
---------XX---------------------
-------XXXX---------------------
-------XXXX---------------------
-----XXXXXX---------------------
-----XXXXXX---------------------
-----XXXXXX---------------------
-E---XXXXXX--------X------------
XXXXXXXXXXXXXXXXXXXXXX----------
