--------------------------------
--------------------------------
--------------------------------
--------------------------------
--------------------------------
--------------------------------
--------------------------------
--------------------------------
--------------------------------
--------------------------------
--------------------------------
--------------------------------
--------------------------------
--------------------------------
--------------------------------
--------------------------------
--------------------------------
--------------------------------
--------------------------------
--------------------------------
--------------------------------
--------------------------------
--------------------------------
-----------------------XXX------
----------------------XXXX------
-o------XX-----------EXXXX------
--E-----XX----------XXXXXX------
SSSS----XX---------XXXXXXX------
-------XXX-------EXXXXXXXX------
---E---XXX-------XXXXXXXXX------
-------XXX------XXXXXXXXXX------
XXXXXXXXXX---XXXXXXXXXXXXXXXXXXX
