--------------------------------
--------------------------------
--------------------------------
--------------------------------
--------------------------------
--------------------------------
--------------------------------
--------------------------------
--------------------------------
--------------------------------
--------------------------------
--------------------------------
--------------------------------
--------------------------------
--------------------------------
--------------------------------
--------------------------------
--------------------------------
--------------------------------
--------------------------------
--------------------------------
--------------------------------
--------------------------------
-------------------SSSSSSSS-----
--------------------------------
--------------------------------
--------------------------------
------E-----------X----S----X---
-----<>-----------X------E--X---
-----[]-----------X---------X---
-----[]-----E-EE--X---------X---
XXXXXXXXXXXXXXXXXXXXXXXXXXXXXXXX
