--------------------------------
--------------------------------
--------------------------------
--------------------------------
--------------------------------
--------------------------------
--------------------------------
--------------------------------
--------------------------------
--------------------------------
--------------------------------
--------------------------------
--------------------------------
--------------------------------
--------------------------------
--------------------------------
--------------------------------
--------------------------------
--------------------------------
--------------------------------
--------------------------------
--------------------------------
--------------------------------
---E----------------------------
--<>----------------------------
--[]----------------------------
--[]------E--------E------------
--XXX----<>------E<>-----E------
---------[]----E<>[]----<>------
---------[]---<>[][]----[]------
--E------[]---[][][]----[]------
XXXXXXXXXXXXXXXXXXXXXXXXXXXXXXXX
