--------------------------------
--------------------------------
--------------------------------
--------------------------------
--------------------------------
--------------------------------
--------------------------------
--------------------------------
--------------------------------
--------------------------------
--------------------------------
--------------------------------
--------------------------------
--------------------------------
--------------------------------
--------------------------------
--------------------------------
--------------------------------
--------------------------------
--------------------------------
SSSSSSSSSSSSSSSSSSSSSSSSSSS-----
SSSSSSSSSSSSSSSS----------------
SSSSSSSSSSSSSSSS----------------
SSSSSSSSSSSSSSSS-----E----------
S-------------------<>----------
S-------------------[]----------
-?oooooooooo--------[]----------
-??SSSSSSSSS----XX--[]----------
---------------XXX--[]---SS-----
--------------XXXX--[]---SS-----
--------EE---XXXXX--[]---SS-----
XXXXXXXXXXXXXXXXXXXXXXX--XX-----
