--------------------------------
--------------------------------
--------------------------------
--------------------------------
--------------------------------
--------------------------------
--------------------------------
--------------------------------
--------------------------------
--------------------------------
--------------------------------
--------------------------------
--------------------------------
--------------------------------
--------------------------------
--------------------------------
--------------------------------
--------------------------------
--------------------------------
--------------------------------
--------------------------------
--------------------------------
--------------------------------
------------------------------SS
--------------------------E-----
--------------------E----<>-----
----------E--------<>----[]-----
---------<>---SS---[]----XXX----
-E-------[]--------[]----------E
<>-------[]--------[]---------<>
[]-------[]--------[]---------[]
XXXXXXXXXXXXXXXXXXXXXXXXXXXXXXXX
