--------------------------------
--------------------------------
--------------------------------
--------------------------------
--------------------------------
--------------------------------
--------------------------------
--------------------------------
--------------------------------
--------------------------------
--------------------------------
--------------------------------
--------------------------------
--------------------------------
--------------------------------
--------------------------------
--------------------------------
--------------------------------
--------------------------------
--------------------------------
--------------------------------
--------------------------------
--------------------------------
---------------------SSSS-------
--------------------------------
--------------------------------
-----------------X--------------
--------S?S-----EX---S-----X----
---------------XXX---------X----
--------------XXXX---------XX---
-------------XXXXX----EE---XX---
XXXXXXXXXXXXXXXXXXXXXXXXXXXXXXXX
