--------------------------------
--------------------------------
--------------------------------
--------------------------------
--------------------------------
--------------------------------
--------------------------------
--------------------------------
--------------------------------
--------------------------------
--------------------------------
--------------------------------
--------------------------------
--------------------------------
--------------------------------
--------------------------------
--------------------------------
--------------------------------
--------------------------------
--------------------------------
--------------------------------
--------------------------------
--------------------------------
--------------------------------
--------------------------------
----------------E---------------
------------E--<>---------------
--------E--<>--[]---------------
-------<>--[]--[]---------------
-------[]--[]--[]---------------
-EE-E--[]--[]--[]--------EE-E--E
XXXXXX-XX--XX--XXXXXXXXXXXXXXXXX
