--------------------------------
--------------------------------
--------------------------------
--------------------------------
--------------------------------
--------------------------------
--------------------------------
--------------------------------
--------------------------------
--------------------------------
--------------------------------
--------------------------------
--------------------------------
--------------------------------
--------------------------------
--------------------------------
--------------------------------
--------------------------------
--------------------------------
--------------------------------
--------------------------------
--------------------------------
--------------------------------
SS--------SSSSS------SSSS-------
--------------------------------
--------------------------------
----E---------------------------
---<>---QQQQ--QQQ---------------
---[]---------------------------
---[]---------------------------
---[]-------E-EE-------------E--
XXXXXXXXXXXXXXXXXXXXX----XXXXXXX
