--------------------------------
--------------------------------
--------------------------------
--------------------------------
--------------------------------
--------------------------------
--------------------------------
--------------------------------
--------------------------------
--------------------------------
--------------------------------
--------------------------------
--------------------------------
--------------------------------
--------------------------------
--------------------------------
--------------------------------
--------------------------------
--------------------------------
--------------------------------
--------------------------------
--------------------------------
--------------------------------
--------SSQSSS?SSS--------SSS---
--------------------------------
--------------------------------
-E------------------------SSS---
<>------SSSSSSSSSSS-------------
[]------------------------------
[]------------------------------
[]------------------------------
XXXXXXXXXXXXXXXXXXXXXXXXX----XXX
