--------------------------------
--------------------------------
--------------------------------
--------------------------------
--------------------------------
--------------------------------
--------------------------------
--------------------------------
--------------------------------
--------------------------------
--------------------------------
--------------------------------
--------------------------------
--------------------------------
--------------------------------
--------------------------------
--------------------------------
--------------------------------
--------------------------------
--------------------------------
--------------------------------
--------------------------------
--------------------------------
----------------XX--------------
---------------XXX--------------
--------------XXXX--------------
-------------XXXXX--------------
------------XXXXXX---S----------
-----------XXXXXXX--------------
----------XXXXXXXX--------------
---------XXXXXXXXX--------X-----
XXXXXXXXXXXXXXXXXXXXXXXXXXXXXX--
