--------------------------------
--------------------------------
--------------------------------
--------------------------------
--------------------------------
--------------------------------
--------------------------------
--------------------------------
--------------------------------
--------------------------------
--------------------------------
--------------------------------
--------------------------------
--------------------------------
--------------------------------
--------------------------------
--------------------------------
--------------------------------
--------------------------------
--------------------------------
SSSSSSSSSSSSSSSSSSSSSSSSSSSSSSSS
--------------------------------
--------------------------------
--------------------------------
--------------------------------
--------------------------------
--------------E-----------------
--------E----<>-----------------
-------<>----[]-----E-----SS----
-------[]----[]----<>-----SS----
E-EE---[]----[]--E-[]-----SS----
XXXXXXXXXXXXXXXXXXXXXXXX--XX--XX
