--------------------------------
--------------------------------
--------------------------------
--------------------------------
--------------------------------
--------------------------------
--------------------------------
--------------------------------
--------------------------------
--------------------------------
--------------------------------
--------------------------------
--------------------------------
--------------------------------
--------------------------------
--------------------------------
--------------------------------
--------------------------------
--------------------------------
--------------------------------
--------------------------------
-----------------------XX-------
-----------------------XX-------
SS---?-------------S---XX-------
-----------------------XX-------
-----------------------XX-------
-----------------------XX-------
----------E-------SS---XX-------
---E-----<>------------XX-------
---------[]------------XX-------
---------[]E-----------XX-------
XXXXXXXXXXXXXXXXXXXXXXXXXXXXXXXX
