--------------------------------
--------------------------------
--------------------------------
--------------------------------
--------------------------------
--------------------------------
--------------------------------
--------------------------------
--------------------------------
--------------------------------
--------------------------------
--------------------------------
--------------------------------
--------------------------------
--------------------------------
--------------------------------
--------------------------------
--------------------------------
--------------------------------
--------------------------------
--------------------------------
--------------------------------
------oo------------------------
--------------------------------
--------------------------------
--------------------------------
--E-----------------------------
-<>-----------------------------
-[]----------E------------------
-[]---------<>------------------
-[]-E-EE----[]-E-----E----EE-E--
XXXXXXXXXXXXXXXXXXXXXXXXXXXXXXXX
