----------------------------------------------------------------------------------------------------------------------------------------------------------------------------------------------------------------------------------------------------------------------------------------
----------------------------------------------------------------------------------------------------------------------------------------------------------------------------------------------------------------------------------------------------------------------------------------
---------------------------------------------------------------------------------------------------------------------SSSSSSSSSSSSSSSSSSSSSSS--------------------------------------------------------------------------------------------------------------------------------------------
----------------------------------------------------------------------------------------------------------------------------------------------------------------------------------------------------------------------------------------------------------------------------------------
----------------------------------------------------------------------------------------------------------------------------------------------------------------------------------------------------------------------------------------------------------------------------------------
-------------S----------------------------------------------------------------------X-------QQSSSSS----------S--SSS----------------------------------------X---------------SSSSSSSS------------SSSSS------SSSSSS------------SSSS----------------------------X-------QQSSSS--------------
----------------------------------------------------------------------------------------------------------------------------------------------------------XX----------------------------------------------------------------------------------------------------------------------------
------------------------------------------------------------------------------------E---------------------------------------------------------------------XX----------------------------------------------------------------------------------------------------------------------------
------------------------------------------------------------------------------------XXX-----------------------------------------------------------------XXXX-------------------------------------------------------------------------------------------------XX-------------------------
---------------------S--S--------------------------------------------XXXXX-----------------S?--SSSSS---------X--SSSSS-------------XXX------X-----------X--XX-------------------SS------------------------SSS-SS---------------------------------E------------------S?--SSSSS---------<>-
------------------------------------------------------E-----------------------------------------------------XXXX-------E---------XXXX------X----------XXXXXX-----E-----------------------------------------------------------------------------<>------------------------------------[]-
-----------------------------------------------------<>---------------------------------------------------------------<>--------XXXXX------X----------XXXXXX-----X-----------------------------------------------------------------------------[]------------------------------------[]-
-------E-E-------------------------------------------[]------------------------------------------------E--------------[]-------XXXXXX----XXX-E-EE---XXXXXXXX-----X------------------------E---------------------------EE-----------------------[]------------------------------E-----[]-
---XXXXXXXXXXXXXXXXXXXXXX-XXXXXXXXXXXXXXXXXXXXXXXXXXXXXXXXXXXX----XXXXX----XXXXXXXXX---XXXXXXX--XXXXXXXXXXXXXX--XXXXXXXXXXXXXXXXXXXXXXXXXXXXXXXXXXXXXXXXXXXXX-XXXXXXXXXXXXXXXXXXXXXXXXXXXXXXXXXXXXXXXXXXXXXXXXXXXXXXXXXXXXXXXXXXXXXXXXXXXXXXXXXXXXXX--XXXXXXXXXXXXXXXXXXXXXXXXXXXXXXXXX-
