----------------------------------------------------------------------------------------------------------------------------------------------------------------------------------------------------------------------------------------------------------------------------------------
----------------------------------------------------------------------------------------------------------------------------------------------------------------------------------------------------------------------------------------------------------------------------------------
----------------------------------------------------------------------------------------------------------------------------------------------------------------------------------------------------------------------------------------------------------------------------------------
----------------------------------------------------------------------------------------------------------------------------------------------------------------------------------------------------------------------------------------------------------------------------------------
-----------------------------------------------------------------------------------------------------------------------------------------------------------------------------------------------------------------------------------------------------------------------X----------------
--------------------------------------------------------------------------------------XX----------------------------------------------------Q-------------------------------------------------------------------------------------------------------------------------------------------
------------------------------------------------------------------------------------------------------------------------------------------------XX-------------------------------------X------------------------------------------------------------------------------------------------
-------------------------------------------X------------------------------------------------------------------------------------------------------------------------------------------XX----------------------------XX------------------------------------------------------------------
-------------------------------------------X-----------------------------------------------------------------------------------------------------------------------------------------XXXX---------------------------XX------------------------------------------------------------------
--------------XX-----------------------------------------------------XXXXX---------------------------------S---------------------------------------------XXXXXXX---------------------XXX--------------------Q-------XX-----------------------------------------------------Q------------
--------------XX-----------------------XXXXX--------------------------------------------------------------------------------------------------------------------------------------XXXXXXX-------------------------X-XX---------E--------------------------------------E-----------------
-------------XXX----------------------XXXX-X-------------------------X----------------------------------------------------------X--X---------------------------------------------XXXXXXXX------------------------XXXXX----X---<>-------------------------------------<>-----------------
-----------E-XXX--------------------XXXXXXEX--------E---------------EX-------E-EE-----------E---E--------------------------------------------------------E-------E--E------------XXXXXXXX-----------EE-E--------XXXXXX----X---[]------------E------------------------[]-----------------
XXXXX-----XXXXXX---XXXXXXXXXXXXXXXXXXXXXXXXXXXXX----XXXXX---XX--XXXXXX----XXXXXXXXXXXXXXXXXXXXXXXXXXXXXXXXXXXXXXXXXXXXXXXXXXXXXXXXXXXXXXXXXX---------XXXXXX---XXXXXXXXXXXXXXXXXXXXXXXXXXXXXXXXXXXXXXXXXXXXXXXXXXXXXXXXXX--XXXXXXXXXXXXXXXXXXXXXXXX---X--XXXXXXXXXXXXXXXXXXXXXX-------XXX
