----------------------------------------------------------------------------------------------------------------------------------------------------------------------------------------------------------------------------------------------------------------------------------------
----------------------------------------------------------------------------------------------------------------------------------------------------------------------------------------------------------------------------------------------------------------------------------------
SSSSSSSSSSSSSSSSSSSSSSSSSSSS--------------------------------------------------------SSSSSSSSSSSSSSSSSSSSSSSSSSSS--------------------------------------------------------------------------------------------------------------------------------------------SSSSSSSSSSSSSSSSSSSS--------
----------------------------------------------------------------------------------------------------------------------------------------------------------------------------------------------------------------------------------------------------------------------------------------
---------S------------------------------------------------------------------------------------------------------------------------------------------------------------------------------------------------------------------------------------------------------------------------------
-SSS----S--------------------------QQQQQ------------SSSS----------------------------------------------------------------------------------------------------------------------------------------------------S--------SSSS--------SSS-------------------SS-------------------------------
----------------------------------------------------------------------------------------------------XX----------------------------------------------------------------------------------------------------------------------------------------------------------------------------------
-----------------------------------------------------------------------------------------------------XX---------------------------------------------------------------------------------------------------------------------------------------------------------------------------------
----------E-----------------------------------------------------------------------------------------XXXS----------------------------------------------------------------------------------------------XX---------------------------------------------------------------------------E----
---SS---SSS---------E-------------Q---QQQ-------------------------------------------<>------Q-S------X-X--X---------------------------SSSSSS--------------------------------------------E-------------XXX-------XXX----------XX-----------------------------SS-S----SQS-----------<>----
--SSS---SSS--------<>------X------------------------------------------------------E-[]--------------XX---XX----------------------------------------------------------------------------<>------------------------------------XX----------------X-------------------------------X--[]----
SS-SS---SSS--------[]------------------------------------------------------------<>-[]----------XXXXXX-X--X----------------------------------------------------------------------------[]------------------------------------XX---------------------------------------------<>-X--[]----
S-SSS-ESSSS--------[]-------------------------E----------------------------------[]-[]-E--E-----XXXXXX-X--X------X-----EEE-------------E----------------E------------EE----------------[]-E-----------------------------E-E--X------------------------------E-----E---------[]----[]----
XXXXXXXXXXXXXXXXXXXXXXXXXXXXXXXXXXXXXXXXXXXXXXXXXX---X--XXXXXXXXXXXXXXXXXXXXXXXXXXXXXXXXXXXXXXXXXXXXXX----XXXXXXXXXXXXXXXXXXXXXXXXXXXXXXXXXXXXXXXXXXXXXXXXXXXXXXXXXXXXXXXXXXXXXXXXXXXXXXXXXXX----XXXXXX---XXX----XXXXXXXXXXXXXXXXXXXXXXXXXXXX---------------XXXXXXXXXXXXXXXXXXXXXXXXXXXX
