----------------------------------------------------------------------------------------------------------------------------------------------------------------------------------------------------------------------------------------------------------------------------------------
----------------------------------------------------------------------------------------------------------------------------------------------------------------------------------------------------------------------------------------------------------------------------------------
----------------------------------------------------------------------------------------------------------------------------------------------------------------------------------------------------------------------------------------------------------------------------------------
----------------------------------------------------------------------------------------------------------------------------------------------------------------------------------------------------------------------------------------------------------------------------------------
----------------------------------------------------------------------------------------------------------------------------------------------------------------------------------------------------------------------------------------------------------------------------------------
------------------------------------------------------------------------------------------------------SS---------------------------------------------------------------------SSQQQQQQQQ------------S-----------------------------------------------------------S------------------------
----------------XXXX------------------------------------------------------XX------------------------------------------------------------------------------------------------------------------------------------------------------------------------------------------------------------
----------------------------------------------------------------------------------------------------------------------------------------------------------------------------------------------------------------------------------------------------------------------------------------
--------------------------------------------------------------------------------------XXX-----------------------------------------------------------------------------------------------------------------------------------------------------------------------------------------------
-----------------SS-S------S----------------E-------------------------------SS--S-SS------------XXX--------------------------------------------------------X------------------SS?-QSSSQQ-----------------------------------------------------------------S------------------------------
-E-----------------------------------------<>-----------------------------------------------------------------------------------E-----------------------XX------------------------------------------------------------X-----------------------------------------------------------------
XXXX---------------------------------------[]-----------XX---------------------------------------------------------------------<>----------------------XXX----------------------------------------------------------XXX-------------------------------------------------------X---------
--------------------------------E------E---[]-----------XX----------------------------------------------------------EE----E----[]----------------------XXX----------E----------------------E------------------------XXX-----------------E----E---------E----------------------X---------
-----XXXX----XXXXXXXXXXXXXXXXXXXXXXXXXXXXXXXXXXX-----XXX---XXXXXXXX-XXXXXXXXXXXXXXXXXXX---XXXX-X--XXXXXXXXXXXXXXXXXXXXXXXXXXXXXXXXXX--XXXXXXXXXXXXX---XXXXX---XXXXXXXXXXXXXXXXXXXXXXXXXXXXXXXXXXXX--XXXXXXXXXXXXXXXXXXXXXXXXXXXXXXXXXXXXXX-XXXXXXXXXXXXXXXXXXXXXXXXXXXXXXXXXXXXXXXXXXXXX
