----------------------------------------------------------------------------------------------------------------------------------------------------------------------------------------------------------------------------------------------------------------------------------------
----------------------------------------------------------------------------------------------------------------------------------------------------------------------------------------------------------------------------------------------------------------------------------------
----------------------------------------------------------------------------------------------------------------------------------------------------------------------------------------------------------------------------------------------------------------------------------------
----------------------------------------------------------------------------------------------------------------------------------------------------------------------------------------------------------------------------------------------------------------------------------------
----------------------------------------------------------------------------------------------------------------------------------------------------------------------------------------------------------------------------------------------------------------------------------------
------------------SS------------------------------------------------------------S----------------------------------------------------------------------------------------------------------XX-X-XX--Q-----------------------------------------------------------------------------------
-----------------------------------------------------------------------------------------------------------X-----------------------------------------------XXX-----------------------------------------XXX-----------------X------------------------------------------------------------
----------------------------------------------------------------------------------------------------------------------------------------------------------XXXX--------------------------------------------------------------------------------------------------------------------------
-XXXX---------------------E------------------------------------------------------------------------------------------------------------------------------XXXXX--------------------------------------------------------------------------------------------------------------------------
------------XXX----------<>-------Q---------Q------------------------------------------------------XX---------------------------------SSSSSS----------X--XXXXX--------------------------------------X------------XXXXXXX----------------------XXXX--------------------------X-----------
-------------------------[]-----------------------------------------------X---------------------------------------------------------------------------XXXXXXXX-------------------------------------------------------------------------------------------------------------XX-----------
-------------------------[]---------------------------------------------X-X--------------------------------------------------------------------------XXXXXXXXX------------------------------------------------------------------------------------------------------------XXX-----------
----------------------E--[]---------------------------------------------XXX----------------------E---------------------EE----------------------------XXXXXXXXX------E-------------------------------------------------------------------------------------E--E-----------XXXX-----------
------XX-------------XX-XXXXXXXXXXXXXXXXXXXXXXXXXXXXXXXXXXXXXXXXXXXXXXXXXXXXXXX--XXXXX------XXXXXX--------------X--XXXXXXXXXXXXXXXXXXXXXXXXXXXXXX----XXXXXXXXXXXXXXXX-XXXXXXX-XXX--------XXXX-------X----X-----X----------------XXXXXXX---XXXXX----XXXXXXXXXXXXXXXXXXXXXXXXXXXXX--XXXXXX
