----------------------------------------------------------------------------------------------------------------------------------------------------------------------------------------------------------------------------------------------------------------------------------------
----------------------------------------------------------------------------------------------------------------------------------------------------------------------------------------------------------------------------------------------------------------------------------------
----------------------------------------------------------------------------------------------------------------------------------------------------------------------------------------------------------------------------------------------------------------------------------------
---------------------------------------------------------------------------------------------E------------------------------------------------------------------------------------------------------------------------------------------------------------------------------------------
---------------------------------------------------------------------------------------------XXX----------------------------------------------------------------------------------------------------------------------------------------------------------------------------------------
----------------------------Q-------------------------------------------------------------------------------------------------------------------------------------------------------------------------------------------------------------------------------------------SS--------------
-----------------XX-------------X-------------------------------------------------------------------------------------------------------------------------------------------------------XXXX--------------------------------------------------------------------------------------------
----------------XXX---------------------------------------------------------------------------------------------------------------------------------------------------------------------------------------------------------------------------------------------------------------------
---------------XXXX-------------------------------------------------------------------------------------------------------------------------------------------------------------------------------E------------------------------------------------------------XXXX-------------------XX
--------------XXXXX----------------------XXXXX---------------E---------<>--------------------------Q----------E--------------------------------------------<>------------X-----------------------QQS------Q---------E-----------------------------------------------------------S-------
-------------XXXXXX-----------------------------------------<>---------[]---------------------E--------------<>---------------------------E----------------[]------------X-----------------------------------------<>----------------------------------------X--------------------------
------------XXXXXXX-----------------------------------------[]---------[]--------------------<>--------------[]--------------------------<>----------------[]-----------XXXX---------------------------------------[]------------------------X------------------------------------------
----------XXXXXXXXX-----------------------------------------[]-----E---[]--------------------[]--------------[]--------------------------[]----------------[]-----------XXXX---------------------------------------[]-E---------------------E---------------XXX-------------------------
XXXXX----XXXXXXXXXXX---XXXXXXX--XXX---XXX---------------XXXXXXXXXXXXXXXXXXXX---XXXXXXXXXXXXXXXXXXXXXXXXXXXXXXXXXXXXXXXXXXXXXXXXXXXXXXXXXXXXXXXXXXXXXXXXXXXXXXXXX--XXXXXXXXXXXXXXXXX--XXXXXXXXXXXXXXXXXXXXXXXXXXXXXXXXXXXXXXXXXXXXXXXXXX-XXXXXXXXXXXXXXXXXXXX------XXXXX---XXXXXXXXXXX---
