----------------------------------------------------------------------------------------------------------------------------------------------------------------------------------------------------------------------------------------------------------------------------------------
----------------------------------------------------------------------------------------------------------------------------------------------------------------------------------------------------------------------------------------------------------------------------------------
----------------------------------------------------------------------------------------------------------------------------------------------------------------------------------------------------------------------------------------------------------------------------------------
----------------------------------------------------------------------------------------------------------------------------------------------------------------------------------------------------------------------------------------------------------------------------------------
----------------------------------------------------------------------------------------------------------------------------------------------------------------------------------------------------------------------------------------------------------------------------------------
-----------------------------S----------------------------S--------------------SSS------------------------------------------------------SSXX-------------------------XXX---S----S--------------SSSS-------------------------------SS---SS----S--------SSSS----------QQSSSQ--------------
----------------------------------------------------------------------------------------------------------------------------------------------------------------------------------------------------------------------------------------------------------------------------------------
----------------------------------------------------------------------------------------------------------------------------------------------------------------------------------------------------------------------------------------------------------------------------------------
-----------------------------------------------------------------------------------------E----------E-------------------------------------------------------------------------------------------------XXX-------------------------E---------------------------S-----------------------E-
-------------XXX------------SSSQ--------------XX----------------------------------------<>---------<>----------E------------QQQQ--------S-----------------------SS-SS-------------------------------------------SSS-------------SSSSS-------------XX-------------------SSSSS---------<>-
------------XXXX-------------------E---------XXX----------------------------------------[]---------[]---------<>-----------------------------------------------------------------------------------------------------------------------E----------XX---------------------------------[]-
-----------XXXXX------------------<>--------XXXX-------X--------------------------------[]---------[]---------[]--------------------------------------------------------------------------X-------------------------------------------<>--------XXXX---------------------------------[]-
----------XXXXXX--------E---------[]-------XXXXX-----XXX--------------------------------[]---------[]---------[]--------------------------------------------------------------------------E-------------------------------------------[]-------XX-XX---------------------------E-----[]-
XXXXXXX--XXXXXXXXXXXXXXXXXXXXXXXXXXXXXXXXXXXXXXXXXXXXXXXXXXXXXXXXXXXX--XXXXXX---------XXXXXXXXXXXXXXXXXXXXXXXXXXXXXXXXXXXX-XXXXXXXXXXXXXXX-XXXXXXXXXXXXXXXXXXXXXXXXXXXXXXXXXXXXXXXXXXXXXXXXXXXXXXXXXXXXXXXXXXXXX----XXX---------XXXXXXXXXXXXXXXXXXXXXXXXXXXXXXXXXXXXXX-XXXXXXXXXXXXXXXXX
