----------------------------------------------------------------------------------------------------------------------------------------------------------------------------------------------------------------------------------------------------------------------------------------
----------------------------------------------------------------------------------------------------------------------------------------------------------------------------------------------------------------------------------------------------------------------------------------
SSSSSSSSSSSSSSSSSSSSSSSSSSSS------------------------------------------------------------------------------------------------------------------------------------------------------------------------------------------------------------------------------------------------------------
----------------------------------------------------------------------------------------------------------------------------------------------------------------------------------------------------------------------------------------------------------------------------------------
------------------------------------------------------------------------------------------------------------------------------------------------------------------------------------------------------------X---------------------------------------------------------------------------
----------------XX------------SS---SS--------------------XXX-------------------------------------X------XXXXXXX---------------------------------SSSSSSSSS--S-----------S------------------X--------------------------XXX------------------------------XXXXX-S---------------------------
---------------XXX-----------------------------------------------------------------------------------------------------------------------------------------------------------------------XX---------------------------------------------------------------------------------------------
---------------XXXX--------------------------------------------------------------------------------------------------------------------------------------------------------------------XXXX---------------------------------------------------------------------------------------------
--------------XXXXXS----------E-------------------------------------------------------------------------------------S-SSS-------------------------------------------------------------XXXXX------------XXXX-----------------------------------------------------------------------------
-E------Q-XXXX--XX----X-----SSSSS-------------XX------X------------------------------X---------------?S-SS------------------S?S-----------E------SSSSSSS-----------------------------XXXXXX---------------------XX----------------------------XXX-----------QQQQ--------------XXXX----XX
<>--------X-XXX-XX---XX------------E----------X--------------------------------------X---------------------------------------------------<>------------------------E-----------------XXXXXX----------------------------------EX------------------------------------E-----XXX-XXXX-------
[]-------XXXXXXXXX---XX-----------XX--------X-XX-----------------------------------------------------------------------------------------[]-----------------------<>---------------XXXXXXXX----------------------------------XX-----------------------------------<>----------XX--------
[]-E--------XXXXXX---XX--------------------XX-X----------------EE------------------------------------------------------E-E---------------[]--------------------EE-[]--------------XXXXXXXXX-----E--X--------------------------------------------------------------[]-------X--XXX-------
XXXXXXXXXXXXXXXXXX---XXXXXXXXXXX-XXXXXXXXX-XXXXXXXXXXXXXXXXXXXXXXXXXXXXXXX---XXXXXXX-------XXX----XXXXXXXXXXXXXXXXXXXXXXXXXXXXXXXXXXXXXXXXXXXXXXXXXXXXXXXXXXXXXXXXXXXXXXXXXXXXX--XXXXXX--XXXXXXXX-XX-------XXXX-----------------XXXXXXX---XXXXXXXXXXXXXXXXXXXXXXXXXXXXXXXXXXXXXXXXXXXXXX
