----------------------------------------------------------------------------------------------------------------------------------------------------------------------------------------------------------------------------------------------------------------------------------------
----------------------------------------------------------------------------------------------------------------------------------------------------------------------------------------------------------------------------------------------------------------------------------------
----------------------------------------------------------------------------------------------------------------------------------------------------------------------------------------------------------------------------------------------------------------------------------------
----------------------------------------------------------------------------------------------------------------------------------------------------------------------------------------------------------------------------------------------------------------------------------------
----------------------------------------------------------------------------------------------------------------------------------------------------------------------------------------------------------------------------------------------------------------------------------------
--------------------------------------------------------------------------------XXXX----------------------------------------------X--------------------------SSS--------------------?S----------------------SS------------------------------------------SSSS----------------------------
----------------XXX---------------------------------------------------------------------------------------------------------------X-----------------------------------------------------------------------------------------------------------------------------------------------------
----------------XXX--------------------------------------------------------------------------------------------------------------XX-----------------------------------------------------------------------------------------------------------------------------------------------------
----------------XXX----------------------------------------------------------------------------------------------S--------------XXX----------------------------------------SS---------------------E-------------------------------------------------------------------------------------
--------Q-X-----XXX---X--------------------X------------------------------------------------------------------------------------XXX-------------------------------------------------S------------<>-----------------------------------------SS--------------SSS---------------XX--------
-------------XX-XXX---X--------------------------------------------------------------------------------------------------------XXXXX-------------------------------------X-----------------------[]--------------------------------------------------------------------------XXX--------
------------XXXXXXX---X------------------EXX----------------------------------------------------------------------------------XXXXX--------X-----------------------------------------------------[]------------------------------------------------------------------------XXXXX-------X
EE-E--------XXXXXXX---X----------------E-XXX-------------------EE-E---------------------------E-------------------------------XXXXX--------X----------------------------XXX----------------------[]-------------------E--------X-------------------------------------------XXXXX-----XXX
XXXXXXXXXXXXXXXXXXXXXXXXXXXXXXXXX---XXXXXXXXXXXXXXXXXXXXXXXXXXXXXXXXXXXXXXX------XXXXXXXXXXXXXXXXXXXXXXXXXXXXXXXXXXXXXXXXXXXXXXXXXXX--XXX--XXXXXXXXXXXXX----XX-XXXXXXXXXXXXXXXXXXXXXXXXXXXX-XXXXXXXXXXXXXXXXXXXXXXXXXXXXXXXXXXXXXXXXXXXXXXXXXXXXXXXXXXXX-XXXXXXXXXXXXXXXXXXXXXXXXXXXXXXX
