----------------------------------------------------------------------------------------------------------------------------------------------------------------------------------------------------------------------------------------------------------------------------------------
----------------------------------------------------------------------------------------------------------------------------------------------------------------------------------------------------------------------------------------------------------------------------------------
----------------------------------------------------------------------------------------------------------------------------------------------------------------------------------------------------------------------------------------------------------------------------------------
----------------------------------------------------------------------------------------------------------------------------------------------------------------------------------------------------------------------------------------------------------------------------------------
----------------------------------------------------------------------------------------------------------------------------------------------------------------------------------------------------------------------------------------------------------------------------------------
------------------------------------------------------XX-----------------------------------------------------------------------------------------------------SSS---------XXX--------------------------SSSSSSSS---SSS------SSSSSS--------------------------------------------------------
-----------------------------------------------------------------------X----------------------------------------------------------------------------------------------------------------------------------------------------------------------------------------------------XXXX--------
----------------------------------------------------------------------XX----------------------------------------------------------------------------------------------------------------------------------------------------------------------------------------------------------------
---------------------------------------------------------------------XXX-------------------------------------------------------------------------------------------------------------------------------E------------------------------------------------------------------------------E-
---------------------------------------------------------------------XXX------------X---------------XXXX---------------------X-XX-----------SQQXX-------------XX--<>-----------------------------SSS--SSSSSSSS---------E-------------------------------------X------------------------SS
---------------XXX------------------------------------------------XXXXXX--------------------------XX------------------------XX------------------------------------[]---------------------------------------S----------<>------------------E---------------E--X--------------------------
---------------XXX-----------------------------------------------XXXXXXX----------------------------------------------------XX--------------------------------X---[]-------------------------------------X------------[]-----------------<>--------------<>-XXX-------------------------
---------------XXXX---------------------------------------------XXXXXXXX--------E------------------------------------------XXX-------E--E-------------------------[]-----------EE--------------E----------------------[]-----------------[]--------------[]-XX--------------------------
XXXXX--XXXXXXXXXXXXXXX--XXXXXXXXXXXXXXXXXXXXXXXXXXXXXXXXXXXXX-XXXXXXXXXXXXXXXXXXXXXXXX-------XXX----------------XXXXXXX-XXXXXXXXXXXXXXXXXXXXXXXXXXXX---XX--XXXXXXXXXXXXXXX--XXXXXXXXXXXXX----XXXXXXXXXXXXXXXXXXXXXXXXXXXXXXXXXXXXXXXXXXXXXXXXXXXX-------XXXX-----XXXXXX---XX------XXXXXX
