----------------------------------------------------------------------------------------------------------------------------------------------------------------------------------------------------------------------------------------------------------------------------------------
----------------------------------------------------------------------------------------------------------------------------------------------------------------------------------------------------------------------------------------------------------------------------------------
----------------------------------------------------------------------------------------------------------------------------------------------------------------------------------------------------------------------------------------------------------------------------------------
----------------------------------------------------------------------------------------------------------------------------------------------------------------------------------------------------------------------------------------------------------------------------------------
--------------------------------------------------------------------------------------------------------------------------XX------------------------------------------------------------------------------------------------------------------------------------------------------------
----------------------------------------?S------------------------------------------------------------------------------------------------XX--------------------------------------------------------------------------------------XX------------------------------------------------XXX-
----------------------------------------------XX----------------------------------------------------------------------------------------------------------------------------------------------------------------------------------------------------------------------------------------
---------------------------------------------------------------------------------------------------------------------------------------------------------------------------------------XX-----------------------------------------------------------------------------------------------
------------------------------------------------------XX--------------------------------------------------------------------------------------------------XX--------------------------XXXX----------------------------------------------------------------------------------------------
------------------------SSSS-X-------------------------------------------------------------------------------------------------Q------SSSS--------------XXXX-------------------------XXXX--------------------------------------------------------------------------------XXX------------
-----------------------------X------------------------------------------E-------------------------------------------------E---------------------------XXXXXX----------------------X-XXXXXX--------------------------E-----------------------X---------------------------XXXX------------
----------------------------XXX----------------------------------------<>------------------------------------------------<>--------------------------XXXXXXX----------------------XXXXXXXX-------------------------<>-----------------------X--------------------------XXXXX------------
-------EE-------------------XXX-----------------------------E------E---[]----------E------------EE-------E-E-------------[]-------------------------XXXXXXXX--------E--E---------XXXXXXXXX--------------E----------[]-------------------E---X----------E-EE-----------XXXXXX--------E---
-----XXXXXXXXXXXXXX---XXXXXXXXXXXXXXXXX---XXXXXXXXXXXX--XXXXXXXXX-XXXXXXXXXXXXXXXXXX-----X--XXXXXXXXXXXXXXXXXXXXXXXXXXXXXXXXXXXXXXXXX--XXXXXXXXXXX--XXXXXX---XXXXXXXXXXXXXXXXX--XXXXXXXXXXXXXX--XXXXXXXXXXXXXXXXXXXXXXXXXXXXXXXXXXXXXXXXXXXXXXXX--XXXXXXXXXXXXXXXX--XXXXXXX--XXXXXX-XXXX
