----------------------------------------------------------------------------------------------------------------------------------------------------------------------------------------------------------------------------------------------------------------------------------------
----------------------------------------------------------------------------------------------------------------------------------------------------------------------------------------------------------------------------------------------------------------------------------------
----------------------------------------------------------------------------------------------------------------------------------------------------------------------------------------------------------------------------------------------------------------------------------------
----------------------------------------------------------------------------------------------------------------------------------------------------------------------------------------------------------------------------------------------------------------------------------------
----------------------------------------------------------------------------------------------------------------------------------------------------------------------------------------------------------------------------------------------------------------------------------------
-SSS---SS--------------------X-X---------------------------------------------------------------------------XXX------------------XX------------------------------------------------------------------------------------------------------------------------------------------------------
-------------------------------------------------------------------------XXX---------------------------------------------------XXX---------------------------------------------------------------------------------------------------------------------------------------------X--------
------------------------------------------------------------------------------------------------------------------------------XXXX------------------------------------------------------------------------------------------------------------------------------------------------------
-----------------------------------------------------------------------------------------------------------------------------XXXXX----------------------------------------------------------------------------------------------------------------------------------------------------XE
--SSS----------------------------------------------------X-----------------------?SSX-------------XXXXX--------------------X-XXXXX-----------------------XXXXX----------X---------------XXXX-----------------------X---------------------------X-------------XX------------------------S
------------------X--------------------------------------X----------------------------------------------------------------XXXXXXXX-----------------------XX-XX------------------------XX---------------------------------------------------------------------XX-------------------------
------------------X-------------------------------------XXX--------------------------------------------------------------XXXXXXXXX----------------------XXXXX--------------------------------------------------------------------------------XXX------------XXXX------------------------
------------------X-------------------------------------XX-------------------------------------------------------E-E-----XXXXXXXXX---------X----------XXXXX---------E-------------------------------------------E--------------------------EEXXX----------E-XXXX------------------------
XXXXXXXXXXXXX--XXXXXXXXXXXXXXXXXXXXXXXXXXXXX--------XXXXXXXXXXXXXXX--XXXXXXXXXXXXXXXXXXXXX---XXXXXX----XXXX-XXXXXXXXXXXXXXXXXXXXXX-XXXXXX--XXXXXXXX--XXXXXX---XXXXXXXXXXXXXXXX---XXXXXX----XXXXXXXXXXXXXXXX--XXXXXXXXXXXXXXXXXXXXXXXXXXX-XXXXXX------XXXXXXXXXXXXXXXX-----XXXXXXXXXXXXXX
