----------------------------------------------------------------------------------------------------------------------------------------------------------------------------------------------------------------------------------------------------------------------------------------
----------------------------------------------------------------------------------------------------------------------------------------------------------------------------------------------------------------------------------------------------------------------------------------
----------------------------------------------------------------------------------------------------------------------------------------------------------------------------------------------------------------------------------------------------------------------------------------
----------------------------------------------------------------------------------------------------------------------------------------------------------------------------------------------------------------------------------------------------------------------------------------
----------------------------------------------------------------------------------------------------------------------------------------------------------------------------------------------------------------------------------------------------------------------------------------
------------?SS------------------------------SSS-------------------------------------------Q-----------------------------------E------------------------------------------------------------------XX-SSS--SSSSSS-------------------------------X------------------------------------XXXX
-------------------------------------------------------------------------------------------------------------------------------X------------------X-------------------------------------------------------------------------------------------XXX---------------------------------------
------------------------------------------------------------------------------------------------------------------------------XX-------------------------------------------------------------------------------------------------------------XXXX---------------------------------------
--------------------------XX-------------------------------------------------------------------------------------------------XXX-------------------------------------------------------------------------------------------E----------------XXXXXX--------------------------------------
-X-------------------------S--------------------------------------------E-----------------Q---QQQ--?Q-----------------------XXXX---------------------------XXX------------------------QQ-------SSS-------SSSSSS-----------<>---------------XXXXXX-----------------------------------S---
-X---------------------------------------------------------------------<>----------E--------------------------------------XXXXXX------------------------------------------------------------------------------------------[]--------------XXXXXXX---------------------------------------
XX---------------------------------------------------------------------[]---------<>-------------------------X-----------XXXXXXX------------------------------------------------------------------------------------------[]-------------XXXXXXXX---------------------------------------
XXX----E-----------------------------------------------------------E---[]---------[]-------------------------X----------XXXXXXXX--------E--E-------------E-----------------------E------------------------------------E---[]-----E-E----XXXXXXXXXX------E--E----------------------------
---XXXXXXXX-XXXXXXXXXXXXXXXXXXXX--XXXXXX----XXXXXXXXXXXXXXXXXXXXXXXXXXXXXXX----X-XXXXXXXXXXXXXXXXXXXXXXXXXXXXXXXXXXXXXXXXXXXXXXXXXXXXXXXXXXX-----X------XXX-----XXXXXXXXXXXXXXXXXXXXXXXXXXXXXXXXXXXXXXXXXXXXXXXXXXXXXXX-XXXXXXXXXXXXXXXXXXXXXXXXXXXXXXXXXXXXX-XXXXXXXXXXXXXXXXXXXXXXXXXX
