------------------------------------------------------------------------------------------------------------------------------------------------------------------------X---------------------------------------------------------------------------------------------------------------
----------------------------------------------------------------------------------------------------------------------------------------------------------------------------------------------S----S------------------------------------------------------------------------------------
------------------------------------------------------------------------------------------------------------------------------------------------------------------------SSSSSSSSSSSSSSSSSSSSSSSSSSSS--SSSSSSSSSSSSSSSSSSSSSSSSSS--------------------------------------------------------
------------------------------------------------------------------------------------------------------------------------------------------------------------------------SSSSSSSSSSSSSSSS----SSSSSSSS--S----SS---------------------------------------------------------------------------
------------------------------------------------------------------------------------------------------------------------------------------------------------------------SSSSSSSSSSSSSSSS----SSSSSSSS-------SSS--------------------------------------------------------------------------
--S-----------------------------------------XS---------------------------------------------Q--QQ----------------------------------SS------------------------------------SSSSSSSSSSS--SSS----------SS-SSSSSSSSS---SSS-------SS---SSS-------------------SSS-------------------------------
-------------------------------------------XX-------------------------------------------------------------------------------------------------------------------------------------------------------------------------------------------------------------------------------------------
------------------------------------------XXX-------------------------------------------------------------------------------------------------------------------------------------------------------------------------------------------------------------------------------------------
----------------------------------------XXXXXX--------------------------E------------------------------------------X-----------------------------------------------------?--?------------------??------E--------------------------------------------------------------------------------
-QQQ-----------------------------------XXXXXX----------------Q---------<>-----------------Q---QQQ--QQ-----------------------XX------------------------------------------SSSSSSSSSSS--------E------XX-SSSSS-SSS---------E--------SSSQS-------------XX------------------------------------
------------------X------------------XXXXXXXX----X---------------------[]-----------------------------------------------------------------------------E-----------------XSSSSSSSSSS-------<>-----------SS--SSS--------<>---------------E----------XX------------------------------------
------------------X------------------X-XXXXXX----X---------------------[]----------------------------------------------------------------X-----------<>-----------------SSSSSSSSSSS-------[]-------X---SS-SSS---------[]--------------<>--------XXXX------------------------------------
---------------X--X---------EE-EE----X-XXXXXX----X----------E----------[]---------X------------------------------------------------------------------[]--------------EE-SSSSSSSSSSS-------[]-----XXX------SS----------[]--------------[]-------XX-XX--------------------E----------E-E--
XXXX--XXXXXXX--XX-----------XXXXXXXXXXXXXXXXXXXXXXXXXXXXXXXXXXXXXXXXXXXXXXXX--XXXXXXXXXXXXXXXXXXXXXXXXX------XXX------XXXX------XXXXXXXXXXX-XXXXXXXXXXXXXXXXXXX-XXXXXXXXXXXXXXXXXXXXXXXXXXXXXXXXXXXXXXXXXXXXXXXXXXXXXXXXXXXXXXXXXXXXXXXXXXXXX--XXXX-------XXXXXXXXX-XXXXXX-----XXXXXXXXX
