----------------------------------------------------------------------------------------------------------------------------------------------------------------------------------------------------------------------------------------------------------------------------------------
----------------------------------------------------------------------------------------------------------------------------------------------------------------------------------------------------------------------------------------------------------------------------------------
------------------------------SSSSSSSSSS--------------------------------------------SSSSSSSSSSSSSSSSSSSSSSSSSSSS------------------------------------------------------------------------------------SSSSSSSSSSSSSSSSSSSSSSSSSSSS--------------------------------------------------------
------------------------------S---SSSSS-------------------------------------------------------------------------------------------------------------------------------------------------------------SSSSSSSSSSSSSSS------SS---SS--------------------------------------------------------
-----------------------------------SSSS-------------------------------------------------------------------------------------------------------------------------------------------------------------SSSSSSSSSSSSSSS-----SSSS--SS--------------------------------------------------------
--------SSS------------------SSSSSSSSSS---SS------------X-------QQSSSSS-----------------------------------------------------------------------------------------------------------------------S-SSS--SSSSSSSSSS--SSS---------------S-------------------SSSS-----------------------------
----------------------------------------------------------------------------------------------------------------------------------------------------------------------------------------------------------------------------------------------------------------------------------------
--------------------------------------------------------E------------------------------------------------------------------------------------------------------------------------------------------------------------------E------------------------------------------------------------
-----------------------E---------------------------E----XXX------------------------------------------------------------------------------------------------X---------------X----------------------------E-----------------<>------------------------------------------------------------
-----SS--QS-----------<>-------SSSSSSSS--------E--<>-----------S?S-SSSSS---------X--SSSS----SQS--------------------------------X----------------------------------------------------XX---------------SSSSSSSSSS--------E--[]----S?SSS-----------------------------S---------------------
----------------------[]------E-----SS--------<>--[]-----------------------------XXX-----------------X-XX------------------------------------------------XXX-----------------------------------------SSSSSSSSSS-------<>--[]----------------------X--------------------------------E----
----------------------[]------SS-----S--------[]--[]-----------------------------XX-----------------<>-XX--------------------XXX-----------------------XXXXX-----------------------------------------SSSSSSSSSS-------[]--[]----------------------X-------------------------------<>----
------------------E---[]-------------S--------[]--[]-----------------------EE----XX-E-----E-------X-[]-XX------------------EEXXX----------------------XXXXXX--------E--E-----------------------------SSSSSSSSSS-------[]--[]----------------------X---------------------------E---[]----
XXXXXXXXXXXXXXXXXXX-XXXXXXXXXXXXXXXXXXXXXXXXXXXXXXXXXXXX--XXXXXXX---XXXXXXXXXXXXXXX-XXXXXXXXXXXXXXXXXXXX---XXXXXXXXXX--XXXXXXXXXXXXX--------XXXXXXXXXXXXXXXXXXXXXXXXXXXXXXXXXXXXXXXXXXXXXXXXXXXXXXXXXXXXXXXXXXXXXXXXXXXXXXXXXXXXXXXXXXXXXXXXXXXXXXXXXXXXXXXXXXXXXXXXXXXXXXXXXXXXXXXXXXXX
