----------------------------------------------------------------------------------------------------------------------------------------------------------------------------------------------------------------------------------------------------------------------------------------
----------------------------------------------------------------------------------------------------------------------------------------------------------------------------------------------------------------------------------------------------------------------------------------
----------------------------------------------------------------------------------------------------------------------------------------------------------------------------------------------------------------------------------------------------------------------------------------
----------------------------------------------------------------------------------------------------------------------------------------------------------------------------------------------------------------------------------------------------------------------------------------
----------------------------------------------------------------------------------------------------------------------------------------------------------------------------------------------------------------------------------------------------------------XXX---------------------
----------------------------Q------------------------------------------------------------------------------------------------------S----SS---------------------------------------QSS-S-----X---------------------------------XXX------------------------------------------------SSSSSS--
----------------------------------------------------------------------------------------------------------------------------------------------------------------------------------------------------------------------------------------------------------------------------------------
----------------------------------------------------------------------------------------------------------------------------------------------------------------------------------------------------------------------------------------------------------------------------------------
--------------------------------------------------------------------------------------------------------------E----X-----------------------------------------------------XXXXX--------------------E-------------------------------------------------------------------------------------
--------------XXXX-----------------------XXXXX--------------------------X------------X-----------------------QQ---XXX---------------------------------------------------------------SS-----------<>-----------------------SSS------------------XX-----------XXXXX-------------XXXX------
-----------------------------------------------------------------------XX----------E-X-----------------------------------------------------------------------------------------------------------[]-----------------E-------------------------EXXX-----------------------XXX------------
-----------------------------------------------------------------------XX---------<>-X-----------------------------------------------------------------------------------------------------------[]----------------<>-------------------------XXXXX-------------------------------------
-----------------------------------------------------------E-------E-XXXX---------[]XXX-----------------------------------------------------------------E----------------------------------------[]------E----E----[]-----E-------------------XXXXX-------XX---------------X------------
X----X-----XX--------XXXXXXXXX--X----XXXX---------------XXXXX-XXXXXXXXXXXX----XX--XXXXXXXXXXXXXX--XXXXXXXXXXXXXXXXX---XXX------XXXXXXXXXXX--XXXXXXXXXXXXXXXX-----XX-XXXXXXXXXXXXX-------XXXXXXXXXXX-XXXXXXXXXXXXXXXXXXXXXXXXXXXXXXXXXXXX--XXXXXXXXX--------X---------XX--------X-------X
