X---------------------------------------------------------------------------------------------------------------------------------------------------------------------------------------------------------------------------------------------------------------------------------------
----------------------S-----------------------------------------------------------------------------------------------------------------------------------------------------------------------------------------------------------------------------------------------------------------
SSSSSSSSSSSSSSSSSSSSSSSSSSSS------------------------------------------------------------------------------------------------------------------------------------------------------------------------------------------------------------------------------------------------------------
SSSSSSSSSSSSSSSS----SSSSSSSS------------------------------------------------------------------------------------------------------------------------------------------------------------------------------------------------------------------------------------------------------------
SSSSSSSSSSSSSSSS----SSSSSSSS------------------------------------------------------------------------------------------------------------------------------------------------------XX----------------------------------------------------------------------------------------------------
SSSSSSSSSSSS-SSS--------S-SS--------------------------S------------------------------XXX----------------------------------------------XXXX-------------------------------------------------------------------------------------------------------X------------------------------------XX
SS-S-------------------------------------------------------------------------------------------------------------------------------------------------------------------------------------------------------------------------------------------XXX--------------------------------------
----------S-----------------------------------------------------------------------------------------------------------------------------------------------------------------------------------------------------------------------------------XXXX--------------------------------------
----E-----S------------??-------------------------------------------------------------------------------------------------------------------------SSS----------------------------------------------------------------------------------------XXXXX--------------------------------------
-SSSSSSSSSSS-------E------XX----------------E-----------XQQQ--------------XX--------------------------------------Q--------------------------------------QQQ---------------------------Q---------------------------<>------------------------XXXXX---------E----------------------SSSSSS
-SSSSSSSSSS-------<>-----------------------<>------------------E-----XXXX-XX---------------------------------------------------X------------------------------------------------------------------E----------------[]---------------------X-XXXXXX--------<>----------------------------
SSSSSSSSSSS-------[]-----------------------[]-----------------<>-----------X---------------------------------------------------------------------------------------------------------------------<>----------------[]--------------------XXXXXXXXX--------[]----------------------------
SSSSSSSSSSS-------[]X----------------------[]-E---------------[]-------X----------------------E-E----------------------------------------------------E---------------------------E---------------[]----------------[]--------------E-----XXXXXXXXX--------[]-------E-EE-----------------
XXXXXXXXXXXXXXXXXXXXXXXXXXXXXXXXXXXXXXXXXXXXXXXXXXXXXXXXXXXXXXXXXXXX----------------XXXXXXXXXXXXXXXXXXXXXXXXXXXXXXXX----XXXXXXXXXXXXXXX-XXXXXXXXXXXXXXXXXXXXXXX------X--XXXXXXXXXXXXXXXXXXXXXXXXXXXXXXXXXXXXXXXXXXXXXXXX---XXXXXXXXXXXXXXXXXXXXXXXX--XXXX-XXX-XXXXXXXXXXXXXXXXXXXXXXXXXX
