----------------------------------------------------------------------------------------------------------------------------------------------------------------------------------------------------------------------------------------------------------------------------------------
----------------------------------------------------------------------------------------------------------------------------------------------------------------------------------------------------------------------------------------------------------------------------------------
--------------------------------------------------------------------------------------------------------------------------------------------SSSSSSSSSSSSSSSSSSSSSSSSSSSS----------------------------------------------------------------------------------------------------------------
--------------------------------------------------------------------------------------------------------------------------------------------SSS----SSSS---------------------------------------------------------------------------------------------------------------------------------
---------------------------------------------------------------------------------------------------------------------------------------------------SSSS------------------------------------------------------XXX------------------------------------------------------------------------
-----------?SSS-----XXX------------------------------------------------------------------------------------------------------------------------S---SSSS---------------S----SSSSSSSSSS-SS-----------------------------------------------QQ-QQQQ--------------------------------XX--------
--------------------------------------------X-------------------------------------------------------------------------------------------------------------------------------------------------------------------------------------------------------------------------------------------
------------------------------------------------------------------------------------------------------------------------------------------------------S---------------------------------------------------------------------------------------------------------------------------------
-XXXXX--------------------XX--------------------------------------------------------------------------------------------------------------------E-----E------------SS--------------------------E--------------------------------------------------------------XXXX----------------------
------------SS--------------------------------------S-SQ-----------------------------------------------------SS--------------------------------SSS-SSSSS--------E-----------SSSSSSSS----------<>-----------------------------S--------QS?-QSSQQQ---------<>-------------XXX----------X--
-X----------------------X--S----------------------------------------------------------------------------------------------E-----------------SSSSSS--SSS--------<>------X----------------------[]--------------E------------------------------------------[]--------------------------XX-
-------------------------------------------------------------------------------------------------------------------------<>-----------------SSSSSSSSSSS--------[]-----------------------------[]-X-----------<>------------------------------------------[]--------------------------X--
XX----------------------------------E----E---------E---------------------------------------E-EE--------------------------[]--------------EE-SSSSSSSSSSS--------[]---------------------------E-[]-X-------E---[]--------------EE--------------------E-----[]-----------------------------
------XX-XX----------------------XXXXXXXXXXXXX--XXXXXXXX-----XXXXX--XXXXXXXXXXXXXXXXXXXXXXXXXXXXXXXXXXXXXXXXXXXXXXXXXXXXXXXXXXXXXX----XXXXXXXXXXXXXXXXXXXXXXXXXXXXXXXXXXXXXXXXXXXXXXXXXXXXX-XXXXXXXXXXXXXXXXXXXXXXXXXXX---XXXXXXXXXXXXXXX--XXXXXXXXXXXXXXXXX-----XXX-------XXXXXXXXXXXX-
