----------------------------------------------------------------------------------------------------------------------------------------------------------------------------------------------------------------------------------------------------------------------------------------
----------------------------------------------------------------------------------------------------------------------------------------------------------------------------------------------------------------------------------------------------------------------------------------
----------------------------------------------------------------------------------------------------------------------------------------------------------------------------------------------------------------------------------------------------------------------------------------
----------------------------------------------------------------------------------------------------------------------------------------------------------------------------------------------------------------------------------------------------------------------------------------
---------------------------------------------------------------------------------------------------------------------------------------------------------------------------------------------------------------------------------------------------------------------XXX----------------
-----------?SS------------------------------------------SSS--------------------SS-------------SSSS--------------------------------------------------------------------XX----------------------------------------------------------------------------------------------------------------
---------------------------------------------------------------------------------------------------------------------------------------------------------------------------------------------------------------------X------------------------------------------------------------------
--------------------------------------------------------------------------------------------------------------------------------------------------------------------------------------------------------------------XX------------------------------------------------------------------
-XSSSSSSS-----------------E---------------------------------------------------------XXXXXX--------------------E----------------------------------------------------------------------------------------------------XXX-------------------------X----------------------------------------
-----------SSSSS---------<>----------------------------------------------------------------S?--SSSS----------<>--------------------------------------------------SSSSSS-X-----------------X-----------------------XXXX------------------------XX---------------------------Q----------E-
-------------------------[]--------------------------------------------X--X----------------------------------[]------E----------E-----------------------------------------------------XXXX-----------------------XXXXX----------------------XXXX-------------------------------------<>-
-------------------------[]-----------------------------------------------X----------------------------------[]-----<>---------<>-------------------------------------------------------------------------------XXXXXXX--------------------XXXXX-------------------------------------[]-
-------------------E-----[]----------------E---------------------------X--X----------------------------E-----[]-----[]-----E---[]----------E-------E--E-------------------------------------------------------XXXXXXXXX------------------XXXXXXX--------E--E---------E---------------[]-
XXXXXXXXXXXXXXXXXXXXXXXXXXXXXXXXXXXXX-XXXXXXXXXXXXXXXXXXXXXX---XXXXXXXXXXXXX-----X-X--XXXXXXX---XXXXXXXXXXXXXXX-XXXXXXXXXXXXXXXXXXXXX-XXXXXXXXXXXXXXXXXXXXXXXXXXXXXXXXXXXX--XX----XX----------------XXXXX---XXXXXXXX-XXXXX-XXXXXXXXXXXXXXXXXXXXXXXXXXXXXXXXXXXXXXXXXXXXXXXXXXXX-XXXXXXXX
