----------------------------------------------------------------------------------------------------------------------------------------------------------------------------------------------------------------------------------------------------------------------------------------
----------------------------------------------------------------------------------------------------------------------------------------------------------------------------------------------------------------------------------------------------------------------------------------
------------------------------------------------------------------------------------------------------------------------------SSSSSS--SSSS----------------------------------------------------------------------------------------------------------------------------------------------
----------------------------------------------------------------------------------------------------------------------------------------------------------------------------------------------------------------------------------------------------------------------------------------
----------------------------------------------------------------------------------------------------------------------------------------------------------------------------------------------------------------------------------------------------------------------------------------
------------------XSSSS---------------------------SSSXX----------------------------------------?SSS-------------S---------------------SSS-------------------------------------------------S-------------------QQQQQ---------SSSS--X-----------------------------------------------------
----------------------------------------------------------------------------------------------------------------------------------------------------------------------------------------------------------------------------------------------------------------------------------------
----------------------------------------------------------------------------------------------------------------------------------------------------------------------------------------------------------------------------------------------------------------------------------------
X-XXXX-------------------------------------------------------------------------------XSSSSSSS-----------------E------------------------SS-----------------------------------------------------------------------------------------------------------------------------------------------
------------XXX--------------------------------------------------------------------------------SSSSS---------<>-SQQQ--------------XXX----------------------X------------QQQ---------------XX--------------Q---QQQQQQQQ------------------------------------------------------------------
------------------------XXXX---------------XXX---------------------------------------------------------------[]--------E---------XXXX----------------------X--------------------------XXX-----------------------------------------------------------------E-----------------------------
-------------------------------------------XXXX--------------------------------------------------------------[]-------<>--------XXXXX--------------------XXX---------------------------------------------------------------------------------------------<>-------------X---------------
-------------------------------------------XXXX--------------------------------------------------------------[]-------[]-------XXXXXX-----------------XXXXXX----------------------------------------------------------------------------E---E------------[]---------E-XXX-----------EE-E
------XXX-------XXXXXXXX----XXXXX--XXXXXXXXXXXXXXX---XXXXXXX---XXXXXX-XXXXXXXXXXXXXX---XXXXXX---XXXXXXXXXXXXXXXXXXXXXXXXXXXXXXXXXXXXX---XXXXXXXXX--XXXXXXXXXXXXXXX--XXXXXXXXXXX---XXXXXXXXXXXXXXXXXXXXXXXXXXXXXXXXXXXXX---------XXXXXXXXX-XXXXXXXXXXXXXXXXXXXXXXXXXXXXXXXXXXXXXXXXXXXXXX
