----------------------------------------------------------------------------------------------------------------------------------------------------------------------------------------------------------------------------------------------------------------------------------------
----------------------------------------------------------------------------------------------------------------------------------------------------------------------------------------------------------------------------------------------------------------------------------------
----------------------------------------------------------------------------------------------------------------------------------------------------------------------------------------------------------------------------------------------------------------------------------------
----------------------------------------------------------------------------------------------------------------------------------------------------------------------------------------------------------------------------------------------------------------------------------------
----------------------------------------------------------------------------------------------------------------------------------------------------------------------------------------------------------------------------------------------------------------------------------------
----------------------XXXX-------SSSSSSSS-----------SSSS--------------------------------------------------------------------------------------------------------------------------------------SSS---------------------------------------------------------------------------------------
----------------------------------------------------------------------------------------------------------------------------------------------------------------------------------------------------------------------------------------------------------------------------------------
----------------------------------------------------------------------XX-----------------------------------------------------------------------------------X---------------------------------------------------------------------------------------------------------------X------------
---------------------------------------------------------------------XXXX----------------------------------------------------------------------------------X--------------------------------------------------------------------------------------------------------------XX------------
X--------------XXXXXXX-----------SSSSSSS-----------------------------XXX------------SQQQ--------------XXX------------E----------E---------------------------------------Q-Q---------------XX-----------------------X-----------------------------------------------------XXX------------
------------------------------------------------------------------XXXXXXX------------------E---------XXXX-----------<>---------<>---E----------------------X--------------------------XXX-------------------------------------------------------E-----------------------XXXXX-----------
-----------------------------------------------------------------XXXXXXXX-----------------<>--------XXXXX-----------[]---------[]--<>----------------------X-----------------------------------------------------------------------------------<>---------------------XXXXXXX-----------
----------------------------------------------EE----------------XXXXXXXXXX------E---------[]-------XXXXXX------X----[]---------[]--[]--------E--------EE--EX-----------------------------------------------------------------------------E-----[]---------------------XXXXXXXX------E--E
-----------XXXX---XXXXXXXXXXXXXXXXXXXXXXXXXXXXXXXXXXXXXXXXXXXXXXXXXXXXXXXXXXXXXXXXXXXXXXXXXXXXXXXXXXXXXXXXXXXXXX-XXXXXXXXXXXXXXXXXXXXX-XXXXXXXXXXXXXXXXXXXXXXXXXXXXXXXXXXXXXXX-XXXXXX---------------XXXXXX--XXXXXXXX---XXXXXXXXXXXXXXXXXXXXXXXXXXXXXXXXXXXXXXXXXX---XXXXXXXXXXXXXXXXX-XX
