----------------------------------------------------------------------------------------------------------------------------------------------------------------------------------------------------------------------------------------------------------------------------------------
----------------------------------------------------------------------------------------------------------------------------------------------------------------------------------------------------------------------------------------------------------------------------------------
----------------------------------------------------------------------------------------------------------------------------------------------------------------------------------------------------------------------------------------------------------------------------------------
----------------------------------------------------------------------------------------------------------------------------------------------------------------------------------------------------------------------------------------------------------------------------------------
----------------------------------------------------------------------------------------------------------------------------------------------------------------------------------------------------------------------------------------------------------------------------------------
-------------------XXXXSSS---------------S--------------------------------------------------QQQQQQQ---------SSSS-----SSSSSSSS------------------------------------------------------?SSS-----------------------------------------SSSSS--SS--------------SSS---------------------------XXX
----------------------------------------------------------------------------------------------------------------------------------------------------------------------------------------------------------------------------------------------------------------------------------------
-----------------------------------------------------------------------------------------------------------------------------------------------------------X----------------------------------------------------------------------------------------------------------------------------
--XXXX------------------------SSS------------------------------------------------------------------------------------------------------E------------------XX------------XXXXXX--------------------XX------------------------------------------------------------------------------------
------------XXX-------------------------SS-----------------------------------------S-------S?-QSSSQQ-----------------SSSSSSS----------<>------------------XXX-------------------?---SSS----------X-----------------X--------------SSS--------------------------------------Q-------SS---
------------------------------------------------------------------------------------------------------------------?-------------------[]-----------------XXXX-----------------------------------XXXX---------------X------------------------------X-------------------------------------
---------------------------------------------------------XX------------------------------------------------------SS-------------------[]---------------XXXXXX-----------------------------------------------------XX----------------------------X-X-------------------------------------
---------------------------------------------------------------------E---------E-----------------------E--------------------------E---[]-------E------XXXXXXX--------------------------------------------------E--XX------------------------------X------------------E------------------
------XXXXX-----XXXXXXXX----XXXXXXXXX---XXXXXXXXXXXXXX--XX---XXXXX--XXXX----XXXXXXXXXXXXXXXXXXXXXXXXXXXXXXXXXX--XXXXXXXXXXXXXXXXXXXXXXXXXXXXXXXXX--XXXXXXXXXXXXXXX--XXXX----XXXX-----XXXXXXXXXXXXX--XXXXXXXXXXXXXXXXXXXXXX--XXXXXXXX--XXXXXXXXXXXXXXX----XXXXXXXXXXXXXXXXXXXXXXXXXXXXXXX
