----------------------------------------------------------------------------------------------------------------------------------------------------------------------------------------------------------------------------------------------------------------------------------------
----------------------------------------------------------------------------------------------------------------------------------------------------------------------------------------------------------------------------------------------------------------------------------------
----------------------------------------------------------------------------------------------------------------SSSSSSSSSSSSSSSSSSSSSSSSSS---------------------SSSSSSSSS---SSSSSSSSS--SS----SS------------------------------------------------------------------------------------------
--------------------------------------------------------------------------------------------------------------------------------------------------------------------------SSSSSSSSSSSSSS----S------S------------------------------------------------------------------------------------
---------------------------------------------------------------------------------------------------------------------------------------------------------------------------SSSSSSS----SS-----S----SS------------------------------------------------------------------------------------
----------------------SSSS------------------------------------------------------------------------------------------------------X---------------------------------------S-SSSSSSSSS--SSS----S--------SSSSSSSSSS--SSS--------SSSS------SSSSSS----------------SS--------------------------
--------------------------------------------------------------------------------------------------------------------------------X-------------------------------------------------------------------------------------------------------------------------------------------------------
--------------------------------------------------------------------------------------------------------------------------------XX------------------------------------------------------------------------------------------------------------------------------------------------------
--------------------------------------------------------------------------------------------------------------------------------XX-S------------------E---------------------E------------------E--?----------------------------------------------------E---------------------X----------
QQQQ--------------XXXX------------------XX------------------------------X-------------------------------------S-<>---------XXX--X-----X--------------<>--------------------?SSSSSS---------E--<>-------SSSSSSS--------------------E--SS--SSS----------<>------------Q-------XX----------
-------E-----XXX-XXXX------------------XXX-----------------------------XX----------E----------------------------[]-------X--XXX-X----XX----E---------[]---------E-----------SSSS----------<>--[]---------------------------------<>-------------------[]--------------------XX---------E
------<>---------XXXX-----------------XXXX----------------------------XXX---------<>----------------------------[]-------X--XXXXXX---XX---<>---------[]--------<>----------SSSS-----------[]--[]----------------------<>---------[]-------------------[]------------------XXXXX-------XX
------[]-------XXXXX----------------XXXXXX-E------E-E----E-E-------E-XXXX---------[]-------E--------------------[]--E-------XXXXXX---XX---[]---------[]--------[]-------------------------[]E-[]----------------------[]E--------[]---------------E---[]------------------XXXXX-------XX
XXXXXXXXXXXXX--XXXXXXX----XXXXXXXXXXXXXXXXXXXXXXXXXXXXXXXXXXXXXXXXXXXXXXXXXXXXXXXXXXXXXXXXXXXXXX-XXXXXXXXXXXXXXXXXXXXXXXXXXX---XX---XXXXXXXXXXXXXXXXXXXXXXXXXXXXXXXXXXXXXXXXXXXXX-XXXX-XXXXXXXXXXXXXXXXXXXXXXXXXXXXXXXXXXXXXXXXXXXXXXXXXXXXXXXXXXXXXXXXXXXXXXXXXXXXX-XXXXXXXXX----XXXXXX
