----------------------------------------------------------------------------------------------------------------------------------------------------------------------------------------------------------------------------------------------------------------------------------------
----------------------------------------------------------------------------------------------------------------------------------------------------------------------------------------------------------------------------------------------------------------------------------------
----------------------------------------------------------------------------------------------------------------------------------------------------------------------------------------------------------------------------------------------------------------------------------------
----------------------------------------------------------------------------------------------------------------------------------------------------------------------------------------------------------------------------------------------------------------------------------------
-----------------------------------------------------------------------------------------------------------------------------------------------------------------------------------------------------------------------------------------XXX--------------------------------------------
?-SS-------------SSS-----------------------------------X----------------S----------------------------------XXX------------------------SSS------S----------------------------------------------------------------------------XXXX--------------------------------------------------------
----------------------------------------------------------------------------------------------------------------------------------------------------------------------------------------------------------------------------------------------------------------------------------------
------------------------------------------------------------------------X---------------------------------------------------------------------------------------------------------------------------------------------------------------------------------------------------------------
--EX-------------------------------------------------------------------XX-------------------------------------------------------------------------------------------------------------------------------------------------------------S-------------------------------------------------
--XXX--------XX----------XX----------------Q-------S-----E-------------XX--------------------------XXXXSSS------XQQQ--------------EXXX------------------------------------------------QQ----------E----------------------S-SS-----------------QQ----------E--------------------------SS-
-------E----X------------XX-----------------------------<>-------X----XXX----X-----------------------------------------------XXXXXXXX------------------------------------------------------------<>------------------------------------------------------<>-----------E-----------------
-------X--------X--------XX-----------------------------[]------------XXX----X-----------------------------------------------------X--------------------------X----------------------------------[]------------------------------------------------------[]----------<>-----------------
--------------------XXX--XX----------E------------------[]-EE------E-XXXX----X--------------------------------------------------------------------------------X------------------E---------------[]--------------------------------------E---------------[]--------E-[]-----------------
X-----XX-----------------XX-XXXXXXXXXXXXXXXXXXXXXXXXXXXXXXXXXXXXXXXXXXXXXXXX---XXXXXXXX-----XX--XXXXXXXXXXXXXXXXXXX-XX--XXXXX-------------XXXXXXXXXXXXXXXXXXXXXXXXXXXXXXXXXXXXXXXXXXXXXXXXX--XXXXXXXXXXXXXXXXXXXXXXXXXXXXXXXXXXXXXXXXXXXXXXXXXXXXXX-XXXXXXXX--XXXXXXXXXXXXXXXXX---XXXXXX
