----------------------------------------------------------------------------------------------------------------------------------------------------------------------------------------------------------------------------------------------------------------------------------------
----------------------------------------------------------------------------------------------------------------------------------------------------------------------------------------------------------------------------------------------------------------------------------------
----------------------------------------------------------------------------------------------------------------------------------------------------------------------------------------------------------------------------------------------------------------------------------------
-------------------------------------------------------------------------------------------------------------------------------------------------------------------------------------------------------------E--------------------------------------------------------------------------
-------------------------------------------------------------------------------------------------------------------------------------------------------------------------------------------------------------XXX------------------------------------------------------------------------
-------------------------------------------------------------------------SSS--------SSS--------------------S----------------------X----------XX---------------------------------SSS------------------------------QQ---------------------------------------------------------------------
---------------------------------------------------------------------------------------------------------------------------------XX-----------------------------------------------------------------------------------------------------------------------------------------------------
---------------------------------------------------------------------------------------------------------------------------------XX-----------------------------------------------------------------------------------------------------------------------------------------------------
-----------------------------------------------------------------------------------------------------------------S--------------XXX----------------------------------------------------------------------SSSS---------------------------------------------------------------------------
-----------------S---------------------------------------XXXX-------------XX--------SSSQ?-------------XX--------X-------------XXXXX-------------------------------------------------SS-------------------------QQQQQ-----------------------QQ-----------------------------XXX-----------
-------------------------------------------------------------------------------------------E----X-----XX---------------------XXXXXX---------------------------------------------------------------------------------------------------------------------------------------XXXX----------
-----------------------------XX-----------------------------------------------------------<>----------XX---------------------XXXXXX--------------------------------------------------------------XX------------------------------------------------------<>--------------XX-X-----------
------------------------------------------------------------------------------------------[]-------XX-XX---------------------XXXXXX--------------------------------------------------------------X-----------E-------------------------------------------[]-----------------------------
XXXXXXXXXX----XXXXXXXXXXXXXXXXX----XX----XXXXXXXXXXXXXXXXXXX-XXX---XXXXXXXXXXXXXXXXXXXXX-XXXXXXXX--XXX------XXXXXXXXXXX--XXXXXXXXXXXXXX-XXXXXXXXXXXXXXXXXXXXXX------XXXXXXXXXXXXXX-XXXXXXXXXXXXXXXXXXXXXXXXXXXXXXXXXXXXXX-XXXXXXXXXXXXXXXXXXXXXXX--------XXXXXXXX---XXXXX---------------
