----------------------------------------------------------------------------------------------------------------------------------------------------------------------------------------------------------------------------------------------------------------------------------------
----------------------------------------------------------------------------------------------------------------------------------------------------------------------------------------------------------------------------------------------------------------------------------------
----------------------------------------------------------------------------------------------------------------SSSSSSSSSSSSSSSSSSSSSSSSSSSS--------------------------------------------------------------------------------------------------------------------------------------------
----------------------------------------------------------------------------------------------------------------------------------------------------------------------------------------------------------------------------------------------------------------------------------------
----------------------------------------------------------------------------------------------------------------------------------------------------------------------------------------------------------------------------------------------------------------------------------------
------------------X---------Q------------------------------------------------------------------------------------SS-----S--------------------------------------------------------------------------------------------------XXX-----------------------------------------------------XXXXX
-----------------XX------------XX---------------------------------------------------------------------------------------------------------------------------------------------------------------------------------------------------------------XXXX------------------------------------
----------------XXX---------------------------------------------------------------------------------------------------------------------------------------------------------------------------------------------------------------------------------------------------------------------
---------------XXXX---------------------------------------------------------------------------------------------------------------------------------------------------------------------------------------------------------------------------------------------------------------------
--------------XXXXX---------X------------XXXXXX---------SQQQ--------------XX----------------------XXXX----------SSSSS---SQS--------------------------------X-------------------------------------------------------XX------------------------------------SSS----------------------------
-------------XXXXXX---------X-----------XXX-------------------------------XX-------------------------------------------------------XX----------------------------------------E----------E--------------------------X-------------X------------------------------------------------------
-------------XXXXXX--------------------XXX--------------------------------XX----------------------------------------------------<>-XX--------------------X------------------<>---E-----<>---------------------------------------XXX-----------------------------------------------------
----------XXXXXXXXX-------------------XXXX-------E--E------------------XX-XX------------------------------------------E---------[]-XX------------------EEX----------E-------[]---E-----[]---------------------------------------XX------E-----------------------------------------------
XXXXXXXXXXXXXXXXXXXX-------XXXXXXX---XXXXX----XXXXXXXXXXXXXXXXXXXXXXXXXXXXXXXXX-XXXXX---XX---XXXXX-------XXXXXXXXXXXXXXXXXXXXXXXXXXXXXXXXXXXXXXXXXX-XXXXXXXXXXXXXXXXXXXXXXXXXXXXXXXXXXXXXXXXXXXXXXXXXXXXX----XXXX---------------XX-XXXXXXXX-XXXXXXXXXXXXXXXXXXXXX--XXXXXXXXXXXXXXXXXXXXX
