----------------------------------------------------------------------------------------------------------------------------------------------------------------------------------------------------------------------------------------------------------------------------------------
----------------------------------------------------------------------------------------------------------------------------------------------------------------------------------------------------------------------------------------------------------------------------------------
--------------------------------------------------------SSSSSSSSSSSSSSSSSSSSSSSSSSSS--------------------------------------------------------------------------------------SSSSSSSSSSSSSSSSS-SSSSSSSS----------------------------S-SSSSSSSSSSSSSSSSSSSSSSSSS-----------------------------
--------------------------------------------------------------------------------------------------------------------------------------------------------------------------SSSSSSSSSS--------------SS------------------------------------------------------------------------------------
---------------------------------------------------------------------------------------------------------------------------------------------------------------------------SSSSSSSS---------------SS------------------------------------------------------------------------------------
------------------------------------------------------------------------------------------------------------------------------------------------------------------------SSSSSSSSSSS--SSS----------SS-----------------------------SSS---SSS-----------------------------------------XXXX-
-------------------------------------------X--------------------------------------------------------------------------------------------------------------------------------------------------------------------------------------------------------------------------------------------
------------------------------------------XX--------------------------------------------------------------------------------------------------------------------------------------------------------------------------------------------------------------------------------------------
-----------------------------------------XXX----------------------E------------------------------------------------------------------------------------------------------------------------------------------------------------------------------------E--------------------------------
-------------XXX--------------------------XX---------------S----S<>-----------------------------------------------------------XXX-------------------------XXXXXX----------SSSSSSSSS--------E-------------------------------------SSSS--SSSS-----------<>------------------XXX-----------
-----------XXXXX----------------------XXXXXX---------------------[]---------------------------E---------------E-----------------------------------------------------------SSSSSSS---------<>---E-----------------------------------S----S---------<>--[]--------------------------------
----------XXXXXX----------------------XXXXXX---------------------[]-----<>-XX----------------<>--------------<>-----------------------------------------------------------SSSSSSS---------[]--<>-----------------------------------S--------------[]--[]---X----------------------------
---------XXXXXXX--------E--E-E-E-----XXXXXXX--------E--EE-----E--[]-----[]-------------------[]--------------[]---------------------------------------------------------------SS-E--------[]--[]----------------------E---------------E-----------[]--[]---X----------------------------
XXXXXXXXXXXXXXXXXXXXXXXXXXXXXXXXXXXXXXXXXXXXXXXXXXXXXXXXXXXXXXXXXXXXXXXXXXXXX--XXXXXXXXXXXXXXXXXXXXXXXXXXXXXXXXXXXXXXXX---XXXXX----XXXXXXXXX----XX---XXXXXXXXXXXXXXXXXXXXXXXXXXXXXXXXXXXXXXXXXXXXXXXXXXXXXXXXXXXXXXXXXXXXXXXXXXXXXXXXXXXXXXXXXXXXXXXXXXXXXXXXXXXXX---XXXXXX--XXXXXXXXXXX
