----------------------------------------------------------------------------------------------------------------------------------------------------------------------------------------------------------------------------------------------------------------------------------------
----------------------------------------------------------------------------------------------------------------------------------------------------------------------------------------------------------------------------------------------------------------------------------------
---------------------------------------------------------------------------------------------------------------------------------------------------------------------------------------SSSSSSSSSSSSS----------------------------SSSSSS--------SSSSSSSSSSSSSS----------------------------
----------------------------------------------------------------------------------------------------------------------------------------------------------------------------------------------------------------------------------------------------------------------------------------
----------------------------------------------------------------------------------------------------------------------------------------------------------------------------------------------------------------------------------------------------------------------------------------
--------------------------------------------------------SSS----------------------------------------------------------------------------XXX------------------------XXXXXX-----------------------------------------S------------------------------------------------SSS-S---------------SS
----------------------------------------------------------------------------------------------------------------------------------------------------------------------------------------------------------------------------------------------------------------------------------------
----------------------------------------------------------------------------------------------------------------------------------------------------------------------------------------------------------------------------------------------------------------------------------------
--------------------------E-----------------E--------------------------------------------------------------------------------------------------------------------------------------------SS-----------------------------------E-----------E---------------------------------------------
-X-----------------------<>----------------<>-----------SSSQ---------------X-----------------------XX-----------X-------------XXXXX---------------------------------------------QQ-------------------X-----------------------QSS-----S---<>-----------------------SSSSS-----------------
-X-----------------------[]----------------[]------------------E---------XXXX-------------------------------------------------XXXX-------------------------------------------------------------------X-----------------------------------[]---------E------X----------------------------
-------------------------[]----------------[]-----------------<>--------XXXXX-----------------------------------------------------------------------------------------------------------<>-X--------XX-----------------------------------[]--------<>------X----------------------------
XXX----------------------[]-----EE---------[]-----------------[]-------XXXXXX-------------------------------------------------------------------------------------------------E------EX-[]----------XX-----E-E---------------------------[]--------[]------X------------------EE--------
XXXXXXXX------XXXXXXXXXXXXXXXXXXXXXXXXXXXXXXXXXXXXXXXXXXXXXXXXXXXXXXXXXXXXXXX-XXXXXX---X-------XXXXXXXXXXXXXXXXXXXXXXX---XXXXXX----XXXX-XXXXXXXXX-XXXXXXXXXXXXXXXXXXXXXXXXXXXXXXXXXXXXXXXX-XX-XXXXXXXXXXXXXXXXXXXXXXXXXXXXXXXXXXXXXXXXXXXXXXXXXXXXXXXXXXXXXXXXXXXXXXXXXXXXXXXXXXXXXXXXXX
