----------------------------------------------------------------------------------------------------------------------------------------------------------------------------------------------------------------------------------------------------------------------------------------
----------------------------------------------------------------------------------------------------------------------------------------------------------------------------------------------------------------------------------------------------------------------------------------
----------------------------SSSSSSSSSSSSSSSSSSSSSSSSSSSS--------------------------------------------------------------------------------------------------------------------------------------------------------------------------------------------------------------------------------
-------------------------------------------------------------------------------------------------------------------------------------------------------------------------------------------------------------------X--------------------------------------------------------------------
----------------------------------------------------------------------------------------------------------------------------------------------------------------------------------------------------------------------------------------------------------------------------------------
-------------------------------------------------------------------------------------XXX-----------------------------------------------XX-XX----------------XX-----------XXXX--------------------------------------X-------------------------------------------------------XSSS---------
-----------------------------------------------------------------------------------------------------------------------------------------------------------XXX----------------------------------------------------XX------------------------------------------------------XXX---E-------
---------------------------------------------------------------------------------------------------------------------------------------------------------XXXXX---------------------------------------------------XXX-----------------------------------------------------XXXX----E------
--------------------------------------E----------------------E----------E-------------------------------------------------------------------------------XXXXXX--------------------------------------------------XXXX-----------------E----------E-----------------------XXXXXE--<>------
--------------XXX-----------SS-S----S<>---------E------X----<>---------<>----------E---------------------------------------------------------E--------XXXXXXXX-------------------------------------------------XXXXX----------------<>---------<>----------E-E--<>-----XXXXXX-----------
----------------------------S--S-----[]--------XX-X----X----[]---------[]---------<>--------------------------E-----------------------------<>-------XXXXXXXXX---XX----E--------------------------------------XXXXXX----------------[]---------[]----E----<><>--[]---XXXXXXXX----X-----<
----------------------------S]-S-----[]-----<>-XX-----XX----[]---------[]----<----[]-------------------------<>-----------------------------[]-------XXXXXXXXX---XX----X-------------------------------------XXXXXXX----------------[]---------[]---<>----[][]--[]---X-XXXXXX----X-----[
----------------------------S-----E--[]-----[]-XX----XXX-E--[]-----E-E-[]----[----[]-------------------------[]-----------------------------[]-E-----X-XXXXXXX---XX----X--------E---E----------E-EE---------XXXXXXXX--------E--E-E--[]-----E-E-[]---[]----[][]--[]-----XXXXXX----X-----X
XXXXX----XXXXXX----XXXXXXXXXXXXXXXXXXXXXXXXXXXXXXXXXXXXXXXXXXXXXXXXX---XXXXXXXXXXXXXXXXXXXXXXXXXXXXXXXXXXXXXXXXX--XXX--XXXXXXXXXXXXXXX--XXXXXXXXXXXXXXXXXXXXXX--XXXXXXXXXXXXXXXXXXXXXXXXXXXXXXXXXXXXXXXXXXXXXXXXXXXXXXXXXXXXXXXX-XXXXXXXXXXX-XXXXXXXXXXXXXXXXXXXXXXXXXXX--XXX---XXXXXXXX
