----------------------------------------------------------------------------------------------------------------------------------------------------------------------------------------------------------------------------------------------------------------------------------------
----------------------------------------------------------------------------------------------------------------------------------------------------------------------------------------------------------------------------------------------------------------------------------------
----------------------------SSSSSSSSSSSSSSSSSSSSSSSSSSSS--------------------------------------------------------------------------------------------------------------------------------------------------------------------------------------------------------------------------------
----------------------------------------------------------------------------------------------------------------------------------------------------------------------------------------------------------------------------------------------------------------------------------------
--------------------------------------------------------------------------------------------------------------------------------------------------------------------------------------------------------------XX------------------------------------------------------------------------
----------------------XXXX------------------------------------------------X---------------SQQQQQQ-----------------------------------------------------------------------X---SSSSSSSSS--S-----------S----------------------------SS------------------------------------------------------
--------------------------------------------------------------------------X-------------------------------------------------------------------------------------------------------------------------------------------------------------------------------------------------------------
-------------------------------------------------------------------------XX---------------------------------------------------------------------------------------------X---------------------------------------------------------------------------------------------------------------
--------------------------------------E---------------------------------XXX--------------------------------E----------------------X---------------SSS-----------------------------------------------------------------------------------------------------------------------------------
--Q----------------------------S----SQ>--------------------------------XXXX-----------E--QQ--SQQQ---------<>----QQQ--------------XXX---------------------QQQ-----------------SSSSSSSQQ--------<--X-----------------Q------------QQ----------------X------------------------<>-----------
---------------X---------------------[]--------E-------X--------------EXXXX----------<>-------------------[]--E---------------EXXXXX-----------------------------------------------------------E-X----------------------------E---------------EXXXXX-----------------------[]-----------
-------------------------------------[]-----<>-XX-----XX-------------EXXXXX----------[]-------------------[]-------------------XXXXX------XX--------------------------------------------------[]-X---------------------------<>----------------X-XX-------X----------------[]-----------
----------------------------E-----E--[------[]-------XXX--------------XXXXX----------[]----------------E--[]-------------------XXXXX-----XXX---------E-------------------------------------EE-[]-X-----------E---------------[]--------------------------XXX---------------[]-----------
XXXX----XXXXXXXXXXXXXXX-XXXXXXXXXXXXXXXXXXXXXXXX--XXXXXXXXXXX--XXXXXXXXX-X------XXXXXXXXXXXXXXXXXXXXXXXXXXXXXXXXXXXXXXXX--XXXXXXXXXXXXXXXXXXXXXXXXXXXXXXXXXXXXX------X--XXXXXXXXXXXXXXXXXXXXXXXXXXXXXXXXXXXXXXXXXXXXXXXXXXXXXXXXXXXXXXXXXXXXXXXX-------XXXX-XXXXXXXXXXXXXXXXXXXX---XXXXX
