----------------------------------------------------------------------------------------------------------------------------------------------------------------------------------------------------------------------------------------------------------------------------------------
----------------------------------------------------------------------------------------------------------------------------------------------------------------------------------------------------------------------------------------------------------------------------------------
----------------------------------------------------------------------------------------------------------------------------------------------------------------------------------------------------------------------------------------------------------------------------------------
-------------------------------------------------------------------------------------------------------------------------------------------------------------------------------------------------------------E--------------------------------------------------------------------------
------------------------------------------------------------------------------------------------------------------------------E------------------------------------------------------------------------------XXX------------------------------------------------------------------------
--------------------------------SSSSSSSSS----------------------------------------------------------------------------------------E----------------------------------XXXX-----------------------------------------QQ------------------------------E---------------------------------XXXXX
----------------------------------------------------------------------------------------------------------------------XX-------------XXXXX------------------------------------------------------------------------------------------------------XXXXX-----------------------------------
--------------------------------------------------------------------------------------------------XXXXXX--------------------------------------------------------------------------------------------------------------------------------------------------------------------------------
---------------------------------------------------E---------------------------E-------------------------------------------------------------------------------------------------------------------------SS-----------------------------------------------------------------------------
-------------------------SSS-----SSSSSSS----------<>--------------------E-----<>------------------------------------------------XX---------Q---------------------S-SS------------------XX----------------------EQQQQQQ--------E---------------------------SS----------------------------
------------------------------>-------------------[]--------------------------[]--E----------------------E------------------X----------------------------------------------------------XX------------------------------------<>---------------------------------------------------------
-----------------------------[]-------------------[]--------------------------[]------------------------<>------XXX--------------------------------------------------------------------XX------------------------------------[]-XXXX----------------------------------------------------
-------E-E----------------------------------------[]--------------------------[]-----EE-EEE-E-EEE-EE------E--E-E------------EE-------E-E---------------------------------E-EE------E-XXXX--------------------E---------------[]---------------------------------------------------------
---XXXXXXXXXXXXXXXX---XXXXXXXXXXXXXXXXXXXXX-XXX--XXXXXXXXXXXXXXXX--XXXXXXXXXXXXXXXXXXXXXXXXXXXXXXXXXXXXXXXXXXXXX-----X--XX--XX-----XXXXXXXXXXXXXXXXXXXXXXXXXXXXXXXXXXXXXXXXXXXXXXXXXXXXXXXXXXXXXXXXXXXXXXXXXXXXXXXXXXXX--XXXXXXX-----XXXXXX-XXXXX----XXXXXXX-XXX---XXXXXXXXXXXXXX------X
