----------------------------------------------------------------------------------------------------------------------------------------------------------------------------------------------------------------------------------------------------------------------------------------
----------------------------------------------------------------------------------------------------------------------------------------------------------------------------------------------------------------------------------------------------------------------------------------
------------------------------------------------------------------------------------SSSSSSSSSSSSSSSSSSSSSSSSSSSS------------------------------------------------------------------------------------------------------------------------------------------------------------------------
----------------------------------------------------------------------------------------------------------------------------------------------------------------------------------------------------------------------------------------------------------------------------------------
----------------------------------------------------------------------------------------------------------------------------------------------------------------------------------------------------------------------------------------------------------------------------------------
---------------------------------------?SSS------------------------------XX-------------------------------------------------------X-------------------------------------------------------------------------------------------------------------S-----------------------------X---------
------------------------------------------------------------------------XXX-------------------------------------------------------X------------------------------------------------------------------------------------------------------------------------------------------XX---------
--------------XXXXXX---------------------------------------------------XXXX--------------------------SX--------------------------XX------------------------XE----------------------------------------------------------X-----------------------------------------------------XX---------
-----------------------------XSSSSSSS------------------E--------------XXXXX-------------------------XXXS---------S---------------XX--------------E---------X------------------------------------------------------------------------------------E-----------SS-------------XXXX---------
---------------------------E-----------SSSSS----------------------X--XXXXXX-----------------Q-S------X----X-----X--------------XXXX-------------<>---------------------E--------Q-----------------------------------------SS--------->---------<>--------------------------XXXX---------
----------------E---------<>--------------------------------------X-EXXXXXX--------------------------X-X--X----X--------------EXXXX-------------[]----------E----E----<>----------------XX------------------------------------------[]---------[]----X--------------------XXXXX---------
---------------<>---------[]--------------------------------------XXXXXXXXX--------->------------XXXXX-X--X----X-------------EXXXXX-------------[]---------<>---<>----[]---------------XXX--------XX--------------------------------[]---------XX----X-------------------XXXXXX---------
--E-EE----E----[]---------[]-------------------------------------XXXXXXXXXX---------E-----E------XXXXX-X--X----X--------------XXXXX--------X-E--[]---------[]---[]----[]--------------XXXX--------XX--E--E--E-E-----------E--E---E--[]-----E-XXXX----X-------------------XXXXXX--------X
XXXXXXXXXXXXXXXXXXXXXXXXXXXX---XXXXXXXXXXXXXXXXXX-------XXXXXXXX-XXXXXXXXXXXXXXXXXXXXXXXXXXXXXXXXXXXXX-XXXXXXXXXXXXXXXX---XXXXX----XXXXXXXXXXXXXXXXXXXXX-XXXXXXXXXXXXXXXXXXXXXXXXXXXXXXXXX----XXXXXXXXXXXXXXXXXXXXXXXXXXXXXXXXXXXXXXXXXXXXXX-XXXX-XXXXXXXXXXXXXXXXXXXXXXXXX-------------
