----------------------------------------------------------------------------------------------------------------------------------------------------------------------------------------------------------------------------------------------------------------------------------------
----------------------------------------------------------------------------------------------------------------------------------------------------------------------------------------------------------------------------------------------------------------------------------------
SSSSSSSSSSSSSSSSSSSSSSSSSSSS------------------------------------------------------------------------------------SSSSSSSSSSSSSSSSSSSSSSSSSSSS--------------------------------------------------------SSSSSSSSSSSSSSSSSSSSSSSSSSSSSSSSSSSSSSSSSSSSSSSSSSSSSSSS----------------------------
-------SS------------------------------------------------------------------------------------------------------------------------------------------------------------------------------------------------------------------------------------------------------------E------------------
-------SSS-----------------------------------------------------------------------------------------------------------------------------------------------------------------------------------------------------------------------------------------------------------XXX----------------
-SSSS--SS----S----------------------------------------------------------------------------SQQQQQQ--------------S----------------X---------------------------------------------SSSSSSS--------------S------------------------------------------------------------------------------------
--------------------------------------------------------------------------------------------------------------------------------X-------------------------------------------------------------------------------------------------------------------------------------------------------
----------------------------------------------X---------------------------------------------------------------------------------XS-----------------------------------------------------------------------------------S--------------------S---------------------------------------------
-----------------------SS----S---------------XX---------------------------------------------------------------------------------XXXS-----------------------------------------------------------E---------------------SSS------------------E-------------------------S-------------------
SSSSS--SSSS--------E?------XSQQ-------------XXXX----------------------------------Q---E--SSS-SQSQ---------------<>------Q---X----X----X-----------------------------------E--SSS-SSS----------<>----SS-S----SQS---------X------X-----S---[]----------------X--------------Q----------QQ-
-------SSS--------->X------X---------------XXXXX-------------------------------------<>--------------------E----[]--------------XX---XX----------------------------------<>-------------------[]----[------------------XX-X----X-<E------[]---------E------X------E---E--------------->-
---S--SSS-------<XXXX-------]--------------XXXXX-------------------------------------[]-------------------<>-X--[]----------XXXXXX---XX----X-----------------------------[]-------------------[]----[---------------<>-XX------XSS?------[]--------<>------X---------<>---------------]-
---SS-SSS-------[]-XX-------]-------------XXXXXX---------------E-EE--------------EE--[]----------------EE-[]-X--[]----------XXXXXX---XX----X------------------E----------[]---------------EE--[]----E-----E------EX-[]-XX------XS[]------[]--------[]------X---------[]--------------[]-
XXXXXXXXXXXXXXXXXXXXXXXXXXXXXXXXXXXXXXXXXXXXXXXXXXXXXXXXXXXXXXXXXXXXXXXXXX----XXXXXXXXXXXXXXXXXXXXXXXXXXXXXXXXXXXXXXXXXXXXXXXXXXXX---XXXXXXXXXXXXXXXX--XXXXXXXXXXXXXXXXXXXXXXXXXXXXXXXXXXXXXXXXXXXXXXXXXXXXXXXXXXXXXXXXXXXXXXXXXXXXXXXXXXXXXXXXXXXXXXXXXXXXXXXXXXXXXXXXXXXXXXXXXXXXXXXXX
