----------------------------------------------------------------------------------------------------------------------------------------------------------------------------------------------------------------------------------------------------------------------------------------
----------------------------------------------------------------------------------------------------------------------------------------------------------------------------------------------S-----------------------------------------------------------------------------------------
------------------------------------------------------------------------------------------------------------------------------------------------------------------------SSSSSSSSSSSSSSSSSSSSSSSSSSSS------------------------------------------------------------------------------------
------------------------------------------------------------------------------------------------------------------------------------------------------------------------SSSSSSSSSSSSS--------SSSS-SS------------------------------------------------------------------------------------
------------------------------------------------------------------------------------------------------------------------------------------------------------------------SSSSSSSSSS?-----------SSS-SS------------------------------------------------------------------------------------
---------------------------------------------------------------------------------------SSSSSSSS-----------------------------------SS-------------------SS---------------SSSSS-SSSS---S------------S--------------------------------------------E----------------------------------------
--------------------------------------------------------------------------XX------------------------------------------------------------------------------------------------------------------------------------------------------------------E-----------------------------------------
----------------------------------------------------------------------------------------------------------------------------------------------------------------------------------------------------------------------------------------------XXXXXX------------------------------------
--------------------------------------------------------------------------------------E---------------------------XXX----------------------------------------------------?---------------------SS-------------------------------------------X-------------------------------------------
----------------E------------------------X----------------------------------SS--S-SS-------SS----SS----------X--------------XXX---------------E--QQ--S?-----E-----------SSSSSSSSSSS--------E?------X---------------------------------------XX------------------------------X------------
---------------<>----------------------XXX-------------------------------------------------------------------X-------------------------------<>------------<>---E-------X--SSSSSSS--------<>X------X----------------E----------------------XXX-------E------------------XX--------------
---------------[]---------------------XXXX--------------XX---------------------------------------------------X-------------------------------[]--X---------[]------------]SSSSSSSSS-----<X[]X------X---------------<>---------------------XSS-------<>-----[-----------XXX--------------
----E------E---[]-------------------EXXXXX-E--------E---XX----------------------------------------------E-E----------------------------------[]------------[]-EE--------ESSSSSSSSS------[][]X----XXX----EE----E----[]------------EE-EEE-XXXXX-EE----[]--EE-[-----------XXX----------E---
XXXXXXXXXXXXXXXXXXXX-----XXXXXXXXXXXXXXXXX-XXXXX-----------XXXXXXXX-XXXXXXXXXXXXXXXXXXXXXXXXXXXXXXXXXXXXXXXXXXXXXXX---XXXX-X--XXXXXXXXXXXXXXXXXXXXXXXXXXXXXXXXXXXXXXXXXXXXXXXXXXXXXXXXXXXXXXXXXXXXXXXXXXXXXXXXXXXXXXXXXX--XXXXXXXXXXXXXXXXXXXXXXXXXXXXXXXXXXXXXXXXX---XXXXX---XXXXXXXXXX
