------------------------------------------------------------------------------------X---------------------------------------------------------------------------------------------------------------------------------------------------------------------------------------------------
X---------------------------------------------------------------------------------------------------------S----S------------------------------------------------------------------------------------------------------------------------------------------------------------------------
--------------------------------------------------------SSSSSSSSSS---------SSSSSSSSSSSSSSSSSSSSSSSSSSSSSSSSSSSSS------------------------------------------------------------------------------------------------------------------------------------------------------------------------
------------------------------------------------------------------------------------SSSSSSSSSSSSSSSS----SSSSSSSS------------------------------------------------------------------------------------------------------------------------------------------------------------------------
------------------------------------------------------------------------------------SSSSSSSSSSSSSSSS----SSSSSSSS------------------------------------------------------------------------------------------------------------------------------------------------------------------------
----------------SSS--------------------------SS----------SSS---SSSS-----------------SSSSSSSSSSS--SSS----------SS------------------X-------------------------------------------------------------------------------------------------------------------------------------------XSSSS-----
--------------------E---------------------------E------------------------------------S-S-----------------------------------------XX---------------------------------------------------------------------------------X-------------------------------------------------------------------
-----E---------------E-----------E----------E----E-----------------------------------------------------------------------------XXXX-----------------------------------------------------------------------------------------------------------------------------------------------------
-----E----------E---->-----------E---------<>---------------------E---------------------E------------------??-----------------XXXXX-------------------------------------------------------------------------------------------------------------------------X-XXXX----------------------
-E--<>---------<>----------E----<>---------[]----------E---SS---SSS------------------SSSSSSSSSSS-------E------XX-------------XXXXXX------------------------------------------------------X---------------------------------SSSSS----------------------SSSSSS------------XXX-------------
<>--[]---------[]----X----<>----[]---------[]----E----<>--ES-----SS--------E---------SSSSSSSSSS-------<>---------------------XXXXXX---------------------XX------------------------------XXXX----------------------------------------------------------------------------------------XXXX
[]--[]---------[]---<>----[]----[]---------[]---<>----[]---S-----SS-------->-------X-SSSSSSSSSS-------[]------------------XXXXXXXXX--------------------XXX-----------------------------XXXXX---------X----------------------------------------------------------------------------------
[]--[]-----E-E-[]---[]----[]EE--[]-----E---[]---[]----[]---------SS--------]-----XXX-SSSSSSSSSS-------[]-------X----------XXXXXXXXX-----E------------XXXXX----------E-EE--------------XXXXXX----------------E------------E-E-----------EEEE------------E--------------------------------
XXXXXXXXXXXX---XX---XXXXXXXXXXXXXXXXXXXX--XXXXXX-XXXXXXXXXXXXXXXXXXXXXXXXXXX--XX-XXXXXXX-XXXXXXXXXXXXXX------XX-XXXXXXX---XXXXX--XXXXXXXXXXXXXXXXXXX--XXXX-X-XXXXXXXXXXXXXXXXXXXXXXXXXXXXXXXXXXXXXXX-----XXXXXXXXXXXXXXXXXXXXXXXXXXXXXXXXXXXXXXXXXXXXXXXXXXX------XXX-------XXXXXXXX----
