----------------------------------------------------------------------------------------------------------------------------------------------------------------------------------------------------------------------------------------------------------------------------------------
----------------------------------------------------------------------------------------------------------------------------------------------------------------------------------------------------------------------------------------------------------------------------------------
--------------------------------------------------------SSSSSSSSSSSSSSSSSSSSSSSSSSSS---SS---S-----------SS----SS---------------------------------------------------------------------------------------SSSSSS-----SS-----------------SSSSSSSSSSSSSSSSSSSSSSS----------------------------
----------------------------------------------------------S----SSS---------------------SS---------------SSSSSSSS---------------------------------------------------------------------------------------SSSSSSSSSS-SS--------------------------------------------------------------------
----------------------------------------------------------SS---SSS?---------------S---XSS---------------SSSSSSSS---------------------------------------------------------------------------------------SS--SSS-----------E--------------------------------------------------------------
--------------------------------------------------------SSSSS--SSS---S------------S----SSSSSS----SS----------------------------------------------------XXX----------------------------------------XXSSSSSSSSSSSSSSSS----SSSSSSSS-----------------------SS---------------------------SS--
--------------------------------------------------------------------------------------------------------------------------------------------------------------XXX-----------------------------------------------------------------------------------------------------------------------
----------------------------------------------------------------------------------------------------------------------------------------------------------------------------------------------------------------------------------------------------------------------------------------
--------------------------------------------E----------------------------------SS-----E-------------------------------------------------------------------------------XX--------------------------------E----------------------------------------------SS-------------------------------
---------------------------------E---------<>-----------SSSSS--SSSS--------E-------XSXS?SSS-----------XXXX---XXX-------------XXXXX-----------X------------------------------------------------SSS------?SSSSSSS-----------------SSSS------------------------------------XX--------------
----------E---------------------<>---------[]----------E---SS--SSS--------<>-------X------SS?--EX-----XX-------------------------------------XX-----------------------------------------E----------------------------------------------E---------XXXX-----------------------------------
----------E---------------------[]---------[]----<>---<>---SS-SSSS------XX[]X------X-----SSS--------X-[X-------------------------------------XX----------------------------------------<>----------------X------------<---------------<>--------XXXXX-----------------------------------
-------E-EE--------------EE-----[]-----E---[]----[]---[]---SS-SSSS------XX[]X----XXX------SS-------XX-X]E----------------------------E------XXX---------------------------E--E----E----[]-----E-----------------------E---------------[]-------XXXXXX-----------------------------------
XXXXXXXXXXXXXXXXXXX-XXXXXXXXXXXXXXXXXXXX-XXXXXXXXXXXXXXXXXXXXXXXXXXXXXXXXXXXX-XX-XXXXXX--XXXXXXXXXXXXXXXXXXXXXXX--------XXXXXXX---XXXXXXXXXX-------X----------X----XX---XXXXXXXXXXXXXXXXXXXXXXXXXXXXXXXXXXXXXXXXXXXXXXXXXXX--XXXXXXXXXXXXXXXXXXXXXXXX----XXX---X--XXXXXXXXXXXXXXXXXXXX-X
