----------------------------------------------------------------------------------------------------------------------------------------------------------------------------------------------------------------------------------------------------------------------------------------
--------------------------------------------------------X-------------------------------------------------------------------------------------------------------------------------------------------------------------------------------------------------------------------------------
--------------------------------------------------------SSSSSSSSSSSSSSSSSSSSSSSSSSSS----------------------------------------------------------------------------------------------------------------------------------------------------------------------------------------------------
----------------------------------------------------------------------------------------------------------------------------------------------------------------------------------------------------------------------------------------------------------------------------------------
----------------------------------------------------------------------------------------------------------------------------------------------------------------------------------------------------------------------------------------------------------------------------------------
--X--------------------------SSS---SS--------------SS-------------------S-S------------------------------------------------------SSSS---------------------------------------------------------------------------S-----------------------------------------------------------------------
----------------------------------------------------------------------------------------------------------------------------------------------------------------------------------------------------------------------------------------------------------------------------------------
---------------------------------------------------------------------------------------------------------------------------------------------------------------------------------------------------------------------------------------------------------------------------XXX----------
------------------------------------------------------------------------XSSS-----------------------------------------------------------------------------------------------------------------------------E----------E-------------------------------------------------------------------
----------------------------SSSSS---S-------------------<>---E---E------X---------------------------X----------E-XXXX-------------XX-----XX---------------XXX-------------------------------------------<>---------<>---------------------------------------------------X---------------
----------------------------------------------XX--------[]--<>---E-----XX----XX--------------------XX------E--<>-------E---EXX---------E-X--------------------------------------------------------------[]---------[]--------------------------------------------------XXX--------------
------------X-------------------------------X-XX--------[]--[]------X-XXX----XX----X--------------XXX-----<>--[]------XX--------------<>-XX-------------------------------------------------------------[]---------[]----<>-------------------------------------------XSS---------------
----------XXX------------EE-------------------X]--------[]--[]------XXXXX----X]----X-E-E---------XXXX-----[]--[]--------------------E-[]-XX-----------------------------------------E--------E----------[]---------[]----[]----------------------------------EE-----EXXXX-EE------E-E--E
XXXXXXXXX-XXXXXXXXX--XXXXXXXXXXXXXXXXXXXXXXXXXXXXX--XXXXXXXXXXXXXXXX--XXX---XXXXXXXXXXXXXXXXXXXX-XXXXXXXXXXXXXXXXX----XX-------XXXXXXXXXXXXXXXXXXX----XX----------------XXXXXXXXXXXXXXXXXXXXXXXXXXXX-XXXXXXXXXXXXXXXX-XXXX-XXXXXXXXXXXXXXXXXXXXXXXXXXXXXXXXXXXXXXXXXXXXXXXXXXXXXXXXXXXXX
