--------------------------------------------------------X-------------------------------------------------------------------------------------------------------------------------------------------------------------------------------------------------------------------------------
---------------------------------------------------------X--------------------S---------------------------------------------------------------------------------------------------------------------X-----------------------------------------------------------------------------------
--------------------------------------------------------SSSSSSSSSSSSSSSSSSSSSSSSSSSS----------------------------SSSSSSSSSSSSSSSSSSSSSSSSSSSS--------------------------------------------------------SSS-----------------SSSSSSSS--------------------------------------------------------
--------------------------------------------------------SSSSSSSSSSSSSSS------SSSSSSS----------------------------------------------------------------------------------------------------------------------------------------------------------------------------------------------------
---------------------------------------------E----------SSSSSSSSSSSSSSS-----SSSSSSSS----------------------------------------------------------------------------------------------------------------------------------------------------------------------------------------------------
-----------------------XXX--------------XXX-------------SSSSSSSSSS---SS-----------SSS---------------------SSSS-----------------------------------------------------XXX------------------------XXXX------------?SS----------------------------------------------------------------------X
----X----------------------------------------XXXXX--------------------------------------------------------------------------------------------------------------------------------------------------------------------------------------------------------------------------------------
--------------------------------------------------------------------------------------------------------------------------------------------------------------------------------------------------------------S-------------------------------------------------------------------------
------------------------------------------------------XX-?--?------------------??--------------------------S--------------E----------------------------------------------------------------------------------?E------------E---------------------SSS------------------------------------
X------------XXXXXXX---------X--------------------------SSSSSSSSSSS--------E?------XQQQQ--------------XXXX------>S-S----S<>---------E------XX-------------XXXXX---------X-------------XXXXXX----------E--SS--[]-----E-----<>------------Q-----------------------------------------SS----
-----------------------------XX-------------------------XSSSSSSSSSS-------<>X------X-------E------XX-XXXX----------S-----S]--------<>------X--------------XXXX---------------------------------------<>------[]----<>---E-[]---------------------X----X---------------E-----E-----------
----------------------------XXXX------------------------SSSSSSSSSSS-----<>[]X------X------<>---------XXXX----------S-----[]-----<>-[]-----XX--------------------------------------------------------S[]--X---[]----[]--<>-[]------------------XXXX--------------------E-----------------
----------------------------XXXX------------------------SSSSSSSSSSS-----[][]X----XXX------[]-------XXXXXX-------E-----E--[]-----[]-[]----XXX---------------------------------------------------------[]------[]----[]--[]-[]----E-----E------XX-[X------------E--E----S-----------------
---------XXXXX-----XXXX-XXXXXX-----XXXX------------XX---XXXXXXXXXXXXXXXXXXXXXXXXXXXXXXXXXXXXXXXXXX-XXXXXXXX-XXXXXXXXXXXXXXXXXXXXXXXXXXXXXXXXXXXXXX---XXXXXX----XXX--XXXX---------XXXX------XXX----XXXXXXXXXXXXXXXXXXXXXXXXXXXXXXXXXXXXXXXXXXXXXXXXXX--XXXXXXXXXXXXXXXXXXXXXXXXXXXXXXXXXX
