----------------------------------------------------------------------------------------------------------------------------------------------------------------------------------------------------------------------------------------------------------------------------------------
----------------------------------------------------------------------------------------------------------------------------------------------------------------------------------------------------------------------------------------------------------------------------------------
------------------------------------------------------------------------------------------------------------------------------------------------------------------------SSSSSSSSSSSSSSSSSSSSSSSSSSSSSSSSSSSSSSSSSSSSSSSSSSSSSSSS--------------------------------------------------------
------------------------------------------------------------------------------------------------------------------------------------------------------------------------------------------------------S----SSS--------------------------------------------------------------------------
-----------------------------------------------------------------------------------------------------------------------------------------------------------------------------------------------------------SSS?-------------------------------------------------------------------------
----------------------XXXXX-X--SSSSSSSS----------------S-S--------------------------------------------------------XX---------------------------------------------------------------------------------SSSS--SSS--------------------------------------------------------------------------
----------------------------------------------------------------------------------------------------------------------------------------------------------------------------------------------------------------------------------------------------------------------------------------
----------------------------X----------------------------------------------------------------------------------------------------------------------------------------------------------------------------------------------E------------------------------------------------------------
-----------------------------------------------------------------------------------------E----------E-----------------------------------------------------------------------------E------SS--------------------------------E------------------------------------------------------------
----------------------------------SSS---?SS----------X---QQ---------------X-------------<>---------<>--------------------------------------------------------XX---<>---->--S-----<>-----------------SSSSS--SSSS--------E--[]-------------------XXX--------------------------------------
---------------X-------------------------------------------------------X-XX----E--------[]---------[]----------E-------------------------------------------XXXX---[]-------------[]---------?----------SS--SSSS-------<>--[]------------------------------------------------------------
--------------------------------------------------------------------------X---<>--------[]---------[]----------[-------------------------------------------XXXX---[]----SS-------[]--------EX---------SSS-SSSSS-------[]--[]------------------------------------------------------------
------------------------------------------------E-E-----------------------X---[]--------[]---E-----[]---------E[--------E---E----------E-EE---------------XXXXX---[]----S-----E--[]--------[]---------SSSSSSSSS-------[]--[]------------------------------------------------------------
XXXXXX--XXXXXXXXXXXXXXX-XXXXXXXXXXXXXXXXXXXXXXXXXXXXXXX-XXXXXXXX--XXXXXXX--XXXXXXXXXXXXXXXXXXXXXXXXXXXXXXXXXXXXXXXXXXXXXXXXXXXXXXX-XXXXXXXXXXXXXXXXXXXXXXXXXXXXXXXXXXXXXXXXXXXXXXXXXXXXXXXXXX--XXXXXXXXXXXXXXXXXXXXXXXXXXXXXXXXX--------XXXXXXXXXXXXXXXXXXXXXXXXXXXXXXXXX-XXXXXXXXXXXXXX
