----------------------------------------------------------------------------------------------------------------------------------------------------------------------------------------------------------------------------------------------------------------------------------------
------------------------------------------------------------------------------------------------------------------------------------------------------------------------------------------------------------------------------------------------------------X---------------------------
--------------------------------------------------------SSSSSSSSSSSSSSSSSSSSSSSSSSSS----------------------------------------------------------------------------------------------------------------------------------------------------------------------------------------------------
----------------------------------------------------------------------------------------------------------------------------------------------------------------------------------------------------------------------------------------------------------------------------------------
----------------------------------------------------------------------------------------------------------------------------------------------------------------------------------------------------------------------------------------------------------------------------------------
--------------------------XX------------------E----XX----------------------------------------------X-S-----------------------------------------------------------------------------------------------XXXX-------------------------------------------------------------------------------
--------------------------------E------------XX-------------------------XX------------------------XX--------------------------------------------------------------------------------------------------------------------------------------------XX--------------------------------------
-----------------X---------------------------XX--------------------------XX-----------------------XXX-----------------------------------------------------------------------------------------------------------------------------------------------------------------------------------
----------------------------SS-------------XXXX-------------------------XXXS-----------------------X-------------------------------------------------------------------------------------------------------------------------------------------------------------E----------------------
----------------------SS----X------------XXXXXX---------<>------Q-S------X-X--X----------------X---------------E----------------------SSSSSS--------------------------------------------E------------------------------------S----------------------SS-SSSSS---------------------XSS----
----------------------------X------------XXXXXX---------[]--------------XX---XX----------E-----X---------E----<>-----------------------------------------------------------------------<>------------------------------------------------------------------------E----------E----E------
----------------------------]------------XXXXXX---------[]----------XXXXXX-X--X---------<>---------X----<>----[]-----------------------------------------------------------------------[]-----------------------X---------------XXXX----------------------------<>---------<>---<>-----[
--E-----E-E-E-EE------E-----]---------XXXXX-XXX---------[]-E--E-----XXXXXX-X--X------E--[]-----E--EX----[]----[]-X-----EEE-------------E----------------E------------EE----------------[]-E--------------EEEE---E----------E-EE---------E----E-------E-E--------[]---------[]---[]-----[
XXXX-XXXXXXXXXXXXXXXXXXXXXXXXXXXXX---XXXXXX--XXXXX--XXXXXXXXXXXXXXXXXXXXXX----XXXXXXXXXXXXXXXXXX--XXXXXXXXXXXXXXXXXXXXXXXXXXXXXXXXXXXXXXXXXXXXXXXXXXXXXXXXXXXXXXXXXXXXXXXXXXXXXXXXXXXXXXXXXXX----XXXXXXXXXXXXXXXXXXXXX--XXXXXXXXXX--XXXXXXX-XXXXXXXXXXXXXXXXXXXXXXXXXXXXXXXXXXXXXXXXXXXX
