----------------------------------------------------------------------------------------------------------------------------------------------------------------------------------------------------------------------------------------------------------------------------------------
---------------E------------------------------------------------------------------------------------------------------------------------------------------------------------------------------------------------------------------------------------------------------------------------
--------------<>------------------------------------------------------------------------------------------------------------------------------------------------------------------------------------------------------------------------------------------------------------------------
--------------[]------------------------------------------------------------------------------------------------------------------------------------------------------------------------------------------------------------------------------------------------------------------------
--------------[]-----E------------------------------------------------------------------------------------------------------------------------------------------------------------------------------------------------------------------------------------------------------------------
X---SS??ESSSSSS-----SSS--S-SSSSSSS-SSS----SS-----------S-----------------------------------------------------XXX---------------------------------------------------------SSS-------------------------------QQQQQQQQ------------S--------------------------------------------------------
----------------------------------------------------------------------------------------------------------------------------------------------------------------------------------------------------------------------------------------------------------------------------------------
]---------------------------------------------------------------------------------------------------------------------------------------------------------------------------------------------------------------------------------------------------------------------------------------
X-X----------------------------E--------------------------------------------------------------------------------------------------------------------------------------------------------------------------------------------------------------------------------------------------------
-------S?S--?SS----------X----SSS--SS-------------------------------SS-----------------------------------SSSSS---------------------------------------QQ------------------?SQS---------------------------------QSQQQQ-Q---------------QQ---Q---------------------------------------------
------------------------XXXX------------------X-----------------------------------------------E------------------------------------------------------------------------------------------------------------------------------X-------------------------E--------------------------------
--------------------------------------------X-X----------------------------------------------<>-----------------------------------------------------------------------XX----------------X-X----------------------------------X------------------------[]--------------------------------
--------------------X-X-----------------------X----------------------------------------------[]-----------------------------------------------------------------------XX-----------------------------------------------E--------------------------E---[]--------------------------------
-----XXXXXX-XX--XXXXXX------XXXXXXXXXXXXXX-XX-----------XXXXXXXXXX-XXXXXXXXXXXXXXX--XXXXXXXXXXXXXXXXXXXXXXXXXXXXXXXXXXXXXXXXXXXXXXXXXXXXXXXXXXXXXXXXXXXXXXXXXXXX--XXXXXXXXXXXXXXXXXX----------------XXXXXXXXXXXXXXXXXXXXXX--XXX-XXXXXXXXXXXXXXXXXXXXXXXXXXXXXXXXXXXXX-XXXXXXXXXXXXXXXXXX
