----------------------------------------------------------------------------------------------------------------------------------------------------------------------------------------------------------------------------------------------------------------------------------------
----------------------------X-----------------------------------------------------------------------------------------------------------------------------------------------------------------------------------------------------------------------------------------------------------
----------------------------------------------------------------------------------------------------------------------------------------------------------------------------------------------------------------------------------------------------------------------------------------
----------------------------------------------------------------------------------------------------------------------------------------------------------------------------------------------------------------------------------------------------------------------------------------
------------------------------------------------------------------------------------------------------------------------------E---------------------------------------------------------------------------------------------------------------------------------------------------------
--SS---SSSS---------------------------------------------X--SSS??SS-------??SS----------------------------------------------------E-----------------------S-----XXX-------SS-----------------------------------------X-------------------------------------------------------------------
------------------------------------------------E---------------------------------------------------------------------XX-------------------------------------------------------------------------------------------XXX------------------------------------------------------------------
---------------------------------E----------E----------------------------------------------------------------------------------------------------------------------------------------------------------------------XXX------------------------------------------------------------------
-----------------------E---------E----------E-----------X-XX----------------------------------------------------------------------------------XXXX---------------------------------------------E------------------XXXX------------------------------------------------------------------
---S----SSS-----------<>--------<>---------[]----------E-------SS---XXX----------<>-QQQQ--------------XX-----------------------XXX---------S------------XX--------------SS----------------X---<>------------------XXXX----------------------------SSSS-SS-SQ------------------------SSSS
----------------------[]--------[]---------[]----X----<>-------------------------[]---------------XXXXXXX-----------------------------------------------------------XXXX------------------X---[]----------------EXXXXX------------------------------------------------------------------
------------------<---[]--------[]---------[]---<>----[]-------------------------[]-------X----------XXX--------XXXX--------------------------------------------------------------------XXX---[]---------------XXXXXXX----------XXX-----------------------------------------------------
------------------[---[]-----E--[]-------E-[]---[]----[]--------------------E-E--[]----------------X---X---------------------E---------------------------------------------------------XXXX---[]-----E-E------XXXXXXXX---------X---------------------E-------------E-E------------------
XXXXXXXXXXXXXXXXXXXXXXXXXXXX-XXXXXXXXXXX---XX---XXXXXXXXXXX--XXX--------XXXXXXXXXXXXXXXXXXXXXXXXXXXXXX-X----XXXXX----X--XX--XX-------XXXXXXX-----XXXXXX---XXXXXXXXXXXX--XXXXXXXXXXXXXXXXXX---XXXXXXXXXXXXXXXXXXXXXXXXXXXX-XXX--X-------XXXX-XXXXXXXXXXXXXXXXXXXXXXXXXXXXXXXXXXXXXXXXXXXX
