----------------------------------------------------------------------------------------------------------------------------------------------------------------------------------------------------------------------------------------------------------------------------------------
----------------------------------------------------------------------------------------------------------------------------------------------------------------------------------------------------------------------------------------------------------------------------------------
----------------------------------------------------------------------------------------------------------------------------------------------------------------------------------------------------------------------------------------------------------------------------------------
---------------------------------------------------------------------------------------------------------------------------------------------------------------------------------------------------------------------------------EEE-----------------S--SS-S----------------------------
---------------------------------------------------------------------------------------------------------------------------------------------------------------------------------------------------------------------------------XXXXX---------------E--SS------------------------------
--------------------------XX-------------E---E--------------------------XX--------------------Q---------------------------QSS--------------S------SSSSSS--------------SS-----------------------XXX----------------Q---------SSXX?----------------S?SSSSSSS--XXXXX-----------------------
--------------------------------------------XXXXXXXXX------------------XXX--------------------------------------------------------------------------------------------------------------------------------------------------------------------------------------------------------------
----------------XX----------------------------------------------------XXXX--------------------------------------------------------------------------------------------------------------------------------------------------------------------------------------------------------------
---------------------------------------------------------------------XXXXX-------------------------------------------------------------------------------------------------------------------------------S------------------------------------------------------------------------------
-----------------------S------------------------SS--S-SQ--------Q-XXXXXXXX----X----------------QQQ------------E---E--QQ--SS?----E----------------SS--SSS------------------------------XXXXX--------------------QQQQQQ------SS---XXXXX-------------XXXX----XX----------------------------
-----------------------------E--------------------------<>-------XXXXXXXXX---XX------------------------------<>--<>------------<>------------->----------------------------------------------------------------------------------------X---EXX------------------------------------------
----------------------------XXXX------------------------[]-------XXXXXXXXX---XX----X-------------------------[]--[]--X---------[]------------[]---------------------------------------------------------------------------------------XX--------------------------------X---------------
--E-----E-EEE-EE------E-E---X------------E-------E------[]-E-----X-XXXXXXX---XX----X-------------------------[]--[]------------[]-EE---------[]---------------EE------------------------------------------------------E---------------[]-------XX---X---------------E---E------------EE-
XXXXXXXXXXXXXXXXXXXXXXXXXXXX-----XXXXX--XXXXXXXXXXXXXXXXXXXXXXXXXXXXXXXXXX----XXX--XXXXXXXXXXXXXXXXXX--------XXXXXXXXXXXXXXXXXXXXXXXXXXXXXXXXXXXXXXXXXXXXXXXXXXXXXXXXXXXXX-XX-----XXXXX---XXXXX-XXXXXXXXXXXXXXXXXXXXXXXXXXXX-XXXX------XXXXX---XXXXXXXX--XX-XXXXXXXXXXXXXXXX-----XXXXXXX
