----------------------------------------------------------------------------------------------------------------------------------------------------------------------------------------------------------------------------------------------------------------------------------------
----------------------------------------------------------------------------------------------------------------------------------------------------------------------------------------------------------------------------------------------------------------------------------------
--------------------------------------------------------------------------------------------------------------------------------------------------------------------------------------------------------------------------------SSSSSSSSSSSSSSSSSSSSSSSSSSSS----------------------------
--------------------------------------------------------------------------------------------------------------------------------------------------------------------------------------------------------------------------------SSSSSSSSSSSSSSS------S----SS----------------------------
--------------------------------------------------------------------------------------------------------------------------------------------------------------------------------------------------------------------------------SSSSSSSSSSSSSSS-----SS----SS----------------------------
-----------Q---------------------------?SSS------XX------------------------------------------------X-SS---------------------EQS--------------XXX---------------------------S----S--------SSS------------------------------------SSSSSSSSSSS--SSS-----------------------------------XXX--
--------------------------------------------------------------------------------------------------XX----E-------------------------------------------------------------------------------------------------------------------------------------------------------------------------------
--------------------------------------------------------------------------------------------------XXX----E-----------------------------------------------X------------------------------------------------------------------------------------------------------------------------------
-----E----------E--------------XXX--------------------XX---------------------------------E------X-XX----<>-------XSSSSSSS-----------------E--------------X--------------------------------------------------------------------------E------------------E--------------------------------
----<>-----E---<>------------------------------------------------------X-------------E--<>-----X--XX-----------E------------S?SS---------<>-----------------------SSSSSS---XX----------------------------------------------------SSSSSSSSSS--------E--<>-------------------XX-----------
----[]---------[]---------E--X------------------------------------------------------<>--[]-----X--XX-----E-----<-------------------------[---------------------------------------------------------------E----------E-------------SSSSSSSSS-------<>--[]-------------------X------------
----[]---------[]--------<>------------------------------------------X---------------]--[]---------X----<>----[[---------------------------------------------------------------------------------XX-----<>---E-----<>------------SSSSSSSSSS-------[]--[]--------------------------------
----[]---------[]--------[]-XXX------------------------------------EEX----------E---[]--[]-----E--EX----[]----[]---------E--------------------E--E-EE-E-E--------E-E--------------------------E--X------[]---E-----[]------------SSSSSSSSSS-------[]--[]--------------------------------
XXXXXXXXXXXXXXXXXX-----X-XXX------XXXXX-----XXXX---X----XXXXXXX-XXXXXXXXXXXXXXXXXXXXXXXXXXXXXXXX--XXX--XXXXXXXXX--XXXXXXXXXXXXXXXXXXXXXXXXXXXXXXXXXXXXXXXXXXXXXXXXXXXXXXXXX---XXXXXX----X-----X--XX-XXXXXXXXXXXXXXXXXXXXXXXXXXXXXXXXXXXXXXXXXXXXX----XXXXXXXXXXXX----XXXX---------------
