----------------------------------------------------------------------------------------------------------------------------------------------------------------------------------------------------------------------------------------------------------------------------------------
----------------------------------------------------------------------------------------------------------------------------------------------------------------------------------------------------------------------------------------------------------------------------------------
----------------------------------------------------------------------------------------------------------------------------------------------------------------------------------------------------------------------------------------------------------------------------------------
----------------------------------------------------------------------------------------------------------------------------------------------------------------------------------------------------------------------------------------------<-----------------------------------------
-----------------------------------------------------------------XXX---------------------------------------------------------------------------------------------------------------------------------------------------------------E----------[]-----E----------------------------------
Q-----------------------X--------X---------E------------------------------------------------------------------------------------------------X---S?--S?S---------------------------------------SSSS--SSSSS-SSSSS-----------------X--SS???E--------??SSSS-SS--S---------------------------
----------------------------------------------------------------------------------------------------------------------------------------------------------------------------------------------------------------------------------------------------------------------------------------
-------------------------------------------------------------------------------------------------XX----------------------------XX--------------------------------------------------------------------------------------------------E----------------------------------------------------
-------------------------------------------------------------E----------E------------------------X------------------------------------------X-XX---------------------------------------------------------------------------E----X-XX----------------------------------------------------
-------------XXXXX----------------------X-------------------<>---------<>----------E----------------------SSSSSS-----------------------------------S?---XSS----------X--SQQQ?-------------XX-----------SS--SS-------------<>-------XX-------XXX------X------X-----------------EX--------
-------------X-------------------------XXX------------------[]---------[]---------E-----------E--------------------------------------E-------------------------------XX--------E----------XX------------------------------[]----------------------------X-XXX-------------XXXXXX--------
------------XX------------------------XXXX------------------[]---E-----[]--------->----------<>--------------------------------X-------------------------------------XX-------<>----------XX------------------------------[]------------------------------------------------------------
-----------XXX-------E--E---------E-XXXXXX--------E-EE-E----[]---E-----[]---------]------E-E-[]------------E-----E--EE----EE--EE-----------E-------------------EE-E--X--------[]-------XX-XX------------------------------[]------------------------E-----------------------------------
---XX---XXXXXX-----XXX--XXXXXXXXXXXXXXXXXXXXXXXXXXXXXXXX-XXXXXXXXXXXXXXXXXXX-XXXXXXXXXXXXXXXXXXXXXXXXXXXXXXXXXXXXXXXXXXXXXXXXXXXXXXXXXXXXXXXXXXXXXXXX-------XXXXXXXXXXX-XXXX--XXXXXXX--XXXX---------XXXXXXXXXX-XXX-XXXXXXXXXXXXX------XXXXXX---XXXXXXXXXXX--XX--X-----XXX---------------
