----------------------------------------------------------------------------------------------------------------------------------------------------------------------------------------------------------------------------------------------------------------------------------------
----------------------------------------------------------------------------------------------------------------------------E-----------------------------------------------------------------------------------------------------------------------------------------------------------
---------------------------------------------------------------------------------------------------------------------------<>-------E-------------------------------------------------------SS-----S------------------------------------------------------------------------------------
----------------------------------------------------------------------------------------------------------------------E----[]------<>--------------------------------------S----------------SS---SSS------------------------------------------------------------------------------------
----------------------------------------------------------------------------------------------------------------------XXX--[]------[]--------------------------------------SE---------------SS--SSSS------------------------------------------------------------------------------------
-------QQ-SSS--------------S-----------SS-------------------------------XX----------------------------------XXXX-----------XXX---XXXXXX-------------------------------XX---SSSSSS-----SS-?-SSS-----S-------------------------------------------------------X------SQQQQQQ---------------
-----------------------------------------------------------------------XXX--------------------------------------------------------------------------------------------------------------------------------------------------------------------------------------------------------------
---------------------------------------------------------------------XXXXX--------------------------------------------------------------------------------------------------------------------------------------------------------------------------------------------------------------
---------------------------------E----------E-----------------------XXXXXX------------------------------------------XXX--------------------S------------------------------EX-------------------------------------------------------------------------------------------------------E----
--E--QQ--SSS--------------------<>---------<>----------E----------XXXXXXXX---------------------------------------XXX-------------SS-S---------------------------SS-S----SXSXSSS-------E----X-----XXX---------------XX-----------------------------------S-SS--E--QQ--SQQQ---------<>----
-<>--------------------E--------[]---------[]---E-----<><---------XXXXXXXX---XX-----------------------------------XX---------------------------------------------------------SSS---EX------------------------------------------------------------------------<>-------------------[]--E-
-[]--X----------------<>--------[]---------[]----<>---[]>--------XXXXXXXXX---XX-----------------------------------XX------------------------------------X--------------------SSS--------X-X------------------------------------------------------------------[]-------------------[]----
-[]---------------EE--[]--------[]---------[]----[]---[]EE-E----XXXXXXXXXX---X------------------------------------XX--------------------------------E---EE-------E-E----------S---------X-X-E-E----X---------------------E-------------E---------------------[]----------------E--[]----
XXXXXXXXXXXXXXXXXXXXXXXXXXXX--XXXXXXXXXXXXXXXXXXXXXXXXXXXXXXXXXXXXXXXXXXXXXX-X-XXXXXXXXXXXXXXXXXX-XXXXXXXXXXXXXX----------------------------XX-XXXXXXXXXXXXXXXXXXXXXXXXXXXXX-XXXXXXXX--XXXXXXXXXXXXXXXXXXXXXXXXXXXXXXXXXXXXXXXXXXXXXXXXXXXXXXXXXXXXXXXXXXXXXXXXXXXXXXXXXXXXXXXXXXXXXXXXX
