----------------------------X-----------------------------------------------------------------------------------------------------------------------------------------------------------------------------------------------------------------------------------------------------------
----------------------------------------------------------------------------------------------------------------------------------------------------------------------------------------------------------------------------------------------------------------------------------------
SSSSSSSSSSSSSSSSSSSSSSSSSSSSSSSSSSSSSSSSSSSSSSSSSSSSSSSS--------------------------------------------------------------------------------------------------------------------------------------------------------------------------------------------------------------------------------
SSSSSSSSSSSSSSS-----------SSSSS----SSSS-------------------------------------------------------------------------------------------------------------------------------------------------------------------------------------------------------------------------------------------------
SSSSSSSSSSSSSSS-----------SSS------SSS?-------------------------------------------------------------------------------------------------------------------------------------------------------------------------------------------------------------------------------------------------
SSSSSSSSSSS--SSS----------SS-S------S-?---------------S------------------------------------------X-------XX--X------------------------------------------------------------------------------------------------------------------Q-------------------------------------------------------
-S------------------------------------------------------------------------------------------------------------------------------XX------------------------------------------------------------------------------------------------------------------------------------------------XX----
--------------------------------------S----------------------------------------------------------------------------------------------------------------------------------------------XX-XXXX--------------------------------------------------------------------------------------------
----E------------------E--------------E------------SS-----------------------------------------------------------------------------------------------------------------------------------------------------------------------------------------------------------------------------------
--SSSSSSSSS--------E--<>---->--S-----[]---------E------X--------------------------------------------------------------------------------------------------QQ----------------------------------S----------------------------------------------XXXXX-------------------------XXX----------
--SSSSSSSSS-------<>--[]----SSSSSS---[]--------<>------X------------X----------------X--------------------------------------------------------------------------------------------E-----E---------------------------E-----------------------XX------------------------------------------
-SSSSSSSSSS-------[]--[]----SS?SS----[]--------[]------X------------X-------------------------------------------------------------------------------------------------------------E---------------------------------------------------------XX------------------------------------------
-SSSSSSSSSS-------[]--[]----SSSSS--S-[]--------[]------X--------E---X--------EE-EE--------------------------------------E----------------------------E--------------------E--E--E-S-----------EE-E-E----------E---------------E------------XXX-------E--E-------------------------------
XXXXXXXXXXXXXXXXXXXXXXXXXXXXXXXXXXXXXXXXXXXXXXXXXXXXXXXXXXXXXXXXXXXXXXXXXXXXXXXXXXXX-------XXXX------XX--------X-----XXXXXXXXXXXX-------X-XXXXXXXXXXXXXXXXXXXXX---------XXXXXXXXXXXXXXXXXXXXXXXXXXXXXXXXXXXXXXXXXXXXXXXXXXXXXXXXXXXXXX--XXXXXX---XXXXXXXXXXX--------XXXX----------------
