----------------------------------------------------------------------------------------------------------------------------------------------------------------------------------------------------------------------------------------------------------------------------------------
----------------------------------------------------------------------------------------------------------------------------------------------------------------------------------------------------------------------------------------------------------------------------------------
----------------------------SSSSSSSSSSSSSSSSSSSSSSSSSSSS----------------------------------------------------------------------------------------------------------------------------------------------------------------------------------------------------SSSSSSSSSSSSSSSSSSSSSSSSSSSS
--------------------------------------------------------------------------------------------------------------------------------------------------------------------------------------------------------------------------------------------------------------SSSSSSSSS-----------------
--------------------------------------------------------------------------------------XXXXXX----------------------------------E---------------------------E------------------------------------------------------------------------------XXX------------------SSSSSSSSS---------------S-
--------------------------------------------------------------------------------XXXX-----------------SSSSSSSSS-------------------------------------------------------------------------------------------------------------XX-------------------------------SSSSSSSSSSS--SSS----------SS
----------------------------------------------------------------------------------------------------------------------------------------------------------------------------------------------------------------------------------------------------------------------------------------
----------------------------------------------------------------------------------------------------------------------------------------------------------------------------------------------------------------------------------------------------------------------------------------
--------------------------------------E-----------------------------------------------------------------------------------------------------------------------------------------------------------------------------------------------S------------------------E------------------------
-------------XXXX--------------S----S<S--------------------------------------S-SS----XXXX---------X---XXXX-------------------------SSSSSSS-Q-----------------------------------------------------S-----------------XX-------------------------QQ----------E--SSSSSSSSSS--------E--------
-----------XXXX----------------S-----S---------<>------------------------------------------E---EXX------------------------------------------------------X------------------------------------------------------------------------------------------------<>---SSSSSSSS--------<>--------
----------XXXXX----------------S-----[]-----<>-[]------------------------------------------X--------------------------------------------------X---------X------------------------------------------------------------------------------------------------[]---SSSSSSSS--------[]--------
---------XXXXXX---------E---E-----E--S------[]-[]--------------------------------------------------X--------------------E---EE-------E-E------------E---XE-------E-E------E--E-EE-E-E----------E-EE--------------------------------------E---------------[]----SSSSSSS--------[]------XX
XXXXXX---XXXXX-----X-X--X---XXXXXXXXXXXXXXXXXXXXXXXXXXXXXXXXXXXXXXXXXXXXXXXXXXXXXXXX---------------XXXXXXXXXXXXX-----XXXXXX-XXXXXXXXXXXXXXXXXXXXXXXXXXXXXXXXXXXXXXXXXXXXXXXXXXXXXXXXXXXXXXXXXXXXXXXX--------XXXX----------------XXXXXXXXXXXXXXXXXXX-XXXXXXXXXXXXXXXXXXXXXXXXX--------XX-
