----------------------------------------------------------------------------------------------------------------X-----------------------------------------------------------------------------------------------------------------------------------------------------------------------
-------------------------------------------------------------------------------------------------------------------------------E----SSS----S--------------------------------------------------------------------------------------------------------------------------------------------
------------------------------------------------------------------------------------------------------------------SSSSSSSSSSSS<>----SSS--SSS----------------------------------------------------------------------------------------------------------------SS-----------------SSSSSSSSS
---------E-------------------------------------------------E---------------------S-S------------------------------SSSSSSSSSSSSSS----SSSSSSSS--------------------------------------------------------------------------------------------------------------------------------------------
---------XXX---------------------------------------------XXXXX---------------E---SSS-------XX------------------->SSSSSSSSS----SS----SSSSSSSS--------------------------------------------------------------------------------------------------------------------------------------------
-------------QQ--------------------------------S--SSSS--?--S-------------??SSSS-----X-----------------XX--------?--SSSSSSSS--SSS---SSS-----S----------------SSS-------------------------SS----------------------------------------------------------------------------------------------
----------------------------------------------------------------------------------------------------------------------------------------------------------------E----------------------XX-----------------------------------------------------------------------------------------------
------------------------------------------------------------------------------------------------------------------------------------------------------------E----E---------------------XX-----------------------------------------------------------------------------------------------
----SSSSS--------------------------------------------------X------------------------XXXXXX--------------------E-X??E-----------------------------E---------<>---->--------------------XXXE---------------E----------E-------------------------------------------------E-----------------
------------QQQQ----------E--XXXX-------------XX-X-------XXXXS--------X----XXX----XX------------XXX----------<>---S?SSSSSS---EE----E-----XXX-E--<>---------[]----------E-E---------X--XXX---------------<E---------<>----------E--------------------------SS-----S---<>-----E-----------
-------------------------<>---------------X--------------------X---EXX------------XX-------------------------[]-----SSSSSS-EX-----<>-----X--<>--[]---------[]----X----<><>---E--------XXX----X-----E----[]---------[]---------<>-------------------------------------[]----<>---E------X
-------------------------[]----------------------------------XSX--------X------------------------------------[]----SSSSSS-------X-[]-----XX--]--[]---------[]---<>----[]-]----------XXXXX----X-----[----[]---------[]----<----[]-------------------------------------[]----[]--<>-----XX
---------E---------------[]--------------------------------------------XX---XXX------------------------E--E--[]------S----------X-[]E-E--XXX[]--[]-----E-E-[]---[]----[][]-EE------EXXXXX----X-----[-E--[]-----E-E-[]----[----[]-------------------------------------[]----[]--[]----XXX
XXXXXXXXXXXXXXXXXXX----XXXXXX-------XXX-----------------XXX---XX--------------------------XX-------XXXXXXXXXXXXXXXX--XXXXXX-----XXX-XXXXXXX-XXXXXXXXXXXX--XXXXXXXXXXXXXXXXXXXXXXXXXX--XXX---XXXXX-XXXXXXXXXXXXXX--XXXXXXXXXXXXXXXX---XXXXX----XXXXXXXXXXXXXXXXXXXXXXXXXXXXXXXXXXXXXXXXXX
