----------------------------------------------------------------------------------------------------------------------------------------------------------------------------------------------------------------------------------------------------------------------------------------
----------------------------------------------------------------------------------------------------------------------------------------------------------------------------------------------------------------------------------------------------------------------------------------
-----------------------------------------------------------SSSSSSSSS-------------------SSSSSS-----------------------------------------------SSS-------------------------------------------------------------------------------------------------------------SSSSSSSSSSSSSSSSSSSSSSSSSSSS
----------------------------------------------------------SSSSSSSS--------------------SS-SSSSSSS---------------------------------------------------------------------------------------X---------------------------------------------------------------------------SS-------------------
-E-XXXXX---------------------------------------------------SSSSSSS---------------------S--SSSSS--------------------------------------------------------------------------------------------------------------------------------------------------------------------SSS------------------
S----------------SSS--SSS-------------------------------SSSSSSSSSSS--SSS----------SS-SSSSSSSSSSSS-SS-----------S--------------------------------------S--------------------------------E----------------------------S-S--------------------------------X-----SSSS--SSS----------------S-
--------------------------------------------------------------------------------------------------------------------------------------------------------------------------------------XX------------------------------------------------------------------------------------------------
--------------------------------------------------------------------------------------------------------------------------------------------------------------------------------------XX------------------------------------------------------------------------------------------------
-----------------------------------------------------------E----------------------------E------------------E------------------------------------------E------------E----------------XXXX-------------------------------------------------------------------------------------------SS---
XXXX-------------XXXXX------------------------------------SSSSSSSS---------E------------SSSSSSSS----------<>------------------XXXX------------E--S---<>-----------<>----------------XXXX-----------------E---------<>----------E--------------XXXXXX--------SSSSS--SS----------E--------
-----------EXXXXX---------------------E---------------------SSSSS---------<>----------E-------------------[]---------------------------------<>------[]-----------[]--------------XXXXXX----------------<>---------[]------E--<>-----------------------------------SS---------<>--------
------XX------------------------------>--------------------SSSSSS---------[]---------SS---------------<---[]---------------------------------[]------[]-----------[]-------------XXXXXXX----------------[]---------[]-----<>--[]-------------------------------S--SSS-------XX[]X-------
-----------------------------------E-[]--------------EE-------------------[]E----------------E--------[]--[]---------------------------------[]------[]-----------[]------------XXXXXXXX--------E--E-E--[]-----E-E-[]-----[]--[]----------------------------------SS----------[]X-------
----------------------------XXXXXXXXXXXXXXXXXXX--XXXXXXXXXXXXXXXXXXXXXXXXXXXXXXXXXXXXXXXXXXXXXXXXXXXXXXXXXXXXXXX---------XXX----------------XXXXXXXXXXXXXXXXXXXXXXXXXXXXXXXXXXXXXXXXXXXXXXXXXXXXXXXXXXXXXXXXXXXX---XXXXXXXXXXXXXX---XX---XXXXXX--XXXXXXXXXXXXXXXXXXXXXXXXXXXXXXXXXXXXXXX
