----------------------------------------------------------------------------------------------------------------------------------------------------------------------------------------------------------------------------------------------------------------------------------------
----------------------------------------------------------------------------------------------------------------------------------------------------------------------------------------------------------------------------------------------------------------------------------------
--------------------------------------------------------SSSSSSSSSSSSSSSSSSSSSSSSSSSS-------------------SSSSSSSSS---SSSSSSSSS--SS----SS--------------------------------------------------------------------------------------------------------------------------------------------------
------------------------------------------------------------------------------------------------------------------SSSSSSSSSSSSSS----S------S--------------------------------------------------------------------------------------------------------------------------------------------
-------------------------------------------------------------------------------------------------------------------SSSSSSS----SS-----S----SS--------------------------------------------------------------------------------------------------------------------------------------------
-------QQSSS-----------------------------S-----X----------------S-----------------------------------------------S-SSSSSSSSS--SSS----S-----------------------SSS----------SSSSSSSSSS--SSS--------SSSS----------------------------------SSSSSS----------------SSSSSSSSSS-----S---S--------
----------------------------------------------------------------------------------------------------------------------------------------------------------------------------------------------------------------------------------------------------------------------------------------
----------------------------------------------------------------------------------------------------------------------------------------------------------------------------------------------------------------------------------------------------------------------------------------
-----------------------------XXXXX--------------------E---------------------------------------E---------------------E------------------E--?-----------------XE------------------------------------------------------XE---------------------------------E------EE------------------------
-----SQ---S-----------<-----------------XX-----------<--SSSSS---S----------------------------<>--------------------?SSSSSS---------E--<>----<E---E----------X--------------SSSSSSS-------------------E--------------X-------------E--SS--SSS----------<>------SSS--------------X--------
-----------------------E-----------------------------[]--------S-----------XX----------------[]---------E-----------SSSS----------<>--[]----<>--<>---X-----XX----X-----E----------------------------<>-------E-----XX----X-------<>-------------------[]-----------E---------------E----
----------------------[]-----------------------------X]-------<>--------XXXXX----------------[]--------<>----------SSSS-----------[]--[]----[]--[]------XXXXX----XX---<>------------------<>--------[]----------XXXXX----XX------[]-------------------[]----------------------X---<>----
------------------E---[]--------------------------------------[]--------[X-XX----------------[]--------[]-------------------------[]E-[]----[]--[]------XXXXX----XX---[]------------------[]E-------[]----------XXXXX----X-------[]---------------E---[]----------------------X-E-[]-X--
XXXXXXXXXXXXXXXXXXXXXXXXXXXX----XXXXX-------XXXXXXXXXXX-XXXXXXXXXXXXXXXXXXXXXXXXXXXXXXXXXXXXXXXXXXXXXXXXXXXXXXXXXXXXXXXXX-XXXX-XXXXXXXXXXXXXXXXXXXXXXXXX---XX---XXXXXXXXXXXXXXXXXXXXXXXXXXXXXXXXXXXXXXXXXXXXXXXXXXXXXX-XXXXXXXXXXXXXXXXXXXXXXXXXXXXXXXXXXXXXXXXXXXXXXXXXXX-XXXXXXXXXXXXX
