----------------------------------------------------------------------------------------------------------------------------------------------------------------------------------------------------------------------------------------------------------------------------------------
----------------------------------------------------------------------------------------------------------------------------------------------------------------------------------------------------------------------------------------------------------------------------------------
----------------------------------------------------------------SSSSSSSS----------------------------------------------------------------------------------------------------------------------------SSSSSSSSSSSSSSSSSSSSSSSSSSSS----------------------------SSSSSSSSSSSSSSSSSSSSSSSSSSSS
-----------------------------------------------------------------------------------------------------------------------------------------------------E----------------------------------------------SSSSSSSSSSSS------------------------------------------------------------------------
-----------------------------------------------------------------------------------------------------------------------------------------------------XXX--------------------------------------------SSSSSSSSSSS---------------S---------------------------------------------------------
------SSSSSSS------------------------------------------------------------XX-------------------?SS---------------------------------------------------------------------------------------XX----------SSSSSSSSSSS--SS---------------------------------------------------------------------
------------------------------------------------------------------------XXX-----------------------------------------------------------XXXX---------------------------------------------XXX----------------------------------------------------------------------------------------------
------------------------------------------------------------------------XXX----------------------------------------------------------------------------------------------------------XXXXX-----------------------------------------------------------------------------------SX---------
-----------------------E-----------------------------------------------XXXX-------------------E------------E--------------------------------------S-S--------------------------------XXXXX----------------------------------------------------------------------------------XXXS--------
--E--SSSSSSS----------<>------------------XXX---------------------X-----XXXX--X-------E--QQ--S?-----E-----<>--------------------XX------------------------QQ---------QQ-----------XXXXXXXX-----------SSSSSSSSSS--------E-------X------------------------------------Q-S------X----X-----
-<>-------------------[]--------------------------------E------------XX-XXX---X------<>-------]----<>---E-[]--------------------------------------E---E---------------------------XXXXXXXX---X--------SSSSSSSSS-------<>-------X----------E-----------------[---------------XX----X-----
-[]-------------------[]--------------------------------]-----------XXXXXXXX--X------[]--X---------[]-----[]-----------------------------------------<>--------------------------XXXXXXXXX---X--------SSSSSSSSS-----XX[]-------X---------<>----------------->------------XXXXX-X--X----X
-[]---------------EE--[]------------------------------E-]--E--------XXXXXXXX--X------[]------E]----[]-----[]-----------------------------------------[]-----------------EE-E----XXXXXXXXXX---X-----X--SSSSSSSS------X-[]-----XXX---------[]---------------E-E]-E--E-----XXXXXX-X--X----X
XXXXXXXXXXXXXXXXXXXXXXXXXXXXXXXXX-----XXXXX----XXXXXXXXXXXXXXXXXXXXXXXXXXXXXXXXXXXXX--XXXXXXXXXXXXXXXXXXXXXXXXXX--------XXX-----------------XXXXXXXXXXXXXXXXXXXXXXXXXXXXXXXXXXXXXXXXXXXXXXXXXXXXXXXXXXXXXXXXXXXXXXXXXX--------X-XXXXXXXXXXXXXXXXXXX--XXXXXXXXXXXXXXXXXXXXXXXXX----XXXXXX
