----------------------------------------------------------------------------------------------------------------------------------------------------------------------------------------------------------------------------------------------------------------------------------------
----------------------------------------------------------------------------------------------------------------------------------------------------------------------------------------------------------------------------------------------------------------------------------------
-----------------------------------------------------------------------------------------------------------------------------------------------------------------------------------------------------------------------SSSSSSSSS--------------------------------------------------------
----------------------------------------------------------------------------------------------------------------------------------------------------------------------------------------------------------------------------------------------------------------------------------------
----------------------------------------------------------------------------------------------------------------------------------------------------------------------------------------------------------------------------------------------------------------------------------------
-------------------------------------------XXX---------------------?SS-----------------------------X---------------------------------------------------------------XX-------------------XX----------------------------------------X--------------------------------------QQ---------XXXX
------------------------------------------XXXX----------------------------------------------------XX-----------------------------------------------------------------------------------XXX----------------------------------------------------------------------------------------------
-----------------------------------------XXXXX----------------------------------------------------XX---------------------------------------------------------------------------------XXXXX----------------------------------------------------------------------------------------------
----------------------------------------XXXXXX------------------------------------EX------------X-XX-----------------E---------->---------------------------------------------------XXXXXX--------------------E-------------------------------------------------------------------------
-----------QQQ-Q----------------------XXXXXXXX-----------X-------------------------------------X--XX---------------------------[]----------EQ--------------------------------------XXXXXXX---------------S---<>-----E--------------------------------SSSSS--------------QQQQ-------SS---
--------------------------E-----------XXXXXXXX---X-----<-X-----------------------E-------------XXXXX-----E-----<-----E---------[]---------<>--------------EXXX--------------------XXXXXXXX---X---------------[]----<>---E---------------------------------------------------------------
-------------------------<-----------XXXXXXXXX---X-----[--X-----------------------------------XXXXXX-----X-----[----<>---------[]---------[]-------------------------------------XXXXXXXXX---X---------------[]----[]--<>------X--------------------------------------------------------
-------------------------[]-EE-E----XXXXXXXXXX---X-----XXXX--------------------------E-EE---XXXXXXXX-----X-----[----[]---E-----[]---------[]----------------------------EE-E----XXXXXXXXXX---X-----X---------[]----[---[]------X-------EE--------------E-------------E------------------
XXXXXXXXX--XXXXXXXXXXXXXXXXXXXXXXXXXXXXXXXXXXXX-XXXXX-XXXXXXXXXXXXX---XXXXXXXXXXXX--XXXXXXXXXXXXXXXXXXXXXXXXXXXXXXXXXXXXXXXXXXXXXXXXXXXXXXXXX----------X----------------XXXXXXXXXXXXXXXXXXXXXXXXXXXXXXXXXXXXXXXXXXXXXXXXXXXXXXXXXXXXXXXXXXXXXXXXXXXXXXXXXXXXXXXXXXXXXXXXXXXXXXXXXXXXXX-X
