----------------------------------------------------------------------------------------------------------------------------------------------------------------------------------------------------------------------------------------------------------------------------------------
------------------------------------------------------------------------------------------------------------------------------------------------------------------------------------------------------------------------------------------------------S---------------------------------
----------------------------------------------------------------------------------------------------------------------------------------------------------------------------------------------------SSSSSSSSSSSSSSSSSSSSSSSSSSSSSSSSSSSSSSSSSSSSSSSSSSSSSSSS----------------------------
-------------------------------------------------------------------------------------------------------------------------E----------------------------------------------------------------------------S----SSSS-----------------SSSSSSSSSS-SS--------SSSSSSS----------------------------
-------------------------------------------------------------------------------------------------------------------------XXX-------------------------------------------------------------------------------SSSS-----------------SSSSSSSSSS?---------SSSSSSSS----------------------------
------------SS-----------------------------E------------SS--------------------------X---SSSSSSSSS----------------------------QQ---------XSXX---------------------------------------------XXX-----------S--SSSSSS--------------SSSSSSSSSSSS---SS--------S--SS----------------------------
----------------------------------------------------------------------------------------------------------------------------------------------------------------------------------------------------------------------------------------------------------------------------------------
------------------------------------------XX----------------------------------------X-------------------------------------------------------------------------------------------------------------------------S-------------------------------------------------------------------------
---XXXX-------------------XX--------------XX------------------------------X------------------------------------------SSS----------------------------------------------------XXX-------------------E-----E-----S------------SS----?-E-------------------SS-------------------------------
--------------------S-------------------X-X-------------QQQ---------------X---------------SSSS--?SS----------X-------------E-QQQQ------SSS-------------------------------X-----------------------<>----S-SS--SS----------------XSSSSSSSSS----------E?------XSQQX--------------XX--------
-X------------------------------------XXXXXX---------------------------XXXXX---------------------------------XX----------------------------------------------------------------------------------[]--SE------SS--------<E------X----SSSSSS--------<>---------------E----XXX-------------
--------------------------------------XXXXXX------------]--------------XXXXX---------------------------------XX----------------------------------------------------------------------------------[]-SS?S-S---SS--------[]----------SSSSSS-------XX[]X-------------XX--------------------
XXX---------------------------------XXXXXXXX--------E--E]--------------XXX------------------------------E-E--XX----------E--------E---------------------------------------X----------------------[]--[]------SS--------[]------X---SSSSSS-------XX[]X------X---------------X------------
------XXXXX---XXXXXXXXXXX---XXXXXXXXXXXXXXXXXXXXXXXXXXXXXXXXXXXXXXXXX---------------XXXXXXXXXXXXXX--XXXXXXXXXXX-XXXXXXXXXXXXXXXXXXXX---XXXXX---XXXXXXXXXXXXXXXXXXXXXXXXXXXX--XXX---------XXXXXXXXXXXXXXXXXXXXXXXXXXXXXXXXXXXXXXXXXXXXXXXXXXXXXXXXXXXXXXXXXXXXXXX-----XXX---XXX--XXX-XXX-
