----------------------------------------------------------------------------------------------------------------------------------------------------------------------------------------------------------------------------------------------------------------------------------------
----------------------------------------------------------------------------------------------------------------X-------------------------------------------------------X---------------------------------------------------------------------------------------------------------------
----------------------------------------------------------------------------------------------------------------SSSSSSSSSSSSSSSSSSSSSSSSSSSS--------------------------------------------------------------------------------------------------------------------------------------------
----------------------------------------------------------------------------------------------------------------------------------------------------------------------------------------------------------------------------------------------------------------------------------------
----------------------------------------------------------------------------------------------------------------------------------------------------------------------------------------------------------------------------------------------------------------------------------------
---------------X--------------------------------------X--XXX----------------------------------------------------------------------------------XX----------------------------------------SSS------------------------X--------------------------------------------------------------------
--------------XX----------------------------------------------------------------------------------------------------------------------------------------------------------------------------E---------------------EX--------------------------------------------------------------------
--------------XX---------------------------X-------------------------------------------------------------------------------------------------------------------------------------------------E--------------------XXXXXX----------------------------------------------------------------
------------XXXX--------------------------XX------------------------------------------------------------------------------E------SSS----------------------------------------------------E-----------------------X-------------------------------E---------------------------------------
------------XXXX-----------E------------XXX--------------------------------------------------Q------E-----------<>---S---<>-----------X---------------------------------->---E---------<>----------E---------------------------------E---------<>----------E----------------------------
----------XXXXXX----------<>----------XXXXXX------------------------X------------------------------<>-----------[]--<>---[]----------XX----E----------------------------[]--<>---E-----[]----X----<>-----E-----X---------E-----<----<>---------[]---------<>----------------------------
---------XXXXXXX----------[]---------XXXXXXX------------------------X------------------------------[]-----------[]-------[]---X-E--E-XX---<>----------------------------[]--[]---------[]----<>---[]--------------------<>-----[----[]---------[]----<>---[]----------------------------
-E-E----XXXXXXXX----------[]--------XXXXXXXX------E-E-----------E---X--------E-E-------------------[]-----------[]--E----[]--XX------XX---[]--E---E-E-E-E---------E-----[]--[]-----E-E-[]----[]---[]-EE-EEE-E-EE--EE----[]-----[-E--[]-----E-E-[]----[]---[]-------------------------EE-
XXXXXXXXXXXXXXXXXXXX-XXXX-XXXXXXXXXXXXXXXXXXXXXXXXXXXXXXXXXXXXXXXXXXXXXXXX--XXX-XXXXXXXXXXXXXXXXXXXXXXXXXXXXXXXXXXXXXXXXXXXXXXXXXXX--XXXXXXXXXXXXXXXXXXXXXXXXXXXXXXXXXXXXXXXXXXXXXXX---XX---XXXXXXXXXXXXXXXXXXXXXXXXXXXXXXXXXXXXXXXXXXXXXXXX---XXXXXXXXXXXXXXXXXXXXXXXXXXXXXXXXXXXXXXXXX
