----------------------------------------------------------------------------------------------------------------------------------------------------------------------------------------------------------------------------------------------------------------------------------------
---------------E-----------S--------------------------------------------------------X-----------------------------------------------------------------------------------------------------------------------------------S---------------------------------------------------------------
--------------<>-----------S--------------------------------------------------------------------------------------------------------------------------------------------SSSSSSSSSSSSSSSSSSSSSSSSSSSS---SSSSS------SS----SS--------------------------------------------------------------
-EEE----------[]-----S---S-S---------------------------------------------------------------------------------------------------------------------------------------------------------------------------SSSSSSSSSSSSS----S-----SS--------------------------------------------------------
-XXXXXXXX-----[]-----E---SSS---------------------------------------------------------------------------------------------------------------------------------------------------------------------------SSSSSSSS-S-SS----SS----SS--------------------------------------------------------
?-----?----------??SSSS---------------SSSS------------------------------------------------------S---SSS---------------------------------------------------------------XX-SSS---SS----------------------SSSSSSSSSSSSS----SS----SS------------XXX-----------------------------------------
--------------------------------------------------------------------------------------------------------E-------------------------------------------------------------------------------------------EE--------------------------------------------XXX-----------------------------------
---E-------------------------------------------------------------------XXXXX-------------E---------------E------------------------------------------------------------------------------------------------------------------------------------------------------------------------------
X--X------------------------XXXXXX--------------------E----------------------------------E----------E---------------------------------------------------------------------------------------------------E-------------------------------------------------XX----------------------------
-XXXXS--------E----XXX---XXX-------S?--SSSS----------<>---------------------------------<>---------<>----------E-------------------------------------------------SSSSSS-SSSSS--SSSS---------E----------?SSSSSS----------------X--X--------------------------X-----------------X---------
------SX---EXX------------XX-------------------------[]-------------X--------------<----[]---------[]----X----<>-----E----------E------------------------------------------SS---SSS--------<>------X-----------------------E-----X----------------------------------------XXXX----------
-----SSX--------X--------XX--------------------------[]-------------X--------------[----[]---------[]---<>X---[]----<>---------<>------------------------------------------S---SSSS-----<>-XX------X-----X------------<---<>----XXX-----------------------------------------------------
---------------XX---XXX------------------------E-----[]--EE--EE-EXXXX-EE--------E-E[[E--[]-----E-E-[]---[]]---[]----[]-----E---[]----------E-------E--E-----------------E-SSS-ESSSS-----[]-[-----XXX------------------E]E-[]-X--XXX-----------------------------------------------------
------------------------------XXXXXXX---XXXXXXXXXXXXXXX-XXXXXXXXXXXXXXXXXXXXXXXXXXXX-XXXXXXXXXXX---XX---XXXXXXXXXXXXXXXXXXXXXXXXXXXXX-XXXXXXXXXXXXXXXXXXXXXXXXXXXXXXXXXXXXXXXXXXXXXXXXXXXXXXXXXXXXXXXXXXXXXXXXXXXXXXXXXXXXXXXXXX-------XXXX----X-----XXXX--XXX--XX----XX----------------
