X---------------------------------------------------------------------------------------------------------------------------------------------------------------------------------------------------------------------------------------------------------------------------------------
--------------------S------S------------------------------------------------------------------------------------------------------------------------------------------------------------------------------------------------------------------------------------------------------------
S-SSSSSSSSSSSSSSS---SSSS-SSS---------------------------------------------------------------------------------------------------------------------------------------------------------------------------------------------------------------------------------------------------SSSSSSSSS
--SSSSSSSSSSSSSS----SS---SSS------------------------------------------------------------------------------------------------------------------------------------------------------------------------------------------------------------------------------------------------------------
---SSSSSSSSSSSSS----SSS--SSS------------------------------------------------------------------------------------------------------------------------------------------------------------------------------------------------------------------------------------------------------------
---SSSSSSSSSSSSS----SS----SS-------------------------------------------------------------------------------------------------------------------X------------------------------------------SS--------S---------------------SSS-----------------------------------------------------------
EE-S------------------------------------------------------------------------------------------------------------------------------------------------------------------------------------------------------------------------------------------------------------------------------------
----------S-----------------------------------------------------------------------------------------------------------------------------------------------------------------------------------------------------------------------------------------------------------------------------
----E-----S------------E----------------------------------------------------------------------E----------------------------------XX---------------------------------------XXXX------------------------------------------------------------------------------------------------S---------
--E-SSSSSSSS----------<>---------------------------------------------------------QQ------Q---<>-----E-------------------Q-------XX--------------------------------------------------XXX----------X--QQQ---------------E--------------------QQQQQ----------------------------E-----------
--E-------------------[]--------------------E------------------------------------------------[]----<>---E-----------------------XX---------------------------------------------------------------XX---------------EXXXXX----------------------------------------------------------------
-SS--X------------[---[]-------------------<>------------------------------------------------[]----[]--<>-----XX--------------XXXXX--------------------------------------------------------------XX-------------------------------------------------------------------------E-----------
-[]------E--------[]E-[]--------EE----EE---[]----------E-------E-E---------------EE----------[]----[]--[]-----XX-------------XXXXXX-----------------------------------------------------------E--XX----------------------------------------------------------------------E--------------
XXXXXXXXXXXXXXXXXXXXXXXXXXXXXXXXXXXXXXXXXXXXXXXXXXXXXXXXXXXXXXXXXXXXXXXXXXX--XXXXXXX-XXXXXXXXXXXXXXXXXXXXXXXXXXXXXXXXXXX-XXXXXXXXX-XXXXXXXXXXXXXXXXXXXXX--XX-----XXXXXXX--X---XXX----XXXXXXXXXXXXXX-XXXXXXXXXXXXX---------------XXXXXXXXXXXXXXXXXXXXXXXXXX--XXXXXXXXXXXXXXXXXXXXX--XXXXX
