----------------------------------------------------------------------------------------------------------------------------------------------------------------------------------------------------------------------------------------------------------------------------------------
----------------------------------------------------------------------------------------------------------------------------------------------------------------------------------------------------------------------------------------------------------------------------------------
--------------------------------------------------------SSSSSSSSSSSSSSSSSSSSSSSSSS------------------------------------------------------------------------------------------------------------------------------------------------------------------------------------------------------
----------------------------------------------------------------------------------------------------------------------------------------------------------------------------------------------------------------------------------------------------------------------------------------
----------------------------------------------------------------------------------------------------------------------------------------------------------------------------------------------------------------------------------------------------------------------------------------
----------QQQ---------------------------------------XXXX---------------------------------------------------------S------------------------------------------XS----------X----------------------------------Q--QQQ-------------------------------------------X---S?--EQSSSSS-------------
-----------------------------------------------------------------------------------------------------------------------------------------------------------XX---------------------------------------------------------------------------------------------------------------------------
-------------------------------------------------------------------------S-------------------------------------------------------------------------------XXXX----E------------------------------------------------------------------------------------------]---------------------------
------------------------------------------------------------------------XSSS----------------------------------------------------------------------------XXXXXE---------------E----------E-------------------------------------------------------------------XXX-----------------------E-
------Q---QQQQQQQQ-----------X------------------SSSSSSSS<>------Q--------X----X---------------------------------------------------X----------E---------XXXXXX----------E----<>---------<>---------------E-Q---QQQ--?Q------------------------XXX-------------------S?--SSSS----------<>-
-------------------------<------------------------------[]-------E-------]----X-----------------------X------------------------XXXX---------<>---E---XXXXXXXX----X----<>----[]---------[]------E--E-----------------------------------------XXXX-------------------------------------[]-
-------------------------[------------------------------[]----------XXXXXX---XX----X----------------X-X------------------------XXXX--------X[]--<>---X-XXXXXX----XX---[]----[]---------[]-----<>-----------------------------X------------XXXXXX-------------------------------------[]-
-------------------E-----[]--------E-E------------------[]----------XXX-XX----X----X----------------XXX-----------------------XXXXX-------XX[]--[]------XXXXX----X----[]----[]---------[]-----[]-----------------------------X-----------XXXXXXX--------E----------------------EE-E--[]-
XXXXXXXXXXXXXXXXXXXXXXXXXXXX---XXXXXXXXXXXXXXXXXXXXXXXXXXXXXXXXXXXXXXXXXXX--XXXXXXXXXXXXXXXXXXXXXXXXXXXXXXXXXXXXXXXXXXXXXXXXXXXXXXXXXXXXXXXXXXXXXXXXXXXX---XX---XXXXX-XX-XXXXXXXXXXXXXXXXXXXXXXXXXXXXXXXXXXXXXXXXXXXXXX------XXXXXXXXXXXXXXXXXXXXXXX-X--X------XXXXXX---XXXXXXXXXXXXXXXX
