----------------------------------------------------------------------------------------------------------------------------------------------------------------------------------------------------------------------------------------------------------------------------------------
----------------------------------------------------------------------------------------------------------------------------------------------------------------------------------------------------------------------------------------------------------------------------------------
SSSSSSSSSSSSSSSSSSSSSSSSSSSS--------------------------------------------------------------------------------------------------------------------------------------------------------------------------------------------------------------------------------SSSSSSSSSSSSSSSSSSSSSSSSSSSS
------------------------------------------------------------------------------------------------------------------------------------------------------------------------------------------------------------------------------------------------------------SSS----SSSS-----------------
----------------------------------------------------------------------------------------------------------------------------------------------------------------------------XXX------------------------------XXX---------------------------------------------------SSSS-----------------
---------------------------------------------XXXXXXX--------------------------------------------------------------------------------------------------------------------E----------------------------------------QQ---------SSSXX---SSSSQQSSSSS----------------S---SSSS---------------S-
----------------------------------------------------------------------------------------------------------------------------------------------------------------------------------------------------------------------------------------------------------------------------------------
-----------------S-----------------------------------------------------------------------------------------------------------------------------------------XXXXX----------------------------------------------------------------]-------------------------------------S-----------------
----------E------SSS------------X-X----------------------------------------------------------------------------------------------------------------------------------------------------------------------SS---------------------X-X-----------------------E-----E-----E------------SS---
<>-S----S<>------X--X------X-----------------------------------------------------SS--------------XXXX-------------------------------------------------------------------X---------------XXXX-------------------EQQQQQQ------S---------SS?S-SSSS----------<>----SSS-SSSSS--------E-------
[]--------]------X-XX-X----X---------------------------------------------------------------------X------------------------E--------------------------------------E------X------------XXXXX-X-------------------------------------------------------------[]-SSSSSS--SSS--------<>------X
[]-------[]---X-<>-XX------X--------------------------------------------------------------------XX-----------------------<>--------------------------------------------[---------------------------------------------------------------------------------[]-SSSSSSSSSSS--------[]-------
S-----E--[]--EX-[]-XX------X-----------------------------------E-EE----------------------------XXX----------E------------[]--------------EE--EE-E---E-EEE-EE--------EE-[-------------------------------------E--------E----------------------------EE-E--[]-SSSSSSSSSSS--------[]-------
XXXXXXXXXXXXXXXXXXXX--XXXXXX------------------XXX-------XXXXXXXXXXXXXXXXXXXXXXXXXXXX---XX---XXXXXX-----X-X--X---XXXXXXXXXXXXXXXXXX----XXXXXXXXXXXXXXXXXXXXXXXXXXXXXXXXXXXXX-------XX--------------X-XXXXXXXXXXXXXXXXXXXXX--XXXXXXXXXXXXXX---XXXXXXXXXXXXXXXXXXXXXXXXXXXXXXXXXXXXXXXXXXXX
