----------------------------------------------------------------------------------------------------------------------------------------------------------------------------------------------------------------------------------------------------------------------------------------
----------------------------------------------------------------------------------------------------------------------------------------------------------------------------------------------------------------------------------------------------------------------------------------
----------------------------SSSSSSSSSSSSSSSSSSSSSSSSSSSS--------------------------------------------------------------------------------------------------------------------------------------------------------------------------------------------------------------------------------
----------------------------------------------------------------------------------------------------------------------------------------------------------------------------------------------------------------------------------------------------------------------------------------
-----------------------------------------------------------------------------------------------------------------------------------------------------------------------------------------------------XXXXXXX----------------------------------------------------------------------------
---------------X--------------------------------------------------------------------------------------------------------------------------XX------------------------XXXX---------------------------------------------SSSS-------X----------SS-------------------------------------------
--------------XX------------------------------------------------------------------------------------------------------------------------------------------------------------------------------------------------------------------------------------------------------------XXXX--------
--------------XXX-----------------------------------------------------------------------------------------------------------------------------------------------------------------------------------------------------------------------------------------------------------------------
------------X-XX----------------------E-------------------------------------------------------------E--------------------------------------------------------------------------------------------------------------------------------------------------E--------------------------------
-----------X---------------->--S-----<>--------------------------------X----------------EQQ---QQQ--QQ--------------------------------SSSSS-------------------------SS----------------------------SSSXXXXX-------------XXXX---XXX-----E---E------E-----<>---E--------------------------SS
-----------XXXX------E-----<---S-----[]--------<>---------------------------------E---------------------------------------E---------------------------E----------------------------------------------------E---EXXX-----------------<>---------<>-----[]--<>-E--------------------------
---------------X----<>-----[S--S-----[]--------[]--------------------------------<>--------------------------------------<>-------------------------------------------------------------------------------XX------------------------[]---------[]-----[]--[]XXX-------------------------
-E--EE--XXXE--EX----[]-----[S-----E--[]--------[]--------------------------------[]-------------------E----------------E-[]---------------------------E-------------------------E---EE-------E-E-------------------X----------------[]---------[]-----[]--[]XX--------------------------
XXXXXXXXXXXXXXXXXXXXXXXXXXXXXXXXXXXXXXXXXXXXXXXXX--XXXXXXXXXXXX---XXXXX----XXXXXXXXXXXXXXXXXXXXXXXXXXXXXXXXXXXXXXXXXXXXXXXXXXXXXXXXXXXXXXXXXXXXX-XXXXXXXXXXXXXXXX----XXXXXXXXXXXXXXXXXXXXXXXXXXXXXXXXXX------------XXXXXXXXXXXXX--XXXXXXXXXX-X-XXXXXXXXXXXXXXXXXXXXXXXX-XXXXXXXXXXXXXXXX
