----------------------------------------------------------------------------------------------------------------------------------------------------------------------------------------------------------------------------------------------------------------------------------------
----------------------------------------------------------------------------------------------------------------------------------------------------------------------------------------------------------------------------------------------------------------------------------------
--------------------------------------------------------SSSSSSSSSSSSSSSSSSSSSSSSSS--------------------------------------------------------------------------------------SSSSSSSSSSSSSSSSSSSSSSSSSSSS-------------------SSSSSSSSS---SSSSSSSSS--SS----SS----------------------------------
----------------------------------------------------------------------------------------------------------------------------------------------------------------------------------------------------------------------------------SSSSSSSSSSSSSS----S------S----------------------------
-----------------------------------------------------------------------------------------------------------------------------------------------------------------------------------------------------------------------------------SSSSSSS----SS-----S----SS----------------------------
------------------------------------------------------------------------X------------XXX-------------------------------QQSSS-----------------------------S-----X----------------S-----------------------------------------------S-SSSSSSSSS--SSS----S-----------------------SSS---------
------------------------------------------------------------------------X---------------------------------------------------------------------------------------------------------------------------------------------------------------------------------------------------------------
----------------XXXX----------------------------------------------------XX--------------------------------------------------------------------------------------------------------------------------------------------------------------------------------------------------------------
------------------------------------------------------------------------XX-S-----------------------------------------------------------------XXXXX--------------------E---------------------------------------E---------------------E------------------E--?-----------------XE----------
--------------------------------------------------------<>---------XXX--X-----X---------------------------SSSSSS-----SQ---S-----------<-----------------XX-----------<--SSSSS---S----------------------------<>--------------------?SSSSSS---------E--<>----<E---E----------X-----------
---------------------------------------XXX--------------[]-------X--XXX-X----XX----E---------------------------------------------------E-----------------------------[]--------S-----------XX----------------[]---------E-----------SSSS----------<>--[]----<>--<>---X-----XX----X-----E
---------------------------------------XXX--------------[]-------X--XXXXXX---XX---<>--------------------------------------------------[]-----------------------------X]-------<>--------XXXXX----------------[]--------<>----------SSSS-----------[]--[]----[]--[]------XXXXX----XX---<>
--E---E-E-EEE-E-------E-EE-E--------EXXXX-EE--------EE-E[]--E-------XXXXXX---XX---[]-----EEEE---E--------E-E----------------------E---[]--------------------------------------[]--------[X-XX----------------[]--------[]-------------------------[]E-[]----[]--[]------XXXXX----XX---[]
XXXXXXXXXXXXXXXXXXXXXXXXXXXXXXXXXXXXXXXXXXXXXXXXXXXXXXXXXXXXXXXXXXXX---XX---XXXXXXXXX--XXXXXXXXXXXXXXXXXXXXXXXXXXXXXXXXXXXXXXXXXXXXXXXXXXXXX----XXXXX-------XXXXXXXXXXX-XXXXXXXXXXXXXXXXXXXXXXXXXXXXXXXXXXXXXXXXXXXXXXXXXXXXXXXXXXXXXXXXX-XXXX-XXXXXXXXXXXXXXXXXXXXXXXXX---XX---XXXXXXXX
