----------------------------------------------------------------------------------------------------------------------------------------------------------------------------------------------------------------------------------------------------------------------------------------
----------------------------------------------------------------------------------------------------------------------------------------------------------------------------------------------------------------------------------------------------------------------------------------
--------------------------------------------------------SSSSSSSSSSSSSSSSSSSSSSSSSSSS----------------------------------------------------------------------------------------------------------------------------------------------------------------------------------------------------
----------------------------------------------------------------------------------------------------------------------------------------------------------------------------------------------------------------------------------------------------------------------------------------
----------------------------------------------------------------------------------------------------------------------------------------------------------------------------------------------------------------------------------------------------------------------------------------
-----------------------------------QQ-QQ-----------------------------------------------------------------------------------------------XXXX------------?SSS-------------X---S???E?-------??SS-------Q-----------------E----XX-------------------------------------SQSQQQ----------------
-------------------------------------------------------------------------------------------------------------------------------------------------------------------------------------------------------XXX------------------------------------------------------------------------------
-------------XX--XXX---------------------------------------------------------------------------------------------------------------------------------------------------------------------------------------------------------------------------XX---------------------------------------
------------------------------------------------------------------E--------------------------------------------------------------------------XSSSSSSS-----------------E-X-XX------------------------------------------------------------------XXX----------------------------------E----
---------------------------E-----QQ---QQ----------<-----SSSS---SSSS---------E------X-----------------------------------------XXXX----------------------SSSSS---------<>-------------XXX----------X--X------------XXXXXXX----------------------XXX----------E------S---QQ----------<>----
----------------E---------<>----------------------[]-------S-----SS--------<X------X---------------XX-----------------------XXX--------------------------------------[]--------------------------XX-X------------X---------------------------XXXX---------<>----------------------[]----
---------------<>---------[]----------------------[]-------S-----SS-----<>-XX------X---------------XX----------------------XXXX--------------------------------------[]--------------------------XX-X------------X-------------------------XXXXXX---------[]----------------------[]----
----EE----E----[]---------[]------------------E---[]----E-----ES-S------[]-XX----XXX---------------XXX--------------------XXXX----------E----------------------------[]---------------------E-E--XX--------------X----------E-------------XXXXXXXX--------[]----------------------[]----
XXXXXXXXXXXXXXXXXXXXXXXXXXXXXXXXXXXXXXXXXXXXXXXXXXXXXXXXXXXXXXXXXXXXXXXXXXXXXXXXXXXXXXXXXXXXXXXXXXXXXXXX-----XXX--XXX---XXXXXX---XXX-X----XX---XXXXXXX--XXXXXXX-XX-XXX--XXX--XXXXXXX----XXXXXXXXXXX-XX-XXX---XXXXX-----XXX--X-XXXXXXXX----XXXXXXXXXXXXXXX-XXXXXXXXXXXXXXXXXXXXXXXXXXXXXX
