----------------------------------------------------------------------------------------------------------------------------------------------------------------------------------------------------------------------------------------------------------------------------------------
------------------------------------------------------------------------------------------------------------------------------------------------------------------------X---------------------------------------------------------------------------------------------------------------
----------------------------------------------------------------------------------------------------------------SSSSSSSSSSSSSSSSSSSSSSSSSSSS----------------------------SSSSSSSSSSSSSSSSSSSSSSSSSSSS------------------------------------------------------------------------------------
----------------------------------------------------------------------------------------------------------------------------------------------------------------------------------------------------------------------------------------------------------------------------------------
-------------------------------------------------------------------------------------------------------------------------------------------------------------------------------------------------------------------------------------------------------------XXXXXXX--------------------
------------SS------------------------QQQQQ---------SSSS-------QQQQQ-----------------------SSSSS-----------------SSS----S--------------------XXX----------------------XX---------------------------------------------------------XXX------------------------S----------------SSS--------
----------------------------------------------------------------------------------------------------------------------------------------------------------------------------------------------------------------------------------------------------------------------------------------
----------------------------------------------------------------------------------------------------------------------------------------------------------------------------------------------------------------------------------------------------------------------------------------
-XXXXX--------------------E-----------------E-------------------------------------------------E------------E--------------E------------SS-------------------------------E---------E-------SS--------------------------------------------------------------------------------------------
------------SS-----------<>-----<QQ---QQQ--<>-----------------S---QQQ--------------------SS--SS-----------<>-------SS--SSSS--------------------------------------SSSSSSQ>----S---<>-----------------------------------------------------------------------E-XXXXX-------------XXXX----XX
-------------------------[]--<>------------[]----------------------------------E-----<>-------S-----------[]-------S----SSS--------<>--------------------------------------------[]---------?------X-----------------------------------------------------<>------------EXXXXX--X--------
-------------------------[]--[]--X---------[]---------------------------------<>-<---[]-------S-----------[]-------S---SSSS--------[]-------------------X---------------SS-------[]-----E--<><>---XX-----------------------------------------------------[]-------XX-----------X--------
XX-----------------------[]--[]------------[]-EE---------------------------E--[]-[---[]------E--------E---[]----E--SS-ESSSS--------[]------------EEEE---E--------EEE----S]-------[]--E-----[][]--XXX-----------------------------------------------------[]----------------X------------
-XXXXXXX-----XXXXXXXXXXXXXXXXXXXXXXXXXXXXXXXXXXXXX-XXXXXXXXXXXXXXXXXXXXXXXXXXXXXXXXXXXXXXXXXXXXXXXXXXXXXXXXXXXXXXXXXXXXXXXXXXXXXXXXX-----XXXX---XXXXXXXXXXXXXXXXXXXXXXXXXXXXXXXXXXXXXXXXXXXXXXXXXXXXXXXXXXX---XXXXXXX--XXXXXXXXXXXXXXXXXX--XXXXXXXX-XXXXXXXXXXX------------X--XXXXXXXXXX
