--------------------------------------------------------------------------------------------------------------------------------------------------------------------------------------------------------------------------------X-------------------------------------------------------
--------------------------------------------------------S-------------------------------------------------------------------------------------------------------------------------------------------------------------------------------------------------------------------------------
--------------------------------------------------------SSSSSSSSSSSSSSSSSSSSSSSSSSSS--------------------------------------------------------SS----------------------------------------------------------------------------------SSSSSSSSSSSSSSSSSSSSSSSSSSSS----------------------------
--------------------------------------------------------------------------------------------------------------------------------------------------------------------------------------------------------------------------------S------S------------------------------------------------
--------------------------------------------------------------------------------------------------------------------------------------------------------------------------------------------------------------------------------S------SSS?---------------------------------------------
----------------------------------------------X-------------------------------------------------------------------XX--------------------------------SSS---------------------------------X---------------------------------------[S------------------------------------------------------
---------------------------------------------XX-----------------------------------------------------------------------------------------------------------------------------------------X-----------------------------------------------------------------------------------------------
--------------------------------------------XXX--------------------------S--------------------------------------------------------------------------------------------------------------X-------------------------XXXXXX---------------------------------------------------XXX----------
-------------------------------------------XXXX---------E---------E------SSS--------------------------------------------------------------------------E------------E--------------------XX-------------------------------------------------------------S--------------------------------
------------------------------------------XXXXX--------->>---S---<>-----------------------------------X-------------------------------S--S----E--SS--SS-----------<>-----E----------XX--X---------------------------------------SSSSS--SSSS---------E------X----------------------------
-----------------------------------------XXXXXX---------[]-------[]---------?-X----X--------------EXXXX--------------------------------------<>------SS-----------[]----<>-------X--XXXXX----XX----E-----E---------------E------[--S---SSSS--------XX-X----X-----------X---------E------
-------------------X---------------------XXXXXX---------SS-------[]-----E--<XXX---XX---------------------------------------------------------[]------SS-----------[]----[]-------X--XXXXXX---XX---<>---------------X----<>------S]-S---SSSS-----<>-XX-----XX---------------X----<>------
-------------------X------------------XXXXXXXXX---------S]-------[]--E-----[]X]--XXX------------------------------E--E-EE-E-E----------E-E---[]------ES--------E--[]----[]--E-------XXXXX----XX---[]-EE-EE----EE--EE----[]------S--SS-ESSS------[]-XX----XXX-EE-E---E-EEE-EE----[]-----E
XXXXXXXXXXXXXXXXXXXXXXXXXXXXXXXXXXXXXXXXXXXXXXXX--------XXXXXXXXXXXXXXXXXXXXXXXXXXXXXXXXXXX--XXXXXXX-XXXXXXXXXXXXXXXXXXXXXXXXXXXXXX-XXXXXXXXXXXXXXXXXXXXXXXXXXXXXXXXXXXXXXXXXXXXXXXX---XX---XXXXXXXXXXXXXXXXXXXXXXXXXXXXXXXXXXXXXXXXXXXXXXXXXXXXXXXXXXXXXXXXXXXXXXXXXXXXXXXXXXXXXXXXXXXX
