----------------------------------------------------------------------------------------------------------------------------------------------------------------------------------------------------------------------------------------------------------------------------------------
----------------------------------------------------------------------------------------------------------------------------------------------------------------------------------------------------------------------------------------------------------------------------------------
-----------------------------------------------------------------------------------------------------------------------SS---------------------------------------------------------------------------------------------------------------------------------------------------------------
-----------------------------------------------------------------------------------S----------------------------------------------------------------------------------------------------------------------------------------------------------------------------------------------------
-----------------------------------------------------------E---------------------SSS--------------E-------------------------------------------------------------------------------------------------------------------------------------------------------------------------------------
--------------------------------------------------------S-SSSSSSS------------------------------------------------SSS---SSS--------------------------------------------------------------------XXXXX-X--SSSSSSSS----------------S-S------------------------------------------------------
----------------------------------------------------------------------------------------------------------------------------------------------------------------------------------------------------------------------------------------------------------------------------------------
---------------X------------------------------------------------------------------------------------------------------------------------------------------------------------------------------------X-----------------------------------------------------------------------------------
--------------XX------------------------------------------EE---------------------------------------------------------------------------E-------------------------------------------------------------------------------------------------------------------------E----------E-----------
--------------XX-------------------------------------SSSSXS?SS------------XX------XX----------------------SS-S-Q---SS--SSSS-----------<>---------E----------E---------------------------------------------SSS---?SS----------X---QQ---------------X-------------<>---------<>-----------
-------------XXX-----------------------------------------------E---EX-----X---------------------X---------------------------------X---[]--------<>---------<>--------------------------X-------------------------------------------------------X-XX----E--------[]---------[]----------E
-----------XXXXX----------------------------------------------S>--------X-X]--------------------X---------------------------------<>--[]--------[]---------[]---------XX--------------------------------------------------------------------------X---<>--------[]---------[]----------[
----------XXXXXX-------------X-----EEE-------------E----------[]-------XX-X]E-E---XX--------E---XE-------E-E----------------------[]--[]--------[]---------[]---------XX------------------------------------------------E-E-----------------------X---[]--------[]---E-----[]---------E[
XXXXX-XXXXXXXXXXXXXXXXXXXXXXXXXXXXXXXXXXXXXXXXXXXXXXXXXXXXXXXXXXX--XXXXXXXXXXXXXXXXX-----XXXXXXXXXXXXXXXXXXXXXXXXXXXXXXXXXXXXXXXXXX-XXXXXXXXXXXXXXXXXXXXXXXXXXXXXXXXXXXXXXXXXX--XXXXXXXXXXXXXXX-XXXXXXXXXXXXXXXXXXXXXXXXXXXXXXX-XXXXXXXX--XXXXXXX--XXXXXXXXXXXXXXXXXXXXXXXXXXXXXXXXXXXXX
