----------------------------------------------------------------------------------------------------------------------------------------------------------------------------------------------------------------------------------------------------------------------------------------
----------------------------------------------------------------------------------------------------------------------------------------------------------------------------------------------------------------------------------------------------------------------------------------
----------------------------------------------------------------------------------------------------------------------------------------------------------------------------------------------------------------------------------------------------------------------------------------
----------------------------------------------------------------------------------------------------------------------------------------------------------------------------------------------------------------------------------------------------------------------------------------
----------------------------------------------------------------------------------------------------------------------------------------------------------------------------------------------------------------------------------------------------------------------------------------
--------------------------------------------S-------------------S?S--------S------------------------------------------------------E-------------------------------------X---S???SSSSS-------------------------------SSS--------------------------E--------------------------------------
--------------------------------------------------------------------------------------------------------------------E------------->-------------------------------------------------------------------------------------------------------------XXXXXX----------------------------------
---------------X-----------------------------------------------------------------------------------XXXXX----------------------------------------------------------------]---------------------------------------------------------------------------------------------------------------
--------------XX----------------------------XS------------XX------------------------------------------------------------------------------------------------------------X-X-----------------------E-----------------E-------------------------------------------------------------------
------------XXXX------------<>--------------X-----------------------XXX----------X------------------------------X--------------EXXX-------------------------X------------------S?---?SS----------<>--E---E---------<>-------------------------------------SS----------------------------
----------XXXXXX------------[]---E---E-----XX----X-------------------------------XX-----------------E----E------X-------------EXXXXX-----------------------XXX-----------------------------------[]-----<>---E-----[]----X-----E-E-------------------------------------------X----------
---------XXXXXXX------------[]----------XXXXX----XX----X-------------------------X-----------------<>---<>-----[X-------------X---------------------------XXXX-----------------------------------[]-[]--[]---------[]----XX---<>XXXX---------------------------------------XXXXX--------
--------XXXXXXXX--------E--E[]--E-------XXXXX----XX----X--------------------E-----------EE----EE--E[]----------[-----------------------------------------XXXXX-----------------------------EE-E--[]-[]--[]-----E-X-[]----X]---[]XX--------------------------------E--------XXXXX--------
XXXXXXXXXXXXXXXXXXXXXXXXXXXXXXXXXXXXXXXX--XXX----XXXXXXXXXXXXXXXX--XXXXXXXXXXXXXXXXXXXXXXXXXXXXXXXXXXXXXXXXXXXXXXXXXX----XXXXX----------X---XXXXXXXXXXXXXXXXX--XX---XXXXXXXXXXXXX---XXXXXXXXXXXXXXXXXXXXXXXXXXXX-XXXXXX--XXXXXXXXXX--XXXXX---XXX-----XXXXXXXXXXXXXXXXXXXXXXXXXXX-----XXX
