----------------------------------------------------------------------------------------------------------------------------------------------------------------------------------------------------------------------------------------------------------------------------------------
----------------------------------------------------------------------------------------------------------------------------------------------------------------------------------------------------------------------------------------------------------------------------------------
----------------------------------------------------------------------------------------------------------------------------------------------------------------------------------------------------------------------------------------------------------------------------------------
----------------------------------------------------------------------------------------------------------------------------------------------------------------------------------------------------------------------------------------------------------------------------------------
----------------------------------------------------------------------------------------------------------------------------------------------------------------------------------------------------------------------------------------------------------------------------------------
----------------------------S-SSSSSSSSS---SS----SS-----S--------------------------------------------------------------------------XXX-----------------------------------X---SSSSSSSSS---------------------------------E--------------------------------XX-------------------------XXX---
---------------------------------------------------------------------------------------------------------------------------------------------------------------------------------------------------------------------<>-----------------------------------------------------------------
------------------------------------------------------------------------------------------------------------------------------------------------------------------------X--------------------------------------------[]-----------------------------------------------------------------
------------------------------EE------------------------------------------------------------------------------------XXX-----------------------------------------------E------------------------E--?-------------------------------------------------------------------------------------
---------------------------E---?SSSSS-----E------------------E----------E---------------E-Q---QQQ--QQ---------E--X---------------------------X-----------------------QQ-------SSSS-SQS--------<>--]-X------------XXXXXX---------Q-----------------X---------X-----------------E---------
-----E----------E---------E>--------------------------------<>---------<>---E------------------------------E--E------------------------------X------------------------------------------------[]-<>-X------------XX-XXX-----------------------EXXXXX--------X-------------EXXXXX--------
----<>---E-----<>---------[---------------------------X-----[]---------[]---------------------------------<>-<>-------------------------------------------------------------------------------[]-[]-X----------XXXXXXX---------------------------X----------X---------------------------
----[]---E-----[]---------[---------------------E-E---------[]---------[]---------------------------------[]-[]---X-------------------------XXX--------------------------------------------EE-[]-[]-----------XXXXX---------E-----------------------------------------------------------
XXXXXXXXXXXXXXXXXXXXXXXXXXXXXXXX-XXXXXXXX---XXX-X----XX-XXXXXXXXXXXXXXXXXXXXX--XXXXXXXXXXXXXXX-XXXXXXXXXXXXXXXXXXXX----XXXX------XXXXXXXX---XXXXXXXXXXXX---X------XXXXXXXXXXXXXXXXXXXXXXXXXXXXXXXXXXXXXXXX---XXXXXX---XXXX--XXXXXXXXXXXXXXXXXXXX-XXXXX---XXXXXXXX---XXXXX---------------
