----------------------------------------------------------------------------------------------------------------------------------------------------------------------------------------------------------------------------------------------------------------------------------------
----------------------------------------------------------------------------------------------------------------------------------------------------------------------------------------------------------------------------------------------------------------------------------------
--------SSSSSSSS----------------------------------------------------------------------------------------------------------------------------------------------------------------------------------------------SSSSSSS-----------SSSSSSSSSSSSSSSSSSSSSSSSSSSS----------------------------
---------------------------------------------------------------------------------------------------------------------------------------------------------------------------------E------------------------------------------------------S-----------------------------------------------
---------------------------------------------------------------------------------------------------------------------------------------------------------------------------------XXX---------------------------------------------------SSS----------------------------------------------
SSS----------------------------------------E---------------S---SSSS-----------------SSS----------------------------E--E------E---E------------XX-------------------------------------QQ------------------------------XX---------SSS----SS-------------------------------EQQ----------SSS
------------------------------------------EX-------------------------------------------------------------------------XXXX------------XXXXX--------------------------------------------------------------------------XXX-----------------------------------------------------------------
------------------------------------------XXXXXX--------------------------------------------------------------------------------------------------------------------------------------------------------------------XXX-----------------------------------------------------------------
----------------------------------------X------------------------------------------------------------------------------------------------------------------------------------SSSS----------------------------------XXXX--------------------------------SS-----SSSSSSS-------------------
SSSS--------------XXX-<----------------XX---------------------S--SS-----------------SSSQ---------------X-----------------------XXXXSS------------------------------------------------QQQ---------QQ-----------X-----XXXX--X-----SSSSS--SS-S--------EX------X------------SQSQ--------S---
-------E---------XXXX--E---------------XXX-------------------------------------------------E---------XXX----------XX----------------------------------------------------------E---E-----------------E------------XXXXXX---X------------SS----------XX------X----------------------------
------<>--------XXXXX-[]---X----------XXXX-------------[----------------------------------<>--------XXXX--------XXXX-------------------------------------------------------------<>-----------------]-----------XXXXXXX---X--------S--SS--------<XXXX------X----------------------------
------[]-------XXXXXX-[]-XXX-EE-EEE-XXXXX-EE--------EE-[------------------E---------------[]-------XXXXX-------------------------------------------EE--------------E-EE----------[]---------------E-]--E-------XXXXXXXXX--X-----------[S--------[]-XX------X----------------------------
XXXXXXXXXXXXXXXXXXXXXXXXXXXXXXXXXXXXXXXXXXXXXXXXXXXXXXXXXXXXXXXXXXXXXXXXXXXXXXXX-XXXXXXXXXXXXXXXXXXXXXX-----XXXX---------------------XXXX-XXXXXXXXXXX--XXXXXXXXXXXXXXXXXXXXXXXXXXXXXXXXXXXXX--XXXXXXXXXXXXXXXXXXXXXXXXXX--XXXXXXXXXXXXXXXXXXXXXXXXXXXXXXXXXX---XXXXXXXXXXXXXXXXXXXXXXX--
