----------------------------------------------------------------------------------------------------------------------------------------------------------------------------------------------------------------------------------------------------------------------------------------
----------------------------------------------------------------------------------------------------------------------------------------------------------------------------------------------------------------------------------------------------------------------------------------
SSSSSSSSSSSSSSSSSSSSSSSSSSSS--SSSSSSSSSSSSSS----SSSSSSSS----------------------------SSSSSSSSSSSSSSSSSSSSSSSSSSSS------------------------------------------------------------------------------------------------------------------------------------------------------------------------
------------------------------SSSSSSSSSSSSSS----SS---SSS--------------------------------------------------------------------------------------------------------------------------------------------------------------------------------------------------------------------------------
-------------------------------SSSSSSSSSSSS-----SS----SS--------------------------------------------------------------------------------------------------------------------------------------------------------------------------------------------------------------XX----------------
-S---------------------------SSSSSSSSSSSSSSS----------SS----------------------XXXX------------------------------------------------X---------------SQQQQQQ-----------------------------------------------------------------------X---SSSSSSSSS--S-----------S----------------------------
----------------------------EE----------------------------------------------------------------------------------------------------X-----------------------------------------------------------------------------------------------------------------------------------------------------
---------------------------------------------------------------------------------------------------------------------------------XX---------------------------------------------------------------------------------------------X-------------------------------------------------------
----------E---------------------E-------------------------------------------------------------E---------------------------------XXX--------------------------------E----------------------X---------------SSS---------------------------------------------------------------------------
>S-S----S<>---------E------X---?SSSSSSSS------------------Q----------------------------S----SQ>--------------------------------XXXX-----------E--QQ--SQQQ---------<>----QQQ--------------XXX---------------------QQQ-----------------SSSSSSSQQ--------<--X-----------------Q------------
S--S-----[]--------<>------X--E----------------------------------------X---------------------[]--------E-------X--------------EXXXX----------<>-------------------[]--E---------------EXXXXX-----------------------------------------------------------E-X----------------------------E-
SS-S-----[]-----<>-[]-----XX-SS--X------------<>---------------------------------------------[]-----<>-XX-----XX-------------EXXXXX----------[]-------------------[]-------------------XXXXX------XX--------------------------------------------------[]-X---------------------------<>-
S--S--ES-[]-----[]-[]----XXX------------------[]E-E---------------------------------E-----E--[------[]-------XXX--------------XXXXX----------[]----------------E--[]-------------------XXXXX-----XXX---------E-------------------------------------EE-[]-X-----------E---------------[]-
XXXXXXXXXXXXXXXXXXXX--XXXXXXXXXXXXXXXXXXXXXXXXXXXXXXXXXXXXXX----XXXXXXXXXXXXXXX-XXXXXXXXXXXXXXXXXXXXXXXX--XXXXXXXXXXX--XXXXXXXXX-X------XXXXXXXXXXXXXXXXXXXXXXXXXXXXXXXXXXXXXXXX--XXXXXXXXXXXXXXXXXXXXXXXXXXXXXXXXXXXXX------X--XXXXXXXXXXXXXXXXXXXXXXXXXXXXXXXXXXXXXXXXXXXXXXXXXXXXXXXX
