----------------------------------------------------------------------------------------------------------------------------------------------------------------------------------------------------------------------------------------------------------------------------------------
----------------------------------------------------------------------------------------------------------------------------------------------------------------------------------------------------------------------------------------------------------------------------------------
-------------------------------------------------------------------------------------------------------------------S-SSSS---------------------------------------------------------------------------------------------------------------------------------------------------------------
----------------------------------------------------------------------------------------------------------------------------------------------------------------------------------------------------------------------------------------------------------------------------------------
-----------------------------------------------------------------XXX---------------------------------------------------------------------------------------------------------------------------------------------------------------------------------------------------X----------------
----------S------------------------------------------------------------------------------------XXXX------XX-----SSSSSSSSSS----SS----------SS-----------------------------SSS----SS------------------------------------------------------------------------------------------------------
------------------------------------------------------------------------------------------------------------------------------------------------------------------------------------------------------------------------------------------------XXXX------------------------------------
----------------------------------------------------------------------------------------------------------------------------------------------------------------------------------------------------------------------------------------------------------------------------------------
---------------------------------E----------E----------------S----------E------------------------------------------E---------------------------------------------------------------------------------------------------------------------------------------------S----------------------
------------QQ------------------<>---------<>----------E---------------Q----------E--X---------------?S-SS--S----?SSSS-SSS----------------------------------Q-----------------------------------------------------XXX------------------------------------SQS-----------QQ-QQQ---------E-
--------------------------------[]---------[]------E--<>----------E-----E--------<>--XX--------------------------------S----------<>---------------------------------------------------------------------------------------------E---------------------------------------------------<>-
-------------------------XX-----[]---------[]-----<>--[]---------<>----<>--------[]-XXX----------------------------S--------------[]-------------------------------------------------------------X------------------------------XXXX-------------------------------------------------[]-
-------------------------X------[]---------[]-----[]--[]-----E---[]----[]--------[]-XXX-------------------------------------------[]-------------------------------------------------------------X------------------------------XX---------------------------------------------------[]-
XXXXXXXXXXXXXX-XX--------XX--XXXXXXXXXXXXX-XXXXXXXXXXXXXXXXXXXXXXXXXXXXXXXXXXXXXXXXX-------XXXX---XXXXXXXXXXX-XXXXXXXXXXXXXXXXXXXXXXXXXXXXXXXXXXXXXXXXXXXXXXXX-------XXXXXXXXXXXX--XXXXXXXXXXXXXXXXXXXXXXX--XXXXX---------------XXXXXXXXXXX-XXXXXXXXXXXXXXXXXXXXXXXXXXXXXXXXXXXXXXXXXXXX
