----------------------------------------------------------------------------------------------------------------------------------------------------------------------------------------------------------------------------------------------------------------------------------------
----------------------------------------------------------------------------------------------------------------------------------------------------------------------------------------------------------------------------------------------------------------------------------------
------------------------------------------------------------------------------------SSSSSSSSSSSSSSSSSSSSSSSSSSSS------------------------------------------------------------------------------------SSSSSSSSSSSSSSSSSSSSSSSSSSSS--------------------------------------------------------
-------------------------------------------------------------------------------------------SS-------------------------------------------------------------------------------------------------------------------------------------------------------------------------------------------
-------------------------------------------------------------------------------------------SSS------------------------------------------------------------------------------------------------------------------------------------------------------------------------------------------
------------------------------------------------------------------------X------------SSSS--SS----S----------------------------------------------------------------------------SQQQQQQ--------------S----------------X---------------------------------------------SSSSSSS--------------S
------------------------------------------------------------------------X-------------------------------------------------------------------------------------------------------------------------------------------X-------------------------------------------------------------------
-------------XX----X--------------------------------------------------------------------------------------------------------------X---------------------------------------------------------------------------------XS------------------------------------------------------------------
------------------------------------------------------------------------XX---------------------------------SS----S---------------XX---------------------------------------------------------------------------------XXXS-----------------------------------------------------------E----
----------------------S--S-------------------------------E--------------X-----------SSSSS--SSSS--------E?------XSQQ-------------XXXX----------------------------------Q---E--SSS-SQSQ---------------<>------Q---X----X----X-----------------------------------E--SSS-SSS----------<>----
----------E-----E---------------------------E---------E-<>-------X------X------------------SSS--------->X------X---------------XXXXX-------------------------------------<>--------------------E----[]--------------XX---XX----------------------------------<>-------------------[]----
---------<>--------------------------------<>--------<>-[]----------XXXXXX-------------S--SSS-------<XXXX-------]--------------XXXXX-------------------------------------[]-------------------<>-X--[]----------XXXXXX---XX----X-----------------------------[]-------------------[]----
--E--E---[]------------E-EE-----EE---------[]--------[]-[]-E--------XXXXXX-------------SS-SSS-------[]-XX-------]-------------XXXXXX---------------E-EE--------------EE--[]----------------EE-[]-X--[]----------XXXXXX---XX----X------------------E----------[]---------------EE--[]----
XXXXXXXXXXXXXXXXXXXXXXXXXXXXXXXXXXXXX-XXXX-XXX--XXXXXXXXXXXXXXXXXXXXXXXXX--XXXXXXXXXXXXXXXXXXXXXXXXXXXXXXXXXXXXXXXXXXXXXXXXXXXXXXXXXXXXXXXXXXXXXXXXXXXXXXXXXXX----XXXXXXXXXXXXXXXXXXXXXXXXXXXXXXXXXXXXXXXXXXXXXXXXXXXX---XXXXXXXXXXXXXXXX--XXXXXXXXXXXXXXXXXXXXXXXXXXXXXXXXXXXXXXXXXXXXX
