----------------------------------------------------------------------------------------------------------------------------------------------------------------------------------------------------------------------------------------------------------------------------------------
----------------------------------------------------------------------------------------------------------------------------------------------------------------------------------------------------------------------------------------------------------------------------------------
----------------------------SSSSSSSSSSSSSSSSSSSSSSSSSS------------------------------------------------------------------------------------------------------------------------------------------------------------------------------------------------------SS---SSSSSSSSSSSSSSSSSSSSSSS
----------------------------------------------------------------------------------------------------------------------------------------------------------------------------------------------------------------------------------------------------------------------------------------
----------------------------------------------------------------------------------------------------------------------------------------------------------------------------------------------------------------------------------------------------------------------------------------
------------------------XXXX---------------------------------------------------------S------------------------------------------XS----------X-----------------------------------------------------XX-------Q--QQQ-------------------------------------------S-----------------X---------
-------------------------------------------------------------------------------------------------------------------------------XX---------------------------------------------------------------------------------------------------------------------------------------------X---------
---------------------------------------------S-------------------------------------------------------------------------------XXXX----E-----------------------------------------------------------------------------------------------------------------------S---------------XX---------
--------------------------------------------XSSS----------------------------------------------------------------------------XXXXXE---------------E----------E------------------------------------------------------------------------------------------------S---------------XX---------
-X------------------SSSSSSSS<>------Q--------X----X---------------------------------------------------X----------E---------XXXXXX----------E----<>---------<>-------------------------------SS-S--------E-Q---QQQ--?Q---------------------------------------XXQ-------S-----XXXXX-X-----
----------------------------[]-------E-------]----X-----------------------X------------------------XXXX---------<>---E---XXXXXXXX----X----<>----[]---------[]------E--E-------------------------------------------------------------------------------------[---------------XXXXX-X-----
----------------------------[]----------XXXXXX---XX----X----------------X-X------------------------XXXX--------X[]--<>---X-XXXXXX----XX---[]----[]---------[]-----<>---------------------------------------------------------X------------------------------]-----<-------XXXXXXX-------
-------E-E------------------[]----------XXX-XX----X----X----------------XXX-----------------------XXXXX-------XX[]--[]------XXXXX----X----[]----[]---------[]-----[]-------------------------E-------------------------------X------------------------------]-----[]------XXXXXXX-------
---XXXXXXXXXXXXXXXXXXXXXXXXXXXXXXXXXXXXXXXXXXX--XXXXXXXXXXXXXXXXXXXXXXXXXXXXXXXXXXXXXXXXXXXXXXXXXXXXXXXXXXXXXXXXXXXXXXXXXXXX---XX---XXXXX-XX-XXXXXXXXXXXXXXXXXXXXXXXXXXX------XXXXXXXXXXXXXXXXXXXXXXXXXXXXXXXXXXXXXXXXX------XXXXXXXXXXXX--XXXXXXXXXXXXX-XXXXXXXXXXXXXXXXXXXXX-X----X-XX
