----------------------------------------------------------------------------------------------------------------------------------------------------------------------------------------------------------------------------------------------------------------------------------------
----------------------------------------------------------------------------------------------------------------------------------------------------------------------------------------------------------------------------------------------------------------------------------------
SSSSSSSSSSSSSSSSSSSSSSSSSSSS------------------------------------------------------------------------------------------------------------------------------------------------------------------------------------------------------------------------------------------------------------
----------------------------------------------------------------------------------------------------------------------------------------------------------------------------------------------------------------------------------------------------------------------------------------
----------------------------------------------------------------------------------------------------------------------------------------------------------------------------------------------------------------------------------------------------------------------------------------
-S--------------------------------------------E---------------SQQQQQQ-----------------XX-------------------------------QQ-QQQ------------SSS-------------------------------------------------------------------------E------------------------------------------------------------------
---------------------------------------------XX-----------------------------------------------------------------------------------------------------------------------------------------------------------XX----------------------------------------------------------------------------
--------------------------------------------XXX--------------------------------------------------------X--------------------------------------------------------------------------------------------------------------------------------------------------------------------------------
----------E--------------------------------XXXX--------------------------------E-----------------------------------------------------------------------------------------------------------------------------------------------------E----------E---------------------------------------
---S----S<S------------------------------XXXXXX-----------E--QQ---QQQ--?------<>--------------------------S--S--------Q---QQQQQQ-Q--------------------------Q------------------------------------------------------XXXXSS------Q----<>---------<>----------E-------------------------SSS
-------------------E-------X-------------XXXXXX----------<>-------------------[]----------------------------------------------------------------------------------------------------------------------------------------------------[]---------[]---------<>----------------------------
---------[]-----<>-XX------X-----------XXXXXXXX----------[]-------------------[]---------------------------------------------------------------------------------------------------------------------XXX----------------------------[]---------[]---------[]-XXX------------------------
E-----E--[------[]-X-------X----------XXXXXXXXX-----E--X-[]----------------E--[]------E--E-EE-E-E---------EE-EE--------------------E------------------------------------------------------------------------------------------------[]---------[]---------[]-------------E-------E-E----
XXXXXXXXXXXXXXXXXX----------XXXXXXX--XXXXXX--XXX-XXXX---XXXXXXXXXXXXXXXXXXXXXXXXXXXXXXXXXXXXXXXXXXXXXXXXXXXXXXXXXXXXXXXXXXXXXXXXXXXXXXXXXX--XXXXXXXXXXXXXX-XXX-------XXXX----XXXXXXXXXXXXXXXXXXXXXXXXX----------XXXXXXXXXXXXXXXX-XXXXXXXXXXXXXXXXXXX-XXXXXXXXXXXXXXXXX--XXXXXXXXXXXXXXXX
