----------------------------------------------------------------------------------------------------------------------------------------------------------------------------------------------------------------------------------------------------------------------------------------
----------------------------------------------------------------------------------------------------------------------------------------------------------------------------------------------------------------------------------------------------------------------------------------
SSSSSSSSSSSSSSSSSSSS--------------------------------------------------------------------------------------------------------------------------------------------------------------------------------------------------------------------------------------------------------------------
-----------------------------------------------------------------------------------------------------------------------------------------------------------------------------------------------------------------------------------------E----------------------------------------------
-------------------------------------------------------------------------------------------------------------------------XX-------------------------------------------------------------------------------------------------------------------------------------------------------------
----------------------------S------------------------------------------XSSS-------------------------------XXXX--------------------------XXXX----------------------------------------------------------SS------------------SSSS-------------?EQQ-----------------------------------XXXXX-
----------------------------------------------------------------------XXX---------------------------------------------------------------------------------------------------------------------------------------------------------------------------------------------------------------
----------------------------------------------------------------------XXX-------------------------------------------------------------------------------------------------------------------------------------------------------E------S------------------------------------------------
-----------------XX-------------------------------------------------XXXXXE-----------------------------------------------------------------------E----------E------E-------------------------------------------------------------XSSSSSSS-----------------E-----------------------------
-S------Q-S------X----X------QQ---------------XX---------E---------X-XXXX----------EQQQ---------------EX----------------------QQ-----S-SSS------<>---------<>-----<>---E----------------------------SSSXS--------------X-------------------SSSSS---------<>-----------------------------
-----------------X-X--X----X--------------XX------------<>---------XXXXXX----X----<>-------------XXXXXXX------------------E---------------------[]---------[]-----[]--E----------------XX------------------E----------XX---------------------------------[]----------------X------------
--------------XXXXXX--X---<>---------------------------------------XXXXXX----X----[]-------------------------------------<>---------------------[]---------[]-----[]-->----------------XX-----------------<X----------XX---------------------------------[]-----------------------------
E-----E------XXXXX-X--X---[]----------------------------[E-EE------XXXXXX----X----[]-------------------------------------[]---------------------[]---------[]-----[]--X----------------XX--------------------------XX-X----------------------------E-----[]-----------------------------
XXXXXXXXXXXXXXXXXXXX-XXXX-XXXX-------XXX------------XXX-XXXXXXXXXXXX--XXX-XXXXXXXXXXXXX-----XXXXX--X-XXXXX---XXXXXXXXXXXXXXXXXXXXXXXXXXXXXXXXXXXXXXXXXXXXXXXXXXXXXXXXXXXXXXXXXXXXXXXXXXXXXXX----XXXXXXXXXXXXXXXXXXXXXXXXXXXXXXXX--XXXXXXX---XXXXXXXXXXXXXXXXXXXXX---XXXXXXXXXXXXXX---XXX
