----------------------------------------------------------------------------------------------------------------------------------------------------------------------------------------------------------------------------------------------------------------------------------------
----------------------------------------------------------------------------------------------------------------------------------------------------------------------------------------------------------------------------------------------------------------------------------------
-----------------------------------------------------------------------------------------------------------------------------------------------------------------------------------S----------------------------------------------------------------------------------------------------
----------------------------------------------------------------------------------------------------------------------------------------------------------------------------------------------------------------------------------------------------------------------------------------
-------XX------------------------------------------------------------------------------------XXX----------------------------------------------------------------------------------------------------------------------------------------------------------------------XX----------------
-----------------XXX-----------------------------------------------------------------------------------------------------------------------------------------------X------S----SS------------------------------------------------------QQ-QQQ-------------------------------------------
------------------------------------------------------------------------XXXX------------------------------------------------------------------------------------------------------------------------------------------------------------------------------------------------------------
----------------------------------------------------------------------------------------------------------------------------------------------------------------------------------------------------------------------------------------------------------------------------------------
--XXXXX-------------------E--------------------S----------------------------------------------------------------------------------------------------------------------------------------------------------------------------------------------------------------------------------------
------------XX-----------<>------E---E------E-------------------------------------SS---------------Q----------------------------X----------E-------------XXXX-----------SSSSS-------------XE-----------------------X-----------------QQ---QQ----Q--------------------------Q----------E-
-------------------------[]-----<>---E-----<>----------E--------------------------------------E-----E---------E----------------XX------E--<>-------------XX-XX-----------------E----------XX---E-------------------------------------------------------------------------------------->-
-------------------------[]-<---[]---------[]----<>---<>XXX----------------------------------<>----<>--------<>----------------XX-----<>--[]-------------XXXX-----------------<>--------XXXX--<>----------------XX-------------------------------------------------------------------[]-
----------------------E--[]-[]--[]-----E-E-[]----[]---[]--------------------------------EE---[]----[]--------[]------------E-EXXX-----[]--[]-----------XXX--------------------[]-------XXXXXX-[]-XXX-----------XXX--------------------------------E------------------E---------------[]-
----------------XXXXXXXXXXXXXXXXXXXXXXXX-XXXXX---XXXXXXXXXX-XXXXXX----XX-----XXXXXXXXXXXXXXXXXXXXXXXXXXXXXXXXXXXXXXXXXXXXXXX-X-XXXX-XXXXXXXXXXXXX---XXXXXX--------------XXXXXXXX--XXXXXXXXXXXXXXXXXXXXXXXXXXXXXXXXXX-XXXXX--XXXXXXXXXXXXXXXXXXXXX--------XXXXXXXXXXXXXXXXXXXXXXXXXXXXXXX
