----------------------------------------------------------------------------------------------------------------------------------------------------------------------------------------------------------------------------------------------------------------------------------------
----------------------------------------------------------------------------------------------------------------------------------------------------------------------------------------------------------------------------------------------------------------------------------------
----------------------------------------------------------------------------------------------------------------------------------------------------------------------------------------------------------------------------------------------------------------------------------------
---------------------------------------------------------------------------------------------E------------------------------------------------------------------------------------------------------------------------------------------------------------------------------------------
----------------------------------------------------------------------E----------------------XX------------------------------------------------------------------------------------------------------------------------------------------XXX--------------------------------------------
---------------E---------------------SS--S--------------E--E--E------E---E----------------------EQ?-------------------SSQSSSS------------------------------------------------------S-----------------------------------------------------------------------------------------S----------
----------------------------------------------------------XXXXXXX-------X--XXXXXXX----------------------------------------------------------------------------------------------------------------------------------------------------------------------------------------EX------------
----------------------------------------------------------X--------------------------------S------------------------------------------------------------------------------------------------------------------------------------------------------------------------------XXXXXX--------
------------------------------XXX-----------------------------------------------------SSSSSSS-----------------E------------------------E-------------------------------------E----------E-----------------------------------------------------------------------------------------------
------------XX--------------------------SSS-------------X--------------XXSSSSS-----Q------------S?SS---------QQS--E--SS--SSS----------<>-----------------------------SQ-----<>-----?---<>------------X----------------------SSSS---------------Q----------------------------------------
-----------XXX-------------------------------------------E--------------------------------E----------------------<>-------------------[]------------------------------------[]---------[]------E--E---------------------------------------E---------------E------E-----X---------E------
----------XXXX------------------------------------------XXXX-----------------------------------------------------[]-------------------[]------------------------------------[]---------[]------------------------------------------------<>--------------<>----------------X----<>-----[
------E-XXXXXX-E-----EE-EE-E-----------------------------------------E-------E-------------E-E-------------------[]-------------------[]-----------E-E----------------------[]---------[]------------------EEE---------------------------[]--------------[]--E--EE----EE--EE----[]-----[
XXXXXXXXXXXXXXXXXXXXXXXXXXXXX--XXXXXXXXXXXXXXXXXXXXXX---------------XXX---XXXXXXXXXX--XXXXXXXXXXXXXXXXXXXXXXXXXXXXXXXXXXXXXXXXXXXXXXXXXXXXXX---XXXXXXXXXXXXXXXXXXXXXXXXX--XXXXXXXXXXXXXXXXXXXXXXXXXXXXXXXXXXXXXXXXXXXXXXXXXXXXXXXXXXXXXXXXXXXXXXXXX-XXXXXXXXXXXXXXXXXXXX-XXXXXXXXXXXXXXX
