----------------------------------------------------------------------------------------------------------------------------------------------------------------------------------------------------------------------------------------------------------------------------------------
----------------------------------------------------------------------------------------------------------------------------------------------------------------------------------------------------------------------------------------------------------------------------------------
----------------------------------------------------------------------------------------------------------------------------------------------------------------------------------------------------------------------------------------------------------------------------------------
----------------------------------------------------------------------------------------------------------------------------------------------------------------------------------------------------------------------------------------------------------------------------------------
-------------------------------EE-------------------------------------------------------------------------------------------------------------------------------------------------------------------------------------------------------------------------------------------------------
----------------------------?--SS???S--------??SS-------------------SS-----X--------------SSQSSSS--------------S------------------------------------------------------------------S--------------S-S--------------------------------------------------------------------------------XXXX
----------------------------------------------------------------------------------------------------------------------------------------------------------------------------------------------------------------------------------------------------------------------------------------
----------------E--------------E---------------------------------------------------------------------------------------------XX----X----------------------------------------------------------------------------------------------------------------------------------------------------
------------------------------XX---------------------------XXX--------------------EX-------------------------------------------------------------E----------E-------------------------------------------------------E-------------------------------------------------------------------
-----------------------------XXXXS-------XX--------------------------------------Q----E--SS--SSS-----------------------------------------------------------<>----------------------QQQ-------------------E---------<>---------------------------------SS-S-----------------<>------S----
-----E----------E----E------------SE---EX-------------XX-X-----------------------E---<>--------------------E--------------E----------------------E---------[]-------------------------------------------<>---------[]---E-----------------E----------------------E---------[]-----------
----<>---------<>---<>-----------SSX--------X--------XX------------------------------[]--X----------------<>--------------E---------------------<>---------[]-------------------------------------------[]---------[]---------------------E---------------------<>---------[]-----------
----[]---------[]---[]-----E----------------X---XXX-----XXX--------------------------[]---------------EE--[]------E--E-E--S------------E-EE-----[]---------[]---------E[--------------------------------[]---------[]-------------E--E-E-[]------------E-E------[]---------[]-----------
XXXXXXXXXXXXXXXXXXXXXXXXXXXXXXX----XX-------------------XXXXXXXX-------XXXXXXXXXXXX-XXXXXXXXXXXXXXXXXXXXXXXXXXXXXXXXXXXXXXXXXXXXXXX-XXXXXXXXXXXXXXXXX-XXXXXXX-XXXXXXXXXXXXXXXXXXX--XXXXXXXXXXXXXXXXX-XXXXXXXXXXXXXXXXXXXXXXXXXXXXXXXXXXXXXXXXXXXXXXXXXXXXXXXXXXXXXXXXXXXXXXXXXXXXX--XXXX
