----------------------------------------------------------------------------------------------------------------------------------------------------------------------------------------------------------------------------------------------------------------------------------------
-------------------------------------------------------S--------------------------------------------------------------------------------------------------------------------------------------------------------------------------------------------------------------------------------
----------------------------SSSSSSSSSSSSSSSSSSS-SSSS-SSS--------------------------------------------------------------------------------------------------------------------------------------------------------------------------------------------------------------------------------
----------------------------S-SSSSSSSSSSSSSS----SSSSSSSS--------------------------------------------------------------------------------------------------------------------------------------------------------------------------------------------------------------------------------
----------------------------SSSSSSSSSSSSSSSS----SSSSSSSS--------------------------------------------------------------------------------------------------------------------------------------------------------------------------------------------------------------------------------
----XX--------------------XXSSSSSSSSSSS--SSS----S-----SS------------------------X-X--XX-----------------------------------------X----------------SSSSQSSS-------------SS-----------------S-----------XXX--------------------------------------------------------------------------------
-------------------------------------------------------------------------------------------------------------------------------XX-------------------------------------------------------------------------------------------------------------------------------------------------------
-------------------------------------------------------------------------------------------------------------------------------XX-----------X------------------------------------------XX-----------------------------------------------------------------------------------------------
-------------------------------E-------------------E--------------------------------------------------------------------------XXXX---------------------------------------------------------------------------------------------------E----------E---------------------------------------
-----------------------S-----SSSSSSSSS---------E--<>-----------------XXXX--------------------------------------------------X--XXX-------------E--SSSSSSSQ------------------------------------------E--------------------------------<>---------<>----------E---------------QQ-----------
------------------------------SSSSSSSS--------<>--[]-----------------XX---------------------------------------E----------XX-EXXXXX-----------<>------------------------------E----------E----E----<>--------------------------------[]---------[]---------<>----------------------------
------------X-----------------SSSSSSSS--------[]--[]---------------XXXX--------------------------------------<>----------X-XXXXXXX-----------[]--X--------------------------<>---------<>---<>----[]--------------------------------[]---------[]---------[]----------------------------
--E--EE-E-E-X--------EEE-E-----SSSSSSS--------[]E-[]--------------XXXXX---------E----------E-EE--------------[]-EE-E-------XXXXXXX-----------[]---------------EEE-E------E--[]-----E--E[]---[]----[]-------------------------EE-----[]---------[]---------[]--------------------------E-
--XXXXXXXXXXXXXXXXXXXXXXXXXXXXXXXXXXXXXXXXXXXXXXXXXXXXXXXXXXXXX--XXXXXX--XXXXXXXXXXXXXXXXXXXXXXXXXXXXXX-XXXXXXXXXXXXXXXXXXXXXXXXXXXXXX-XXXXXXXXXXXXXXXXXXXXXXXXXXXXXXXXXXXXXXXXXXXXX-XXXXXXXXXXXXXXXXXXXXXXXXXXXXXXXX---XXXXXXXXXXXXXXXXX-XX-X-XX-XXXXXXXXXXXXXXXXXXXXXXXXXXXXX-XXXXXXXX
