------------------------------------------------------------------------------------X-------------------[-------------------------------------------------------------------------------------------------------------------------------------------------------------------------------
---------------------------------------------------------------------------------------------------E----SS-----S------------------------------------------------------------------------------------------------------------------------------------------------------------------------
---------------------------------------------------------------------------------------SSSS-------<>----SSS---SS--------------------------------------------------------SSS-------------------------------------------------------------------------------------------------------------
---------------------------------------------------------------------------------------SSSSSS-----[]----SS---SSS------------------------------------------------------------------------------------------------------------------------------------------------------------------------
---------------------------------------------------------------------------------------SSS-S------[]----SSS-SSSS-----------------E------------------------------------------------------------------------------------------------------------------------------------------------------
------------------------------------------------------------------------------------?--SSSSSSSS-S-SS----SSS----S-----------XXXX---------------------------------------XX----------------------------------------------------SSSX--------------------------XX------------------------SSSS
----------------------------------------------------------------------------------------------------------------------------------XXXX--------------------------------------------------------------------------------------------------------------------------------------------------
------------------------------------------------------------------------------------]---------------------------------------------------------------------------------------------------------------------------------------------------------------------------------------------------
--------------------------------------------E---------------------------------------X-?---------------------------------------------------XX--------------------------------------E------SSS--------------------------------------------------------------------------------------------
-X----------------------SSSS-----E---------<>---------------------------E---------------SSSSSS---SS----------XXX-X-----------------------------------------------S-SS--------S---<>-----E----------------------Q---QQ--------------------------------SSSSS--------------QQ--------------
--------------------------------<>---------[]----------E---------------<>------E----------------------------XXXX-X---------------------------------------------------------------[]-----------X----E------------------------------------------------------------------------------------
--------------------------------[]---------[]---------<>---------------[]-----<>---X-----X-------------------XX-XXX-----------------------------------------------------<>-------[]-----E----<X---<>------------------------------------------------------------------------------------
XX-----E------------------------[]-----E---[]---------[]---------------[]-----[]--XX-------------------EE-E---X-XXX--------------------------------E--E-----------------[]--E----[]--E-------[X---[]------------------E----------------EE-E---------------------------------------------
XXXXXXXXXXXXXXXXXXXXXXXXXXXXXXXXXXXXX--X-XXXXXXXXXXXXXXXXXXXXXXXXXXXXXXXXXXXXXXXXXXXXXX--XXXXXX-XX--XXXXXXXXXXX-------XX------XXXXXXXXXXX---XXXXXXXXXXXXXXXXXXXXXXXXXXXXXXXXXXXXXXXX-XXXXX-XXXXXXXXXXXXXXXXXXXXXXXXXXXXXXX-XXXXX--XXXXXXXXXXXXXXXXXXXXXXXXXXXXXXXXXXXX-XXXXXXXXXXXXXXX-X
