----------------------------------------------------------------------------------------------------------------------------------------------------------------------------------------------------------------------------------------------------------------------------------------
------------------------------------------------------------------------------------------------------------------------------------------------------------------------X---------------------------------------------------------------------------------------------------------------
---------------------------------------------------------------------------------------------------------------------------------------S----SSSSSS----------SSSSS----S------------------------------------------------------------------------------------------------------------------
---------------------------------------------------------------------------------------------------------------------------------------------------------------------------------------------------------------------------------------------------------------------E------------------
-----------------------------------------------------------------XXX-------------------------------------------------------------------------------------------------------------------------------------------------------------------------------------------------XX-----------------
----------------XXX----------XXX------------------------------------Q------------------------------------------X-SSS---SSSS---------------S-----------------------------X----------SS----------------------------------------------------------------------------------?EQQ-------------
---------------XXXX---------------------------------------------------------------------------------------------------------------------------------------------------------------------------------------X-----------------------------------------------------------------------------
---------------XXXX-----------------------------------------------------------------------------------------------------------------------------------------------------------------------------------------------------------------------------------------E------S--------------------
--------------XXXXX------------------------------------------E----------E----------------------------------------------------------------------------------------------------E----------E---------------------------------------------------------------------SSSSSSS-----------------E-
----------X--XXXXXX-----------------------------------------<>----QE---<>-----------------------------------SS-----SSSSSSSS-------------------------SQ----------------------<>---------<>----------E---------------XXXXS-----------------E------E----------------------SSSSS---------<>-
>---------X-EXXXXXX-----------------------------------------[]---------[]-----------------------------------------E----------------E----------------------------------------[]---------[]---E-----<>-------------------------------------E-----<>------------------------------------[]-
]---------XXXXXXXXX-----------------------------------------[]---------[]------------------------------------------------S--------<>------------------------<>-X------------[]---------[]---><>---[]-------------------------------------------[]----<>------------------------------[]-
]--E------XXXXXXXXX-----------------E---E----------E--------[]---------[]-E----------------EE----------------------------E--------[]--------------E---------[]-X------------[]---------[]---][]---[]----------------------------EE-----------E-[]----[]------------------------E-----[]-
XXXXXX-XXXXXXXXXXXXX----XXXXXX-X-XXXXXXXXXXXXXXXXXXXXXXXXXXXXXXXXXXXXXXXXXXX---XXXXXXXXXXXXXXXXXXXXXXX---XXXXXXXXXXXXXXXXXXXXXXXXXXXXXXXXXXXXXXXXXXXXXXXXXXXXXXXXXXXXXXX--XXXXXXXXXXXXXXXXXXXXXXXXXXXXX--X------XXXX--XXXXXXXXXXXXXXXXXXXXXXXXXXXX---XXXXXXX--XXXXXXXXXXXXXXXXXXXXXXXXXX
