----------------------------------------------------------------------------------------------------------------------------------------------------------------------------------------------------------------------------------------------------------------------------------------
----------------------------------------------------------------------------------------------------------------------------------------------------------------------------------------------------------------------------------------------------------------------------------------
----------------------------------------------------------------------------------------------------------------------------------------------------------------------------------------------------------------------------------------------------------------------------------------
---------------------------------------------------------------------------------------------------------------------------------------------------------------------------------E------------------------------------------------------------------------------------------------------
---------------------------------------------------------------------------------------------------------------------------------------------------------------------------------XXX----------------------------------------------------------------------------------------------------
----------------X-----------------------------------------------------------------------SSSSSSSSS-SS----SSSSSSSS----SSSSSSSS---------SSSSSSS-----------------------------------------QQ-------------------------------E-----------------------------------------------------------------
----------------X-----------------------------------------------------------------------------------------------------------------------------------------------------------------------------------------------------------------------------------------------------------------------
----------------X------------------------------------------------------XX-----------X------------------------------------------------------------------------------------------S--------------------------------------------------------------------------------------------------------
----------------XX----------------------------------------------------XXX---------------------------------------------------------------------------------------------------SSSSS-------------------------------------------------------------------------------------------------------
-E-------------XX-----------------------------------------------------XXX----------------SSSSSSS----------------------SSS---Q----------------------------XXXX----------------------QQQQQ----------E--------------XXXX----------------------------SS---------X---------------------------
<>-------X--XXXXX----X------------------------------------------------XXX--------------------------------------------------------------------------------X---------------------------------------<>--------------XX-XX----------------------------------------------------EXXX----------
[]----------XXXXXX---XX----------------------------------------------XXXX--------------------------------------------------------------------------------XX--------------------------------------[]------------XXXXXX------------XXX----------------------------------------------------
[]-E--------XXXXXX---X-----X------------EE-------E-------E-EE------E-XXXX-----------------------------EEE-------------------------E--------------------X-X-----------------------E---------------[]-----------XXXXX---------------------------------------------------------------------
XXXXXXXXXXXXXXXXX---XXXXXXXXXXXXXXXXXXXXXXXXXXXXXXXXXXXXXXXXX-XXXXXXXXXXXXXXXX--XXXXXXXXXXXXXXXXXXXXXXXXXXXXXXXXXXXXXXXXXXXXXXXXXXXXXXXXXXXXXXXXXX---XXXXX--------------XXXXXXXXXXXXXXXXXXXXXXXXXXXXXXXXXX--XXXXXXX---XX-X--X-XXXXXXXXXX-----XXXXXXXXXXXXXXXXXXXXXX---XXX---------------
