----------------------------------------------------------------------------------------------------------------------------------------------------------------------------------------------------------------------------------------------------------------------------------------
----------------------------X-----------------------------------------------------------------------------------------------------------------------------------------------------------------------------------------------------------------------------------------------------------
----------------------------SS--------------------SSSSSS--------------------------------------------------------------------------------------------------------------------------------------------------------------------------------------------------------------------------------
---------------------------------------------------------------------------------------------------------------------------------------------------------------------------------------------------------------------------------------------------------------------E------------------
---------------------------------------------------------------------------------------------------------------------------------------------------------------------------------------------------------------------------------------------------------------------XXX----------------
----------------------------X-----------S----------------------------------------------------------X--------------------------------------------------SQSQQ-------------Q---------------------------------------------------------------------------------------------------------------
---------------------------------------------------------------------------------------------------X-----------------------------XX-----------------------------------------X-----------------------------------------------------------------------------------------------------------
-----------------X-----------------------------------------------------X--------------------------XX----------------------------XXX-----------------------------------------------------------------------------------------------------------------------------------------------------
----------------XXX-------------------E---------------------------------------------------------XXXX---------------------------XXXX-----------------------------------------------------------------------------------------------------------------------------------------------------
--------Q-------XX---------------E---<>-----E---------------------------------------------------XXXX--------------------------XXXXX--------------------SSSSS-------------------------XXXXX---------------E---------<>-----------------------XX-----------------------------Q----------E-
----------------XX--------------<>---[]----<>---E------E--------------------------------------XXXXXX-------------------------XXXXXX----------------------------------E----------------------------------<>---------[]----------------------XXX------------------------E--------------<>-
-------------XXXXX--------------[]---[]----[]--<><>---<>---------------X---------------------XXXXXXX------------------------XXXXXXX---------------------------------------------------------------------[]---------[]---------------------XXXX-----------------------<>--------------[]-
E--E--------XXXXXX--------------[]---[]E-E-[]--[][]---[]----------EE--EX----------EE---E----XXXXXXXX--------E--E----------XXXXXXXXX---------------------------------------------------------------------[]-----E---[]-------------------EXXXXX-------EE-EE-E---------[]--------------[]-
XXXXXXXXXXXXXXXXXXXX----XXXX-XXXXXXXXXXXXXXXXXXXXXXXXXXXXXXXX-XXXXXXXXXXXXXX--XXXXXXXXXXXXXXXXXXXXXXXXXX-X--XXXXXXXXX----XXXXXXXXXXX---XXXXX--XXXXXXXX-XXXXXXXXXXXXXXX--XX--XXX---XXX---------------XXXXXXXXXXXXXXXXXXXX---XXXXXX-XXXXX-XXXXXXXXXXXXXXXXXXXXXXXXXXXXXXXXXXXXXXXXXXXXXXXX
