----------------------------------------------------------------------------------------------------------------------------------------------------------------------------------------------------------------------------------------------------------------------------------------
------------------------------------------------------------------------------------------------------------------------------------------------------------------------X---------------------------------------------------------------------------------------------------------------
------------------------------------------------------------------------------------------------------------------------------------------------------------------------SSSSSSSSSSSSSSSSSSSSSSSSSSSS------------------------------------------------------------------------------------
---------------------------------------------------------------------------------------------------------------------------------------------------------------------------------------------------------------------------------------------------------------------E------------------
------------------------------------------E---------------------------E----------------------------------------------------------------------------------------------------------------------------------------------------------------------------------------------X------------------
----------------------------------------------------------------------------------------------------------------------------------------------------------------------------------------------------------------------XX----------S-------------------------------------EQ--------------
--------------------------------XXXX-------------XXXXX--------XX---------------X--------------------------------------------------------------------------------------------------------------------------------------------------------------------------------------------------------
-------------------------------------------------------------------------------------------------------------------------------------------------------------------------------------------------------------------------------------------------------------------S--------------------
---------------------------------------------------------------------------------------------------------------------E----------E-------------------------------------------------E---------------------X---------------------E-------------------------------SSSSSSS-----------------E-
-----------------------------------------XXXXXXS-------Q---------------XXXXSSS-----Q-------------------------SSS---------------<>----------E---------------------------------S---<>-----E------------------------------------Q-----------------------------------------SS?SS---------<>-
-----------------------E---------------------------------------------------------------------------------------------E---------[]---------<>-------------------------------------[]---------E--------------------------------E-------------------------------------------------------[]-
----------------------------------------------------------X--------------------------XXX----------------------------<>---------[]---------[]----------------------------SS-------[]--------<>--------------------------------X-------------------------------------------------------[]-
------------------E----------------------E-------E-E-----------------E-------E--------------E----E-------E-E--------[]---------[]---------[]-------E-EE-----------------S--------[]--------[]---------X--------------------------------------------------------------E---------E-----[]-
XXXXXXXXXXXXXXXXXXXXXXXXXXXX-----X------XXX---XXXXXXXXXXX----X--XXX-XXXXXXXXXXXXXXXXXXXXXXXXXX--XXXXXXXXXXXXXXXXXXXXXXXXXXXXXXXXXXXXXXXXXXXXXXXXXXXXXXXXXXXXXXX--XXXXXXXXXXXXXXXXXXXXXXXXXXXXXXXXXXXXXX---XX----------XXXXXXXXXXXXXXXXXXXXXXX--XXXX---------XXXXXXXXXXXXXXXXXXXXXXXXXXXX
