--------------------------------------------------------------------------------------------------------------------------------------------------------------------------------------------------------------------------------X-------------------------------------------------------
----------------------------------------------------------------------------------------------------------------------------------------------------------------S-----------------------------------------------------------------------------------SSS----S----------------------------
SSSSSSSSSSSSSSSSSSSSSSSSSSSS------------------------------------------------------------------------------------------------------------------------------------SS-----S----------------------------------------------------------SSSSSSSSSSSSSS----SSSSSSSS----------------------------
----------------------------------------------------------------------------------------------------------------------------------------------------------------SS---SSS----------------------------------------------------------SSSSSSSSSSSSSS----SSSSSSSS----------------------------
---------------------------------------------------------XXXXX-----------------------------------------------------------XXX-------------------EE---------------SS---SSS--------------------------------------------------------X--SSSSSSSSSSSSS----SSSSSSSS----------------------------
-S--------------------------------------------------XXXXS----------------SSSSSSS--------------------------------------------QQQ-------------SSSSSSSSSS----SS-----------S-------Q--QQQQQ--------------------------------------------SSSSSSSSSSSSS----SS----SS----------------------------
----------------------------------------------------------------------------------------E---------------------------------------------------------------------------------------------------------------------------------------EE-S----------------------------------------------------
--------------------------------------------------------------------------------------------------------------------------------------------------------------------------------------------------------------------------------X------------------------------------------XXXXX--------
---------------------------------------------------------------------------------------------------------------------S------------------------EE------------------------------------------------------------------------------------E---------------------------------------------------
SSSS----S-S---------X-------------------------------S---XXXXX-------------XXXX----XX--------------XXXX--------------E-----QQQQQQQQ------------S?SSSSS-----E-----------X-------Q---QQQQQQQQ------------------------XXXX------------E-SSSSSSSS--------------------------------------------
-----------------X-XX------------------------------------------E---EXX----------------------------------------------------------------------------SS------------------------------------------------------------------------------E--------------------E-------------------------E------
----------------<X-XX-----------------------------------------<>---------------------------------------------------------------------------------SS---------X-X-------X--------------------------X]------------------------------SS--X----------------<>-------------------------------[
E-----E-------X-[]-XX-----------------------------------------[]-------XX-----------------------------------------------------------------------------------X---XXX---X--------------------E-----[]------------------------------[]------E--------EEE-[]-----EE-EEE-E-EEE-EE------E-EE-E
XXXXXXXXXXXXXXXXXXXX---XXXXXX-XXXXXXXXXXXXXXXXXXXXXXXXXXX------XXXXX---XXXXXXXX-XXXXXXX-------XX----------------XXXXXXXXXXXXXXXXXXXXXXXXXXXXXXXX-XXXXXXX----------------XXXXXXXXXXXXXXXXXXXXXXXXXXXXX----X-----XX--------XXXXXXXXXXXXXXXXXXXXXXXXXXXXXXXXXXXXXXXXXXXXXXXXXXXXXXXXXXXXXXX
