----------------------------------------------------------------------------------------------------------------------------------------------------------------------------------------------------------------------------------------------------------------------------------------
----------------------------------------------------------------------------------------------------------------------------------------------------------------------------------------------------X-----------------------------------------------------------------------------------
--------------------------------------------------------------------------------------------------------------------------------------------------------------------------SSSSSSSSSSSSSSSSSSSSSSSSSS------------------------------------------------------------------------------------
----------------------------------------------------------------------------------------------------------------------------------------------------------------------------------------------------------------------------------------------------------------------------------------
--------------------------------------XX------------------------------------------------------------------------------------------------------------------------------------------------------------------------------------------------------------------------------------------------
-----------------------------------------------------------S---------------SSSSSSS-----SSSSSSS----SS----SSSSSSSS-----------------------------------------------------------S---SSSS---------------S----------------------------------X---------E-----------------------------------SS---
----------------------------------------------------------------------------------------------------------------------------------------------------------------------------------------------------------------------------------------------------------------------------------------
-----------------------------------------------------------------------------------------------------------------------------------------------------------------------------------------------------------------XX--XXX------------------------XXXX------------------------------------
-----------------------E---------E----------E-------------XX--------------------------EE-------------------------------------------------------------------------------------------------------------------------X----------------------------------------------------------------------
----------------------<>---E---------------<>-------------XXX-------XXX---------------S?SS-------EX------------------------------X---------S--------------XXX--------------S-SSSSSS---------------------------------------SS-S--------------X-------------------------------------------
----------------------[]--<>-----E---------[]---------E-----------------------------------SE----X--------------------------------------------------------XXXXX------------E-----------------------------------E-----E----------------------XX------------------------------X------------
----------------E-----[]--[]----<]---------[]--------<>-----------------X---------------------------X-------------X--------------------------------------XXXXX-----------------------------<>----------------<>----------------------------XX-------------------------------------------
----------------X-----[]--[]----[]---E-----[]--------[]---------------------------------------------X------------------------E-------------------------XXXXXXX-------------------E---------[----------E--E----]-----------EE-E----E---E-EXXXX---------E-EE-E----------------------------
XXXXXXXXXXXXXXXXXXXXXXXXXXXXXXXXXXXXXXXXXXXXXXXXXXXXXXXXXXX----XXXX-----------------XXX---XXXXXXX---XXXXXX-----------XX-X---XXXXX-XXXXXXXXXXXXXXX---XXXXXXXXXXXXXX--XXXXXXXXXXXXXXXXXXXXXXXXXXXXXXXXXXXXXXXXXXXXXXXXXXXXXXXXXXXXXXXXXXXXXXXXXXXXXXXXXXXXXXXXXXXXXX--XXXXXXXXXXXXXXXXXXXX
