----------------------------------------------------------------------------------------------------------------------------------------------------------------------------------------------------------------------------------------------------------------------------------------
----------------------------------------------------------------------------------------------------------------X-----------------------------------------------------------------------------------------------------------------------------------------------------------------------
----------------------------SSSSSSSSSSSSSSSSSSSSSSSSSSSS------------------------------------------------------------------------------------SSSSSSSSSSSSSSSSSSSSSSSSSSS------------------------------------SSSSSSSSSSSSSSSSSSSSS--------------------------------------------------------
----------------------------------------------------------------------------------------------------------------------------------------------------------------------------------------------------------------------------------------------------------------------------------------
-------------------------------------------------------------------------------------------------------------------------------------------------------------------------------XX-------------------------------------------------------------------------------------------------------
---------------------------------------------------------SS-------------------SSS--------------------S-----------------------------------------------------------------------------------XXX--------SS-------------------------------------SS-------------------------------XX----------
----------------XXXX--------------------------------------------------------------------------------------------------------------------------------------------------------------------------------------------------------------------------------------------------------XX----------
---------------------------------------------XX----------------------------------------------------XX------------------------XX----X---------------------------------------------------------------------------------------------------------------------------------------XXX----------
--------------------------------------------XXX----------------------------------------------------X---------------------------------------------------------SSS-----------XXXX-------------------E---------------------------------------------E--------------------------XXX----------
--------------------SS--SSSS--------Q--------X----------SSSQ---------------------------------------X-----------E----------------------S-------------SQS-----------------------------XX-----------<>-SSS--------------XXXX------------E---------<E-------------------Q-X----XXX----------
--------------------------------------------XX----------------------------X-----------------------------------<>-----E----E-----E----E----------------------------X----X-------------------------[]------------------XXXX-----------<>---------[>---E--------------------XXXXX----------
XXXX--------------------------------------XXXXXX------------------------XXX------------------------XX---------[]----<>---<>----<>----------[----------------<>-X--X---XX-------------------------[]----------------XXXXXX-----------[]---------[]--<>-------------------XXXXXX----------
--------E------------E-E----E--E--E------XXXXXXX-----------------------XXXX-------------E------E---[]---------[]----[]---[]----[]--------E-[E-----E-------X-[]----X---XX-------------------------[]-------E-------XXXXXXX-----------[]---------[]--[]-------EE-E-------XXXXXXX----------
-----XXXXXX-XXXXXXXXXXXXXXXXXXXXXXXXXXXXXXXXXXXXX--XXXXXXXXXXXXXXXXXX--XXX----------XXXXXXXXX-XX-XXXXXXXXXXXXXXXXXXXXXXXXXXXXXXXXXXXXXXXXXXXXXXXXXXXXXXXXXXXXXX---XXXXXX------------------XXXXXXXXX-XXXXXXXXXXXXXXXXXXXX---XXXXX-XXXXXXXXXXXXXXXXXXXXX-X-XXXXXXXXXXXXXXXXXXXXXXX---XX--X
