----------------------------------------------------------------------------------------------------------------------------------------------------------------------------------------------------------------------------------------------------------------------------------------
----------------------------------------------------------------------------------------------------------------------------------------------------------------------------------------------------------------------------------------------------------------------------------------
----------------------------------------------------------------------------------------------------------------------------------------------------------------------------------------------------------------------------------------------------------------------------------------
----------------------------------------------------------------------------------------------------------------------------------------------------------------------------------------------------------------------------------------------------------------------------------------
----------------------------------------------------------------------------------------------------------------------------------------------------------------------------------------------------------------------------------------------------------------------------------------
------------------------------SSSSSSSS----SS---S-------S------------------------------------------------------XX------------------------------------------------------------------------XX----------SSSSS--SSS---------------------------------------------X---------------XXX----------
-------------------------------------------------------------------------XXX-----------------------------------------------------------------------------------------------------------XXX--------------------------------------------------------------------------------XXXX----------
--------------------------------------------------------------------------------------------------------------------------------------------------------------------------------------XXXX-------------------------------------------------------------------------------XXXXX----------
-----E----------E-------------EE-----------------------------------------------------------------------------------------------------------------------------------------------------XXXXX------------------------------------------------------------------------------XXXXXX----------
----<>---------<>-------------S?SSSSS----------------X---X-----------------------?SS----------------------SS--------------------------S-----------------------------SSS-----------XXXXXXXX-----------?SSS--------------------------------------------SSSSSSS-E---------XXXXXXX----------
----[]---------[]----------E-------S---------------E-----X-----------------------------------------------------------E----------E----E--------------------------------------------XXXXXXXX---------E-------E----------X-------------------------------------<>-------XXXXXXXXX---X-----E
----[]---------[]---------<>----------------------<>-X--XX----------------------------------------------------------<>---------<>---<>-------------------------------------------XXXXXXXXX--------<>----------------X-XX------------------------------------[]-------XXXXXXXXX---X----<>
----[]-----E---[]---------[]--------------------E-[]-X--XX-----E----------------------------E-E-E---------E---------[]---------[]---[]-----E-------E--------------------EE-E-----XXXXXXXXX--------[]---------------XX-X----------------EEE------------------[]-EE----X-XXXXXXX---X----[]
XXXXXXXXXXXXXXXXXXX---XXXXXXXXXXXXXXX--XXX-XXXXXXXXXXXXXXXXXXXXXXXXXXXXXXXXXXXXXXXXX--XX-XXXXXXXXXXXXXXXXXXXXXXXXXXXXXXXXXXXXXXXXXXXXXXXXXXX---XXXXXXXXXXXXXXXXXXXXXXXXXXXXXXXXXXXXXXXXXXXXX-XXXX-XXXXXXXXXXXXXXX---X--------------XXXXXXXXXXXXXXXXXXXXXXXXXXXXXXXXXXXXXXXXXXXXXXXXXX-XX
