----------------------------------------------------------------------------------------------------------------------------------------------------------------------------------------------------------------------------------------------------------------------------------------
----------------------------------------------------------------------------------------------------------------------------------------------------------------------------------------------------------------------------------------------------------------------------------------
------------------------------------------------------------------------------------------------------------------------------------------------------------------------------------------------------------------------------------------------------------SSSSSSSSSSSSSSSSSSSSSSSSSSSS
----------------------------------------------------------------------------------------------------------------------------------------------------------------------------------------------------------------------------------------------------------------------------------------
----------------------------------------------------------------------------------------------------------------------------------------------------------------------------------------------------------------------------------------------------------------------------------------
-------SQSSSS--------------------------------------SS-------------------------------SSS-----------------------------------SSSS--------------------------------E---XXXXX-Q---------------------------------------------------XXXX----------------------XXXX------------------------------
--------------------------------------------------------------XX-------------XXXXX------------------------------------------------------------------------------------------X------------------X----------------------------------------------------------------------------------------
----------------------------------------------------------------------------------------------------------------------------------------------------------------------------------------------------------------------------------------------------------------------------------------
-----------------------E-----------------------------------------------------------------------------------------XXSX---------------------E---------------------------------------------------------------------------------------------------------------------------E------SS---------
--E--SS--SSS----------<>----QQQ---------------XX-----------------------XXSSSS-------SSSQS-------------XX------XX-------S?--SSSSS---------<>----------------EXXX----------------------XXXXX--------------------------------------Q-Q------------------------->--S----SQS----------------X
-<>-------------------[]------------------XXXXXXX---------X--------------------------------E----------XX---------------------------------[]---------------EXXXX------------------------------------------------------------------------------XXX-------------------------------XX------X
-[]--X----------------[]-----------------------X--------XXXX------------------------------<>--------XXXX---------------------------------[]---------------X-X--------------------------------------------------------------------------------------------------------[------<>-XX------X
-[]---------------EE--[]-----------------------X------------------------------------------[]-------XX-XXX------X-------------------E-----[]-----------------------------------------------------------------------------------------------------------------E-----E---------[]-XX------X
XXXXXXXXXXXXXXXXXXXXXXXXXXXXXXXXXXXXXXXXX-----------XXXX-------------------XXXXXXXXXXXXXXXXXXXXXX--XXXXXXXXXXXXX--XXXXXXX---XXXXXXXXXXXXXXXXXXXXXX--XXXXXXX--XXXXX--XXXXX--------XXXX---------------XXXXX-XXXXXXXXXXXXXXXXXXXXXXXX------XXXX----------------XXXXXXXXXXXXXXXXXXXXXXXXXXXX
