----------------------------------------------------------------------------------------------------------------------------------------------------------------------------------------------------------------------------------------------------------------------------------------
----------------------------------------------------------------------------------------------------------------------------------------------------------------------------------------------------------------------------------------------------------------------------------------
SSSSSSSSSSSSSSSSSSSSSSSSSSSS------------------------------------------------------------------------------------------------------------------------------------------------------------------------------------------------------------------------------------------------------------
S-SSSSSSSSS-----------SS--SS------------------------------------------------------------------------------------------------------------------------------------------------------------------------------------------------------------------------------------------------------------
S-SSS-SSSSS------------S--SS------------------------------------------------------------------------------------------------------------------------------------------------------------------------------------------------------------------------------------------------------------
-SSSS--SSS---S------------SS-----------------------------------------------XXXXXSS-----------------------------X------------------------------------------------------------------------------------------E------E---E----------Q-------------------------------------------------------
----------------------------------------------------------------------------------------------------------------------------------------------------------------------------------------------------------XXX-------XXXXXX---------XXX-------------------X------------------------------
------------------------------------------------------------------------------------------------------------------------------------------------------------------------------------------------------X---------------------------------------------------------------------------------
-----------------------SS-------------------------------XXXXXX--------------------------------------------------------------------------------------------XX------------------------------------------------------------------XX--------------------------------------------------------
-SSSSSSSSSS--------E-------X----------------------------------------XXX----------------------------------SSSSSS--X------------------------E--------------XXX-----------------------------SSSSS---------X------------XSS--------S-------------XXXXX--------------------------------------
--SSSSSSSSS-------<>-------X------------------------------------------------------------------E------------------X-----------------------<>-----------XXXXXX-----------------------------------------EXX------------------------------------XX------------------------E-----E-----------
--SSSSSSSSS-------[]X------X-----------------------------------------------------------------<>------------------------------------------[]----------XXXXXXX----------------------------------------XXXX------------------------------------XX-----------------------<>-----------------
--SSSSSSSSS-------[]-----XXX-----------------------------------------------------------------[]------------------XX----------------------[]----------XXXXXXX--------E--E----------------------------X-XX------------------------------------XX-------E--E--------E---[]-----------------
XXXXXXXXXXXXXXXXXXXXXXXXXXXXXXXXX-XXXX-XXXXXX--XXXXXXXXX--------XXX-----------------XXXXXXXXXXXXXXXXXXXXXXXXXXXXXXXXXXXXX-----XXXXXXXXXXXXXXXXXXXX--XXXXXXXX-XXXXXXXXXXXXXXXXXXXX---XXXXXXXXXXXXXXXXXX---XX--------------XXXXXXX--------XXXXXX----XXXXX-XXXXXXXXXXXXXXXXXXXXXXX---XXXXXX
