----------------------------------------------------------------------------------------------------------------------------------------------------------------------------------------------------------------------------------------------------------------------------------------
----------------------------------------------------------------------------------------------------------------------------------------------------------------------------------------------------------------------------------------------------------------------------------------
-------------------------------------------------------------------->-------------------------------------------------------------------------------------------------------------------------------SSSSSSSSSSSSSSSSSSSSSSSSSSSS--------------------------------------------------------
-------------------------------------------------------------------[]-------------------------------------------------------------------------------------------------------------------------------------------------------------------------------------------------------------------
--------------------------------------------------------------------]----E--------------------------------------------------------------------------------------------------------------------------------------------------------------------------------------------------------------
-------Q-----------------------------------E-----------------------XXXX-----XXX------SSS---SSS--------------------------------------------------------------SSS-----------------------------------XX-SSS---SSS----------------S--SSS--SSSSSS-------------------------------X------------
-------------------------------------------X-------------------------------XX-----------------------------------------X-----------------------------------------E---------------------------------------------------------------------------------------------------------XXX-----------
------------------------------------------XX---------------------------------------------------------------------------------------------------------------------E-------------------------------------------------------------------------------------------------------XXXX-----------
-----------------------------------------XXX--------------------------------------XX------------------------------------------------------------------------XE------------------------------------------------E----------------------------------------E----------------XXXXXX----------
------Q---QQQ--?Q-----------------------XXXX-------------XX-----------------S---------SSS--SSS---------------------------------XXX-----------E---E---------XX-------------------------QQ-------SSS----SSS--SSSS----------------------SSSSSS-----------<>---------------XXXXXX-----------
--------------------------------------XXXXXX-------------XX--------------------------------------------E------------------------------------<>--<>---X--X-XXX----X-------------------------------------SS---SSS--------<-------X----------------------[]--------------XXXXXXX-----------
-------------------------X-----------XXXXXXX------------XXX-------------------------------------------X>------------------------------------[]--[]------XXXXX----XX------------------------------------SS--SSSS--------[]-----------------------------[]-------------XXXXXXXX-----------
-------------------------X----------XXXXXXXX--------E--EXXX-------------------------------------------[]---------------------E--------------[]--[]-----EXXXXX----X-----X---------E---------------------SS-ESSSS--------[]-------------------------E---[]-----E-E----XXXXXXXXXX------E--E
XXXXXXXXXXXXXXXXXXXXXXXXXXXXXXXXXXXXXXXXXXXXXXXXXXXXXXXX--------XXX-------X---------XXXXXXXXXXXXXXXXXXXXXXXXXXXX-----X------XXX-----XXXXXXXXXXXXXXXXXXXX--XXX---XXXXXXXXXXXXXXXXXXXXXXXXXXXXXXXXXXXXXXXXXXXXXXXXXXXXXXXXXXXXXXXXXXXXXXXXXXXXXXXXXXX-XXXXXXXXXXXXXXXXXXXXXXXXXXXXXXXXXXXX
