----------------------------------------------------------------------------------------------------------------X-----------------------------------------------------------------------------------------------------------------------------------------------------------------------
--------------------------------------------------------------------------------------------------------------------------------------S----S--------------------------------------------------------------------------------------------------------------------------------------------
----------------------------------------------------------------------------------------------------------------SSSSSSSSSSSSSSSSSSSSSSSSSSSS----------------------------------------------------------------------------------------------------------------SSSSSSSSSSSSSSSSSSSSSSSSSSSS
----------------------------------------------------------------------------------------------------------------SSSSSSSSSSSSSSSS----SSSSSSSS--------------------------------------------------------------------------------------------------------------------------------------------
----------------------------------------------------------------------------------------------------------------SSSSSSSSSSSSSSSS----SSSSSSSS---------------------------------------------------------------------------------------------XXX--------------------------------------------
---------------X--------------------------------------XX-----------?SSS----XXXX--S----X--------------------------SSSSSSSSSSSSSSS----SS----SS--------------------------X-------------------E----XX---------------------------------------------------------XX----------------------------
---------------X------------------------------------------------------------------------------------------------ES-S--------------------------------------------------------E-----------------------------------------------------------------------------------------------------------
--------------XX----------------------------------------------------------------------------------------------------------S----------------------------------------------------------------------------------------XXX-X----------------------------------------------------------------
--------------XX-----------------------------------------XXXXX---------------------X--------------------------------E-----S------------E-------------------------------------------------------------------------------------------------------------------------------------SS---------
--------------XX----------------------------------------------------SSS--------------------------------------------SSSSSSSSS-------E--<>-------------------XX-----------X--------------E-XX----------------------------------------------------Q------SSSS----------Q-S------X----------
-----------XXXXX-----E----------------------------------------------------------XE-S----------E-------------------E-SSS-----------<>--[]--------------------------------X-------------EXXXXX-------------------X---------E----------------E----------------------------------X-X--X-----
-----------XXXXX------------------------------------------------------------------------------E------------------SSSSSS--SS-------[]--[]--------------------------------X-------------X---------------------------------<>---------------<>--------------------------------XXX-XX-------
-E-E----XXXXXXXX-----------E------------EE-------E------------------------------------E--E-EE-E------------------SS------E--------[]E-[]-------------------------------------------------------------EE-EEE-E-EEE-EE----[]-----E---------[]-----------------E-----E-------X-[X-X--------
XXXXXXXXXXXXXXXXXXXXXXXXXXXXXXXXXXXXXXXXXXXXXXXXXXXXXXXX----XXXX----XXXXXXXXXXXXX---XXXXXXXXXXXXXXXXXX------XXXXXXXXXXXXXXXXXXXXXXXXXXXXXXXXXXXXXX--XXXXXXXXXXXXXXXXXXXXXXXXXX---XXXXXX---XXXX--XXXXXXXXXXXXXXXXXXXXXXXXXXXXXXXXXXXXXXXXXXXXXXXXXXXXX--XXXXXXXXXXXXXXXXXXXXXXXXX--XXXXXX
