----------------------------------------------------------------------------------------------------------------------------------------------------------------------------------------------------------------------------------------------------------------------------------------
----------------------------------------------------------------------------------------------------------------------------------------------------------------------------------------------------------------------------------------------------------------------------------------
----------------------------------------------------------------------------------------------------------------------------------------------------------------------------------------------------------------------------------------------------------------------------------------
----------------------------------------------------------------------------------------------------------------------------------------------------------------------------------------------------------------------------------------------------------------------------------------
----------------------------------------------------------------------------------------------------------------------------------------------------------------------------------------------------------------------------------------------------------------------------------------
----------------------------------------XXX-----------------------------------------------------------X----S------------------------------------------------XX----------------------------------XXXX--X----------------------------S---SSSS---------------------------------------------
---------------------------------------------XXXXX---------------------X------------------------------X----------------------------------------------------XXX--------------------------------------------------------------------------------------------------------------------------
----------------------------------------------------------------------XXX-----------------------------X--------------------------------------------------XXXXX--------------------------------------------------------------------------------------------------------------------------
------------------------------------------------------XX--------------XX------------SS---------------XX--------------------------------------------------XXXXX-----------------------------------------------------------------------------------------E--------------------------------
-----E---E------E-----------XXX---------------S-SS-----S-----------X--XX------------QQ--------------XXXX----------------------------------------------XXXXXXXX--------------------------------SSS-------------------------SSSSSS-----SS--SS-----------<>----------------------------SSSS
----<>---E-----<>---E------EXX-------------------------------------X--XX-----E---------------------XXXXXX---------------------------------------------XXXXXXXX--------------------E-----E-----------------------------------------E-------------------[]--------------------------------
----[]---------[]--<><>---<>XXX----------------------------------------X----<>------]-------------XXXXXX---------------------------------------------XXXXXXXXX-------------------<>----<>-------------------------------------------------------------[]--------------------------------
----[]-----E-E-[]--[][]---[]XXX--------------------------E--E------E--EX----[]-----E]-------------XXXXXX--------------------E---------------EE-E----XXXXXXXXXX------E--X-----E---[]----[]----------------E-EE-E------------E-------------E--------E---[]-----------E--------------------
XXXXXXXXXXXXXXXXXXXXXXXXXXXXX----XXXXXX-XXXXXXXXXXXXXXXXXXXXXXXXXXXX-XXXXXXXXXXXXXXXXXXXXXXXXXXXXXXXXXXX----XXXXXXXXXXXXXXXXXXXXXXXXXXXXXXXXXXXXXXXXXXXXXXXXXXXX-X-XXXXXXXXXXXXXXXXXXXXXXXXXXXXXXXXXXXXXXXXXXXXXXXXXXXXXXXXXXXXXXXXXXXXXXXXXXXXXXXXXXXXXXXXXXXXXXXXXXXXXXXXXXXXXXXXXXXXX
