------------------------------------------------------------------------------------------------------------------------------------------------------------------------X---------------------------------------------------------------------------------------------------------------
----------------------------------------------------------------------------------------------------------------------------------------------------------------------------------------------S-----------------------------------------------------------------------------------------
------------------------------------------------------------------------------------------------------------------------------------------------------------------------SSSSSSSSSSSSSSSSSSSSSSSSSSSS------------------------------------------------------------------------------------
-------------------------------E----------------------------------------------------------------------------------------------------------------------------------------SSSSSSSSSSSSSSS------SSSS-SS------------------------------------------------------------------------------------
------------------------------XXX---------------------------------------------------------------------------------------------------------------------------------------SSSSSSSSSSSSSSS-------SS--SS-----------------------------------------------------------------XXX----------------
----------------------------?--S-------------S?SSS--------------------------------------------------------------E----------------XX-----------XXXX---------E------------SSSSSSSSSSS--SS-----------SSX----------SS-----------------------------------------------------------------------
----------------------------------------------------------------------------------------------------------------XXXXXXXX----------------------------------------------------------------------------------------------------------------------------------------------------------------
-----------------------------------------------------------------------------------------------------X------------X-----------------------------------------XXXX------------------------------------------------------------------------------------------------------------------------
--SSSS-------------------------X-------------------------XXXXX--------------------------------------XXX-----------------------------------XX--------------------------------?------------------S?-------------------E--------------------------------------------SS---------------------
------------SSS--------------XXXX---------E----X-X---XX-------------SS----------------------Q-S-----XX----X--------X------------XXX-------------------------------------XSSSSSSSSSS--------E?------X-----E---------<>----------E-------------XXXX----------------------E--QQ----------E-
-----------------------------------E---EXX-----------XX--------------------------E------------------XX----X----E--XX------------------------------------X---------------SSSSSSSSSSS-------<>-------X----<>---------[]------E--<>------------XXXXX------------------------------------<>-
----------------------------------XX-----------------XX------------------------------------------XXXXX----X---XX---X------------------------------------X---------------SSSSSSSSSSS-------[]X------X----[]---------[]-----<>--[]-----------XXXXXX------------------------------------[]-
--------------------------------------------X---XXX--XX-----------------------------E--E--------XXXXXXX---X---XX---X--------------------------E--EE-E---X---------EEEE-ESSSSSSSSSSS-------[]X------X----[]---------[]-----[]--[]----------XXXXXXXX------E------------E---------------[]-
XXXXXXXXX---XXXXXXXXXXXXXX--------XX--------XXXXXXX-XXX-XXXXXXXXX---XXXXXXXXXXXXXXXXXXXXXXXXXXXXXXXXXX-XXXXXXXXX----------------------------XXXXXXXXXXXXXXXXXXXXXXXXXXXXXXXXXXXXXXXXXXXXXXXXX-XXXXXX--XXXXXXXXXXXX-XXXXXXXXXXXXXXXXXXX---XXXXXXX-XXXXXXXXXXXXXXXXXXXXXXXXXXXXXXXXXXXXXXX
