----------------------------------------------------------------------------------------------------------------------------------------------------------------------------------------------------------------------------------------------------------------------------------------
--------------------------------------------------------------------------------------------------------------------------------------------------------------------------------------------------------------------------------X-------------------------------------------------------
----------------------------------------------------------------------------------------------------------------------------------------------------------------------------------------------------------------------------------------------------------------------------------------
----------------------------------------------------------------------------------------------------------------------------------------------------------------------------------------------------------------------------------------------------------------------------------------
------------------------------------------E---------------------------------------------------------------------------------------------------------------------------------------------------------------------------------------------------------------------------------------------
------------------E----X-----------------------------------------------X------------------------------------------X------------------------------------------SSSSSSSSS-----------------X-S--------------------------X-----------------------S--------------------------------XXX-----S--
----E-----------------------------------------------------------------XXX-------------------------------------------------------------------------------------------------------------XX---------------------------XXX------------------------------------------------------------------
----------------------------------------------------------------------XXX-------------------------------------------------------------------------------------------------------------XXX--------------------------XXX---------------E--------------------------------------------------
--------------------------------------------------------------------XXXXXE---------------------------------------------------------------------X--------------------------------------XX--------------------------XXXX---------------E----------E---------------------------------------
X--------------EX-E------------------------------------------------X-XXXX----------E-----Q----------E-----------------------------------------XXX-------XXX------------------------X--X------------E-------------XXXXX--------------<>---------<>----------E-----------------?S-S-------
X-------------EXXXXX--------------------X-------------------------XXXXXXX---------<>---------------<>------E----------------XX-----------------------------------------------E-----X---X-----E----<>----------X-EXXXXX--------------[]---------[]----X----<>----------------------------
X---------------------------------------X--------------------------XXXXXX---------[]---------------[]-----<>---------------XXX----------------------------------------------<>---------X----<>----[]---------X-XXXXXXX--------------[]---------[]---<>X---[]----------------------------
----------------------------------------XE-------E-E-----E-EE----XXXXXXXX---------[]---------------[]-----[]---X--------EXXXXX-E--------E-EE-----------------------------E--[]-----E--EX----[]----[]EE-E-------XXXXXXX-----------E--[]---------[]---[]----[]----------------------------
XXXXXX----XXX---------------XXXXXXXXXXXXXXXX---XXXXXXXXXXXXXXXXXXXXXXXXXXXX--XXXXXXXXXXXXXXXXXXXXXXXXXXXXXXXXXXXXXXXXXXXXXXXXXXXXXXXXXXXXXXX-------XXXX-----------------XXXXXXXXXXXX-XXXXXXX-XXXXXXXXXXXXXXXXXXXXXXXXXXX----X--X--XXXXXXXXXX-XXXX---XXXXXXXXXXX----X-------XXXXXXXXXXX-X
