----------------------------------------------------------------------------------------------------------------------------------------------------------------------------------------------------------------------------------------------------------------------------------------
----------------------------------------------------------------------------------------------------------------------------------------------------------------------------------------------------------------------------------------------------------------------------------------
----------------------------------------------------------------------------------------------------------------------------------------------------------------------------------------------------------------------------------------------------------------------------------------
----------------------------------------------------------------------------------------------------------------------------------------------------------------------------------------------------------------------------------------------------------------------------------------
-----------------------------------------------------------------------------------S----------------------------------------------------------------------------------------------------------------------------------------------------------------------------------------------------
---------------------------------------------------------------S---------SSS-------------------------SSS---------XXX--------------------------SSSSSSSS---SSS------SSSSSS------------------------------------------------------------------------------XXXX-------SSSSSSSS-----------SSSS
--------------------------------------------------------------------------------------------------------------------------------------------------------------------------------------------------------------------XXXX----------------------------------------------------------------
----------------------------------------------------------------------------------------------------------------------------------------------------------------------------------------------------------------------------------------------------------------------------------------
--------------------------------------E--------------------------------------------------------------------------------------------------------E------------------------------------------------------------------------------E---------------------------------------------------------
-------------X-XX----------------E---<>-----E-----------SXXXX-------------XX------XXSQQXX-------------XX--<>-----------------------------SSS--SSSSSSSS---------E-------------------------------------X------------------------SSX--------------XXXXXXX-----------SSSSSSS----------------
------------XX-----------------------[]----<>---E--E---E-------E---EX-----XX------------------------------[]---------------------------------------S----------<>------------------E---------------E--X----------------------------------------------------------------------------------
------------XX-----------------------[]----[]--<>-<>--XX------<>----------XX------X-------------------X---[]-------------------------------------X------------[]-----------------<>--------------<>-XXX---------------------------------------------------------------------------------
-----------XXX-------E--E------------[]----[]--[]-[]--XX------[]-------XX-XXX-E--XXX----------------------[]-----------EE--------------E----------------------[]-----------------[]--------------[]-XX------------------------------------------------------------------------EE--------
XXXXXXX-XXXXXXXXXXXXXXXXXXXXXXXXXXXXXXXXXXXXXXXXXXXXXXXXXXX--XXXXXXXX--XXXXXXXXXXXXXXXXXXXXX---XX--XXXXXXXXXXXXXXX--XXXXXXXXXXXXX----XXXXXXXXXXXXXXXXXXXXXXXXXXXXXXXXXXXXXXXXXXXXXXXXXXXX-------XXXX-----XXXXXX---XX------XXXXXX-----------XXXX---XXXXXXXXXXXXXXXXXXXXXXXXXXXXXXXXXXXXXX
