----------------------------------------------------------------------------------------------------------------------------------------------------------------------------------------------------------------------------------------------------------------------------------------
------------------------------------------------------------------------------------X---------------------------------------------------------------------------------------------------------------------------------------------------------------------------------------------------
----------------------------------------------------------------------------------------------------------------------------------------------------------------------------------------------------SSSSSSSSSSSSSSSSSSSSSSSSSSSS--------------------------------------------------------
----------------------------------------------------------------------------------------------------------------------------------------------------------------------------------------------------------------------------------------------------------------------------------------
---------------------------------------------------------------------------------------------XXX----------------------------------------------------------------------------------------------------------------------------------------------------------------------------------------
-------------------------------S---------------------------------------------------X-------------------------------------------------------------------?SSS------------------------------XX-------------------------------------------------------X-------------------------------------
----------------------------------------------------------------------------------------------------------------------------------------------------------------------------------------XXX-------------------------------------------------------X-------------------------------------
------------------------------------------------------------------------------------------------------------------------------XXXXXX---------------------------------------------------XXXX--------------------------SX--------------------------XX------------------------XE-----------
-----------------------------------------------------------------------------------------E----------Q----------------------------------------XSSSSSSS------------------E--------------XXXXX-------------------------XXXS---------S---------------XX--------------E---------X------------
-------------------------S---------------------------------------------------SSSSSS----------------->-----S--------------------------------E-----------SSSSS----------------------X--XXXXXX-----------------Q-S------X----X-----X--------------XXXX-------------<>---------------------E
------------------------------------------------------------------E----------------------E----E----[]---------------------------E---------<>--------------------------------------X-EXXXXXX--------------------------X-X--X----X--------------EXXXX-------------[]----------E----E----<>
----------------------------------------------X------------------<>---------------------<>---<>----[]--------------------------<>---------[]--------------------------------------XXXXXXXXX--------->------------XXXXX-X--X----X-------------EXXXXX-------------[]---------<>---<>----[]
--------E----E---------E----------------------X--------------E---[]---------------------[]---[]----[]---------E[--E-EE----E----[]---------[]-------------------------------------XXXXXXXXXX---------E-----E------XXXXX-X--X----X--------------XXXXX--------X-E--[]---------[]---[]----[]
XXXXXXXXXX-XXXXXXXXXXXXXXXXXXXXXXXXXXXXXXXXXXXXXXXXXXXXXXXXXXXXXXXXXXXXXXXXXXXXXXXXXXXXXXXXXXXXXXXXXXXXX--XXXXXXXXXXXXXXXXXXXXXXXXXXXXXXXXXX---XXXXXXXXXXXXXXXXXX-------XXXXXXXX-XXXXXXXXXXXXXXXXXXXXXXXXXXXXXXXXXXXXX-XXXXXXXXXXXXXXXX---XXXXX----XXXXXXXXXXXXXXXXXXXXX-XXXXXXXXXXXXXXX
