----------------------------------------------------------------------------------------------------------------------------------------------------------------------------------------------------------------------------------------------------------------------------------------
----------------------------------------------------------------------------------------------------------------------------------------------------------------------------------------------------------------------------------------------------------------------------------------
---------------------------------------------------------------------------------------------------------------------------------------------------SS-----------------------------------------------------------------------------------------------------------------------------------
----------------------------------------------------------------------------------------------------------------------------------------------------------------------------------------------------------------------------------------------------------------------------------------
----------------------------------------------------------------------------------------------------------------------------------------------------------------------------------------------------------------------------------------------------------------------------------------
--------------------------------------------XX-----------------Q--QQQQQ------------S--------------------------------------------X---------------------------X---------------XX-----------------------XXX-----------------------------------------------------XXX------------------------
-------------------------------------------XXX----------------------------------------------------------------------------------XX--------------------------X-------------------------E-------------------------------------------------------------------------------------------------
------------------------------------------XXXX---------------------------------------------------------------------------------XXX--------------------------XX-----------------------XXXXXXX-----------------------------------------------------------------------------------X--------
-----------------------------------------XXXXX---------------------------------------------------------------------------------XXX--------------------------XX-S------------------------------------------------------------------------------------------------------------------------
---------Q------E----------------------X-XXXXX--------------E-Q---QQQQQQQQ---------------------------------------E---------XXX-XXX----------<>----------X----X----X---------------------------S----------------------------------X------------------SS--S-------------------------------
---------------<>---------------------XXXXXXXX---X--------------------------------------------E-----E-----------<>-------X--XXXXXX---XX----E<>-------E------XX----X----E---------------------------------------------------------X------------------------------------------------------
---------------[]---------XX---------XXXXXXXXX---X-------------------------------X-----------<>-----------------[]-------X--XXXXXX---XX----X[]----------XXXXXX----X---<>----------------------------------------------------------------------------------------------------------------
---------------[]---------XXEE-E-----XXXXXXXXX---X-----X-------------------E-----X-------E---[]--------------EE-[]-E--------XXXXXX---XX----X[]----------XXXXXX----X---[]--E--EE-E-E-E---------E--E-E------------E----------E--E-XXX---------------------------E-----E-E-E------------E-E
XXXXXXXXXXXXXXXXXXXXXXXXXXXXXXXXXXXXXXXXXXXXXXXXXXXXXXXXXXXXXXXXXXXXXXXXXXXXXX-XXXXXXXXXXXXXXXXXXXXXXXXXXXXXXXXXXXXXXXXXXXXXXXXXXXX---XXX--XXXXXXXXXXXXXXXXXXX---XXXXXXXXXXXXXXXXXXXXXXXXXXXXXXXXXXX-----XXXXX--XX-------XXXXXXXXXXXXXXXXXX--XXXXXXXXXXXXXXXXXXXXXXXXXXXXXXXXXXXXXXXXXXX
