----------------------------------------------------------------------------------------------------------------------------------------------------------------------------------------------------------------------------------------------------------------------------------------
----------------------------------------------------------------------------------------------------------------------------------------------------------------------------------------------------------------------------------------------------------------------------------------
---------------------------------------------------------S--------------------------SSSSSSSSSSSSSSSSSSSSSSSSSSSS--------------------------------------------------------SSSSSSSSSSSSSSSSSSSSSSSSSSSS--------------------------------------------------------SSSS--------------SS--------
----------------------------------------------------------------------------------------------------------------------------------------------------------------------------------------------------------------------------------------------------------------------------------------
----------------------------------------------------------------------------------------------------------------------------------------------------------------------------------------------------------------------------------------------------------------------------------------
----X-------------------------------------------------------------------X-------------------------------------------------------------------------------------------------------S---------------------------------------------------------QQ--------------------------------------------
------------------------------------------------------------------------X-------------------------------------------------------X-------------------------------------------------------------------------------------------------------------------------------------------------------
----------------XXXX-----------------------X----------------------------XX---------------------------S--------------------------------------------------------------------------------------------------------------X-------------------------------------------------------------------
------------------------------------------XX----------------------------XX--------------------------XSSS--------------------------------------------------------------------------E--------------------------------XX-------------------------------------------------E-----------------
-----------------------------------------XXX------------<>----------X---XX---------E<>--------------------X----------------------------SSSSS-----E---E------E--------------S-----<>---------E------X---------------XX---------------E-Q---QQQ--?Q--------------------<>-----------------
----------------------------------------XXXXX-----------[]-------E--X---X-----X---<>[]-------E-----------XX-------------------------------------<>---E-----<>---E------E---S-----[]--------<>------X--------------XXX----------------------------------E--E----------[]------------E----
--------------------------------------XXXXXXX-----------[]----------XXXXXX----X---[][]-----------XXXX>---XX------XX-----------------------------[]---------[]--<><>---<>---S-----[]--------[]------X-------------XXXX---------------------------------<>-------------[]--------XX-->---X
--E--EE-E-E-E------------E-E----------XXXXXXXX------E--E[]----------XXXXXX----X---[][]-----------XX-[]----X-------------E------------E-E--------[]---------[]--[][]---[]------E--[]--------[]----XXX-E-EE------E-XXXX------------------------------E--[]-------------[]-----------[]--XX
XXXXXXXXXXXXXXXXXXXXXXXXXXXXXXXXX---XXXXXXXXXXXXXXXXX-XXXXXXXXXXXXXXXXXXXXX---XXX-XXXXXXXXXXXXXXXXXXXXXX--XXXXXXX---XXXXXXXXXXXXXXXXXXXXXXXX-XXXXXXXXXXXXXXXXXXXXXXXXXXXXXXXXXXXXXXXXXXXXXXXXXXXXXXXXXXXX--XXXXXXXXXXXXXXX--XXXXXXXXXXXXXXXXXXXXXXXXXXXXXXXXXXXXXXXXXXXXXXXXXXXXXXXXXXXX
