----------------------------------------------------------------------------------------------------------------------------------------------------------------------------------------------------------------------------------------------------------------------------------------
----------------------------------------------------------------------------------------------------------------------------------------------------------------------------------------------------------------------------------------------------------------------------------------
----------------------------------------------------------------------------------------------------------------------------------------------------------------------------------------------------------------------------------------------------------------------------------------
----------------------------------------------------------------------------------------------------------------------------------------------------------------------------------------------------------------------------------------------------------------------------------------
-------------------------------------XX-------------------------------------------------------------------------------------------------------------------------------------------------------------------------------------------------------------------------------------------------
Q--------------------------------------QQQQ---------SSSS----------S------------------------------------------------------------------------------------------------------------QQQQQQQQ-----------------------------------------Q-----------------E-------------------------------------
------------------------------------------------------------------------------------------------------------------------------------------------------------------------------------------------------------------------------------E---------------------------------------------------
-----------------------------------------------------------------------------------------------------------------------------------X------------------------------------E------S--------------------------------------------------------------------------------------------------------
--------------------------------------------E---------------------------------------------------------SS-----------------------------------------------------------------------S------------------E------E----------E-----------------------------------------------------------------E-
-------------XXXXX--------------E-----QQQQ-?QQ------------E--SS--SS--------------------------E------E-------------------------------------------------------X---------------------QSSQQQ-Q-------<>-----E------E---<>-----------X------------XXXXX-----------X-----------------------QQ-
---------------------------------------------------------<>--------------------E-------------E-----------------E-----E----------E----E---------------------XX----------E-------------------------[]----------------[]------E--E-X------------XX-XX-----------X--------------------------
---------------------------------------------------------[]-------------------<>-------------------XE----<X---<>----<>---------<>----------[---------------XX---------<>-------------------------[]----------------[]-----<>-----------------XX--------------X--------------------------
----------------------------------------------EE---------[]------E--------EE--[]----E]-----------E-------XX---[]----[]---------[]----------[---E-------E-XXXX---------[]-------------------EE-E--[]-----E----------[]-----[]---------------XXX----------E---XXX-------------------------
XX--X----XXXX---------------XXXXXXXXXXXXXXXXXXXXXXXXXXXXXXXXXXXXXXXXXXXXXXXXXXXXXXXXXXXXXXXXXXXXXXXXXXXXXXXXXXXXXXXXXXXXXXXXXXXXXXXXXXXXXXXXXXXXX-XXXXXXXXXXXX----XX--XXXXXXXXXXXXXXXXXXXXXXXXXXXXXXXXXXXXXXXXXXXXXXXXXXXXXXXXXXXXXXXX---XXXXX----------X---XXXXXXXXXXXX--XXXXXXXXXXXXXX
