----------------------------------------------------------------------------------------------------------------------------------------------------------------------------------------------------------------------------------------------------------------------------------------
----------------------------------------------------------------------------------------------------------------------------------------------------------------------------------------------------------------------------------------------------------------------------------------
--------------------------------------------------------SSSSSSSSSSSSSSSSSSSSSSSSSSSS------------------------------------------------------------------------------------SSSSSSSSSSSSSSSSSSSSSSSSSSSS------------------------------------------------------------------------------------
----------------------------------------------------------------------------------------------------------------------------------------------------------------------------------------------------------------------------------------------------------------------------------------
----------------------------------------------------------------------------------------------------------------------------------------------------------------------------------------------------------------------------------------------------------------------------------------
--------------------------XX------------------------------------------------------------------------------------X---SSSSSQSSS--------S-----------------X-X---------------S--------------------------------------------------XXX---------------------------------------------------------
---------------------------------------------XX-----------------------------------------------------------------------------------------------------------------------------------------------------------------------------------------------------------------------------------------
----------------XXXX------------------------XXX-----------------------------------------------------------------]--------------------------------------------------------S--------------------------------------------------------------------------------------------------------------
-------------------------------------------XXXX-------------------E---------------------------------E-----------X-X---------------------------------------------------------------------------------------------------------------------------------------------------------------------
----------------------SS--------------X-----XXX--------->--S----S<>---------E------X---------------<>------------------S?S-S?SS----------X----XX-------------SSSSS------SSSS----S-S------X-XX-----------------------X------------------------------------SSS----------------------------
------------------------------------------XXXXX--------E---S-----[]--------<>------X-----E---------[]------------------------------------XX--XXX------------------------[----------------X-XX-X--------------------XX------------------------------------------------------------E------
-----------------------------------------XXXXXX-------X>S--S-----[]-----<>-[X------X---------------[]------------------------------------XX---XX------------------------]--------------XXXXXX----------------------XX------------------------------------------------------<------------
--E-EE--E-EEE-EE------E--E-EE--E--------XXXXXXX-------X]S-----E--[]-----[]-[X------X----E----------[]------------------------------EE-E--XX---XX------------------------]-----E-------XXXX-XX------------------E--XXX-------------------E--------------------EE-EE----EE--E[]----------E
XXXXXXXXXXXXXXXXXXXXXXXXXXXXXXXXXXXXXXXXXXXXXXX---XXX-XXXXXXXXXXXXXXXXXXXXXX--XXXXXXXXXXXXXXXXXXXXXXXXXXX--XXXXX-XXXXXXXX----X--XXXXXXX-XXX-XXX-----XX----XXXXXXXXXXXXXXXXXXXXXXXXXXXXXXXXXXX-XXXXXXXXXXX-XXXXXXXXXXXXXXXX---XXX----XXXXXX--XXXXXXXXXXXXXXXXXXXXXXXXXXXXXXXXXXXXXXXXXXXX
