----------------------------------------------------------------------------------------------------------------------------------------------------------------------------------------------------------------------------------------------------------------------------------------
----------------------------------------------------------------------------------------------------------------------------------------------------------------------------------------------------------------------------------------------------------------------------------------
----------------------------------------------------------------------------------------------------------------------------------------------------------------------------------------------------------------------------------------------------------------------------------------
-----------------------------------------------------------------------------------------------------------------------------------------------E----------------------------------------------------------------------------------------------------------------------------------------
---------XXX----------------------------------------------------------E----------------------------------------------------------------------XXXXXXX-------------E----------------------------------------------------------------------------------------------------------------------
--------------------------------------------------XXXX-------------------E----------------------------------XXXX---------------X------------?----------------??SSSSSSS----------------------------------SSSSSSSSS-------------------------------------------------------XX--------------
-------------------------------------------------------------XXXX------------XXXXX---------------------------------------------X----------------------------------------------------------------------------------------------------------------------------------------------XX--------
------------------------------------------------------------------------------------------------------------------------------XXX-------------------------------------------------------------------------------------------------------------------------------------------------------
----------------------------------------------------------------------------------------------------------------------------X-XX--------------------------------------------------------E----------------------------------E------------------------------------------------------------
----------------------------X-----------------EX-----------------------XXXXSS------Q-----------------------SS--------------XX----------------XXXX---------E----XXX----XX-----E---------<>----------E-----SSSSSSS----------<>----------------------------------------------------------SS
----------E-----E-------------------------EXXXXX---------------------------------------------------------------------------XXX---------------------X---EXX------------------<>---------[]------E--<>----------------------[]--------------E------------------X--------------------------
---------<>----<>---------------------------------------XXXX--------------------------------------------------------------XXXX-X------------------XX------------------------[]---------[]-----<>--[]----------------------[]-------------<>-----------------XX--------------------------
-----E---[]----[]---------E------------------------------------------E-------E-----------------------------------E--E---XXXXX-EE--------E--E---------------XX---------------[]-----E---[]-----[]--[]----------------------[]-------------[]--------------EE-XX--------------------------
XXXXXXXXXXXXXXXXXXX---XXXXXXXXXXX---XXXXXXXX-XXXXXX-XXXX------------XX-----XXXXXXXXX---XXXXXXXXXXXXXXXXXX------XXXXXXXXXXXXXXXXXXXXXXXXXXXXXX------XXXX----XXXXXXXXX-XXXXXXXXXXXXXXX---XX--XXXXXXXXXXXXXXXXXXXXXXXXXXXXXXXXXXXXXXXXXXXXXXXXXXXXXXXXXXXXXXXXXXX---XXXXXX--XXXXXX-XXXXXXXX
