----------------------------------------------------------------------------------------------------------------------------------------------------------------------------------------------------------------------------------------------------------------------------------------
----------------------------------------------------------------------------------------------------------------------------------------------------------------------------------------------------------------------------------------------------------------------------------------
----------------------------------------------------------------------------------------------------------------------------------------------------SSSSSSSSSSSSSSSSSSSS-----------------------------------------------------------------------------------------------<--------E-------
---------------------------------------------------------------------------------------------------X--------------------------------------------------------------------------------------------------------------------------------------------------------------E----[-------<>-------
---------------------------------------------------------------------------------------------------X----------------------------------------------------------------------------------------------------------------------------------------------------------XXXXXXX--[]------[]-------
-------------------------------------------E-------------------------------------------------------X----------------------------------------------------------X-------------------------------SSSS-------------------------------S-S--SSSSSSS--------------------------------XXXXXX-----
--------------------------------------------------------------------------------------------------XX----------------------------------------------------------X-------------------------------------------------------------------------------------------------------------------------
-------------------------------------------X----------------------------X------------------------XXX-----------------------------------------S---------------XX---------------------------------------------------------------------------S---------------------------------------------
-----------------------E------------------XX---------------------------XX-----------------------XXXX-----------------------------------------S--------------XXX---------------------------------------------------------------------------S------------E----X--XXXX--------------------S
------Q--------QQ-----<>----------------XXX----------------------------XX----------E-----------XXXXX----------------------------X-----------SS--------S-----XXXX--X-----QQQ---------------XX---------------------X----------------E--SS--SSS----------<>----------------XXX-----XX------
----------------------[]--E-----------XXXXXX---------------------------XX---------<>----------XXXXXX-----E-----<---------E-----XX----------->---------------XXXX--X-------------------XXXXXX--------------------XX---------------<>-------S-----------[]----------------------------X-XS
----------------------[]-------------XXXXXXX-----------[--------------XXX---------[]---------XXXXXXX-----X-----[---------------XX----XX-----]-------------XXXXXX--------------------------XX-------------------XXX---------------[]-------S-----------[]--------------------------------
----------------------[]------------XXXXXXXX--------EE-[-E-E-------E-XXXX---------[]-E-E----XXXXXXXX-----X--E--[E]--E------E-XXXX----XX-----]------------XXXXXXX---------------------------X------------------XXXX----------E----[]------E--------E---[]--------------------------------
XXXXXXXXXXXXXXXXXXXXXXXXXXXXXXXXXXXXXXXXXXXXXXXXXXXXXXXXXXXXXXXX--XXXXXXXXXXXXXXXXXXXXXXXXXXXXXXXXXXXXXXXXXXXXXXXXXXXXXXXXXXXXXXXXXX--XXXXXXXXXXXXXXXXXXXXXXXXX--------XXXXXXX-XXXXXXXXXXXXXXXXXXXXXXXXXXXXXXXXXXX-------X--X-X-XXXXXXXXXXXXXXXXXXXXXXXXXXXX----------------------------
