----------------------------------------------------------------------------------------------------------------------------------------------------------------------------------------------------------------------------------------------------------------------------------------
----------------------------------------------------------------------------------------------------------------------------------------------------------------------------------------------------------------------------------------------------------------------------------------
----------------------------------------------------------------------------------------------------------------SSSSSSSSSSSSSSSSSSSSSSSSSSSSSSSSSSSSSSSSSSSSSSSSSSSSSSSS--SSSSSSSSSSSSSS-------S----------------------------------------------------------------------------------------
----------------------------------------------------------------------------------------------------------------SSSSSSSSSSSSSSS------SSS--SS------------------------------SSSSSSSSSSS-S-------------------------------------------------------------------------------------------------
----------------------------------------------------------------------------------------------------------------SSSSSSSSSSSSSSS--------S--SS------------------------------SSSSSSSSSSS-S------------------------X------------------------------------------------------------------------
------------------XX-----------------------------------------------XXX-------------------------------------------SSSSSSSSSS--SS-----------SS------------------------------SSSSSSSSS--SSS-----SSSSSSS----------------------------------------------------------------------------SXXXSSS-
---------------------------------------------------------------X------------------------------------------------------------------------------------------------------------------------------------------------------------------------------------------------------------------------
----------------------------------------------------------------------------------------------------------------------------------------------------------------------------------------------------------------------------------------------------------------------------------------
----XXX-------------------XX-------------------------------------------------------X--------------------------------?------------------S?-----------------------------------E------------------SS---------------------------------------------------------------------------------------
------------------------------------------------------SS---X------------XSSSS--------------------------------S--SSSSSSSSSSS--------E?------XSS-S----SQS---------X------X--SSSSSSSSS-------------------------------Q---------SSSS-----------------------------XXXX----------------X------
----------------------------------------------------------XX----------------------------------------------------SSSSSSSSSSS-------<>-------X-------------------XX-X----X--S-SS-S----------<>--------------E---E-------------------------------------------------------------------------
----------------------------------------------------------XX----------------------------------------------------SSSSSSSSSSS-------[]X------X----------------<>-XX------X---SSSSS----------<>-----------------<>-------------------------------------------------------------------------
--X-------------------------------------------------------XX-------------------------------EE--------------E--E-SSSSSSSSSSS-------[]X----XXXE-----E---------[]-XX------X---------E--------[]-----------------[]------------------------E--E---------------------------------------------
XXX----------------XXXXXXX-------XXXXXXX-XXXXX---XXXXXXX-----------------------XX-XXXXXXXXXXXXXXXXXXXXXXXXXXXXXXXXXXXXXXXXXXXXXXXXXXXXXXXXXXXXXXXXXXXXXXXXXXXXXXXXXXXXXXXXXXXXXXXXXXXXXXXXXXXXXXXXXXXXXXXXXXXXXXXXXXXXXX--XXXXXXXXXXXXXXXXXXXXXXXXX--XXXXXXXXXX----XXXXXX-XXXXXXXXXXXXXX
