----------------------------------------------------------------------------------------------------------------------------------------------------------------------------------------------------------------------------------------------------------------------------------------
----------------------------------------------------------------------------------------------------------------------------------------------------------------------------------------------------------------------------------------------------------------------------------------
----------------------------------------------------------------------------------------------------------------------------------------------------------------------------------------------------------------------------------------------------------------------------------------
----------------------------------------------------------------------------------------------------------------------------------------------------------------------------------------------------------------------------------------------------------------------------------------
----------------------------------------------------------------------------------------------------------------------------------------------------------------------------------------------------------------------------------------------------------------------------------------
-XXX------------------------X---S?--SQSSSS-------------------------------------------------QQ-QQ---------------S---SSSSSSSSSS-SS------------------------------------------------------------------------------QQQQQ----------SSS------------------E----XXX------------------------------
----------------------------------------------------------------------------------------------------------------------------------------------------------------------------------------------------------------------------------------------------------------------------------------
----------------------------]-----------------------------------------------------------------------------------------------------------------------------------------------------------------------------------------------------------------------------------------------------------
----------------------------XXX-----------------------E------------------------E-------------------------------------------------------E-------------------X------------------------------------------S---SSS---------------------------------------------------------------------------
-----------------------------------S?S-SSSS----------<>------QQ---------E-----<>--------E-Q---QQQ--?Q---------------SSSSSS------------<>-------------------XX--------------------------------------------------SSSSQ--------------------------XXX---------------------------------------
-----------------------------------------------------[]----------------<>-----[]--E---------------------------------------------------[]-------------------XX---------------------------------------------------------------------------------XXXX-----------X--------------------------
-----------------------------------------------------[]----------------[]-----[]------------------------------------------------------[]------------------XXX--------------------------------------------------------------------------------XXXXX--------------------------------------
--E--E-EE-E-E----------E-EE--------------------EE-E--[]----------------[]-----[]----------------------EE----------------------------E-[]---------------E-XXXX------------------------------------------------------------------------------------------------X--------------------------
XXXXXXXXXXXXXXXXXXX-XXXXXXXX---XXXXX----XXXXXXXXXXXXXXXXXXXXXXXXX-XXXXXXXXXXXXXXXXXXXXXXXXXXXXXXXXXXXXXXXX-XXXXXXXXXXXXXX--XXXXXXXXXXXXXXXXXXXXXX-XXXXXXXXXXXXXXX---XXXX------XXXX---XXXXXXXXXXXXXXX--XXXXXXXX-XXXXXXXXXX-------XXXXXX--XXXXXXX---XXXX--XXXXXX---XXXXXXX--XX----XXXXXXXX
