----------------------------------------------------------------------------------------------------------------------------------------------------------------------------------------------------------------------------------------------------------------------------------------
----------------------------------------------------------------------------------------------------------------------------------------------------------------------------------------------------------------------------------------------------------------------------------------
----------------------------------------------------------------------------------------------------------------------------------------------------------------------------------------------------------------------------------------------------------------------------------------
----------------------------------------------------------------------------------------------------------------------------------------------------------------------------------------------------------------------------------------------------------------------------------------
------------------------------------------------------------------------------------------------------------------------------E---------------------------------------------------------------------------------------------------------------------------------------------------------
---SSSSSSSSSS-SS---------SSS----------------------------X---S??-E?SSSSS----S-S------X-------E---------XX--------------------------------------------------------------------------------------XXXX--------------------------------------------------------XX------------------E---------
-----------------------------------------------------------------------------------------------------------------------------------------------------------------------------------------------------------------------------------------------------------------------------X>---------
--------------------------------------------------------]------------------------------------------------------------------------------------------------------------------------------------------------------------------------------------------------------------------XXXX---------
--------------------------------------------------------XXX-------------------------XXXXXX--------------------E-----------------------------------------------------------------------------------------------------------------------------------------------------------XXXX----------
----SSSSSS-----------------------------------------------------S?S-SSSS----------<>-------------XXX----------<>----------------------------Q----------------------------X-Q---------------XX-----------------------------------------------------------S-----------------XXXXX----------
---------------------------------------------------------------------------------[]--------------------------[]-------------X-----------------------------------------E---------------XXXX-X----------------------------------------------------------------------------XXXXXX----------
---------------------------------------------------------------------------------[]--------------------------[]--XX---------X----------------------------------------<>-----------------------------------------------------------------------------------------------XXXXXXXXX---------
------------------EEE------------------------------------------------------EE-E--[]-----------------------E--[]---------E---XE-------E-E-----------------------------[]---------------------------------------EEE-EE--------E--E--------E-E-E---------E---------------XXXXXXXXX-----E---
XXXXXXXXXXXXXXXXXXXXXXXXXXXXXXXXXXXXXXXX---XXXXXXXXXXX------XXXXXXX-XX--XXXXXXXXXXX-------XXX------XXXXXXXXXXXX-XX--XXXXXX--XXXXX--XXXXXXXXXXXXXXXXXX--XXXXXXXXXXXXXXXXXXX-------XXXX----XXXXX---XXXXXXXXXXXXXXXXXXXXXXXXXXXXXXX--XXXXXXXXXXXXXXXXXXXXXXXXXXXXXXXX---XXXXX----------X---
