----------------------------------------------------------------------------------------------------------------------------------------------------------------------------------------------------------------------------------------------------------------------------------------
------------------------------------------------------------------------------------------------------------------------------------------------------------------------------------------------------------------------S---------------------------------------------------------------
--SSSSSSSSSSSSSSS---S-SS---S--------------------------------------------------------------------------------------------------------------------------------------------------------------------------------------------SS-----S--------------------------------------------------------
--SSSSSSSSSSSSSS-------S------------------------------------------------------------------------------------------------------------------------------------------------------------------------------------------------SS---SSS--------------------------------------------------------
--SSSSSSSSSSSSSS-------------------------------------------------XX------------------------------------------------------------------------------------------------------------------------------------EE---------------SS---SSS------------------------------------------E-------------
SSSSSSSSSSSSSSSS-----SSSSSSS-----------------------------------------Q---------------XXX--------------------------S-----------------------------------------XS--------------------------------------S-SSSSSSSS----SS---SSS-----S-------Q--QQ--------------------------------------------
ES---------------------------------------------------------------------------------------------------------------------------------------------------------XX---------------------------------------------------------------------------------------------------------------------------
----------------------------------------------------------------------------------------------------------------------------------------------------------XXX---------------------------------------------------------------------------------------------------------------------------
----E---------------------------S---------------------------SSSSS---------------------------------------------------------------------------------------XXXXXX--------------------------E-------------EE--------------------------------------------------------------------------------
---?SSSSSSS-----------------------------SSS-------------------------QQQQ----------E------------------------------QQQ-----------------------------------XXXXXX----------------Q---------<>-------------S?SSSSS-----E----X-----XXX------Q---QQQ--QQ--------------------------------S------
--E--S---------------------------------------------------------------------------<>-----------------------------------------------X------------------XXXXXXXX----X---------------------[]-----------------SS----X-----------------------------------------------------------------------
--SSSS------------<>-------------------------------------------------------------[]-----------------------------------------------X------------------X-XXXXXX----X---------------------[]----------------SS---------X-------------------------------------------------------------------
---------E--------[]---------------------------------------------E---------------[]-------------E-------------E----------------X--X---------EE-EE----X-XXXXXX----X----------E----------[]---------X---------------------E-E---------------------------------------------EE-------E-E----
XXXXXXXXXXXXXXXXXXXXXXXX-XXX---XXXXXXXXXXXXXXXXXX-XXXX--XXXXXXXXXXXXXXXXXXXXXXXXXXXXXXXXXXXXXXXXXXXXXX---XXXXXXXXXXX--XXXXXXX--XX-----------XXXXXXXXXXXXXXXXXXXXXXXXXXXXXXXXXXXXXXXXXXXXXXXX--XXXXXXXXXX-XXXXXXXX--XXXXXXXXXXXX-XXXXXXXXXXXXXXXXXXX------XXX-----X-XXXX-XXXXXXXXXXXXXXXX
