----------------------------------------------------------------------------------------------------------------------------------------------------------------------------------------------------------------------------------------------------------------------------------------
-------------------------------------------------------------------------------------------------------------------------------E--------------------------------------------------------------------------------------------------------------------------------------------------------
------------------------------------------------------------------------------------------------------------------------------<>----------------------------------------SSSSSSSSSSSSSSSSSSSSSSSSSSSS-------------------------------------------------------------------------S----------
-----------------------------------------------------------------E------------------------------------------------------------[]------------------------------------------S----SSSS-----------------------------------------------------------------------------------------------------
-----------------------------------------------------------------XXX----------------------------------------------------------[]-----------------------------------------------SSSS--------------------------XXX------------------------------------------------------------------------
-------------------------------------------X------------------------EQQ-----------------------------------SSSS--X---S???E?S-------?SSS----------------------XX-----------SSS---SSSS-------------------------------Q-----------------------------SSS-------------------------------------
------------------------------------------XX---------------------------------------------------------------------------------------------------------------XXX--------------------------------------------------------------------------------------E-----------------------------------
-----------------XX----------------------XXX-------------------S------------------------------------------------]------------------------------------------XXX--------------------------------------------------------------------------------------------------------------------------
----------------XXX---------------------XXXX--------------SSSSSSS-----------------E------------------------SS---X-X---------------------------------------XXXX--------------E------------------E------------------------------------------------E---------------------------------------
----------------XXX--------------------XXXXX------------------------S?SS---------QQ-SSSQS--------------X---------------SS---XXX----------X---E---------XXX-XXX-------------SSSSSSSS-----------<>------------------QQ-----------------E---------<>-------------------Q-------------------
---------------XXXX-------------------XXXXXX------------------?------------------X---------E---------XXX--------------------------------XXXX<>-------X--XXXXXX---XX----E--SSS---SSS--------E--[]------------------------------------<>---------[]----X-----E----------------------------
--------------XXXXX------------------XXXXXXX-----X----------------------------------------<>--------XXXX---------------------------------XX-[]-------X-XXXXXXX---XX----X-SSSS--SSSS-------<>--[]------------------------------------[]---------[]---<>>---<>----------------<>-X--------
---E---------XXXXXX----------E-E----XXXXXXXX-----X--E--E---------E------------------------[]-------XXXXXX---------------------------E-E--X--[]-E--------XXXXXX---XX----X--SSS-SSSSS-------[]--[]---X---------E------------------EE--[]-----E-E-[]---[[]---[]------E---------[]----------
XXXXXXXXXXXXXXXXXXXX-------XXXXXXXXXXXXXXXXXXXXXXXXXXXXX--XXXXXXXXXXXXXXXXXX---XXXXXXXXXXXXXXXXXXXXXXXXXXXXXXXXX------XX--------XXXXXXX-----XXXXXXXXXXXXXXXXXX---XXXXXXXXXXXXXXXXXXXXXXXXXXX--XXXXXXXXXXXXXXXXXXXXXXXXX------XXXXXXXXXXXXXXX---XX---XXXXXXXXXXXXXXXXXXXXXXXXXXXXX--XXXXX
