----------------------------------------------------------------------------------------------------------------------------------------------------------------------------------------------------------------------------------------------------------------------------------------
----------------------------------------------------------------------------------------------------------------------------------------------------------------------------------------------------------------------------------------------------------------------------------------
----------------------------------------------------------------------------------------------------------------SSSSSSSSSSSSSSSSSSSSSSSSSSSS--------------------------------------------------------------------------------------SSSSSSSSSSSSSSSSS-SSSSSSSS----------------------------
----------------------------------------------------------------------------------------------------------------------------------------------------------------------------------------------------------------------------------SSSSSSSSSS--------------SS----------------------------
---------------------------------------X-------------------------------------------------------------------------------------------------------------------------------------------------------------------------------------------SSSSSSSS---------------SS----------------------------
--------------------------------------------------------------------------------------------------------------------------------------------------------------------------------------------------------------------------------SSSSSSSSSSS--SSS----------SS----------------------------
---------------------------------------------------------------------------------------------------X------------------------------------------------------------------------------------------------------------------------------------------------------------------------------------
--------------------------------------------------------------------------------------------------XX------------------------------------------------------------------------------------------------------------------------------------------------------------------------------------
-------------------------------------------------------------------------------------------------XXX----------------------E-------------------------------------------------------------------------------------------------------------------------------------------------------------
-------------------------------------------Q-------------------------XXX--------------------------XX---------------S----S<>-----------------------------------------------------------XXX-------------------------XXXXXX----------SSSSSSSSS--------E------------------------------------
--------------------------------------E----------------------------XXXXX----------------------XXXXXX---------------------[]---------------------------E---------------E-----------------------------------------------------------SSSSSSS---------<>---E--------------------------------
-------------------------------------<>---------------------------XXXXXX----------------------XXXXXX---------------------[]-----<>-XX----------------<>--------------<>-----------------------------------------------------------SSSSSSS---------[]--<>--------------------------------
------------E------------------------[]--------------------------XXXXXXX--------E--E-E-E-----XXXXXXX--------E--EE-----E--[]-----[]-------------------[]--------------[]---------------------------------------------------------------SS-E--------[]--[]----------------------E---------
XXXXXXXXXXXXXXXXXX---X--XXXXXXXXXXXXXXXXXXXXXX-------XXXXXXXXXXXXXXXXXXXXXXXXXXXXXXXXXXXXXXXXXXXXXXXXXXXXXXXXXXXXXXXXXXXXXXXXXXXXXXXX--XXXXXXXXXXXXXXXXXXXXXXXXXXXXXXXXXXXXXXXX---XXXXX----XXXXXXXXX----XX---XXXXXXXXXXXXXXXXXXXXXXXXXXXXXXXXXXXXXXXXXXXXXXXXXXXXXXXXXXXXXXXXXXXXXXXXXXX
