----------------------------------------------------------------------------------------------------------------------------------------------------------------------------------------------------------------------------------------------------------------------------------------
----------------------------------------------------------------------------------------------------------------------------------------------------------------------------------------------------------------------------------------------------------------------------------------
----------------------------------------------------------------------------------------------------------------------------------------------------------------------------------------------------------------------------------------------------------------------------------------
----------------------------------------------------------------------------------------------------------------------------------------------------------------------------------------------------------------------------------------------------------------------------------------
----------------------------------------------------------------------------------------------------------------------------------------------------------------------------------------------------------------------------------------------------------------------------------------
--------------------------------------------------------X---S???SSS------??S------------------------------------------------------------------------SS------------------------------?S----------------------------------------------------------------------X---S---SSSS----------------
---------------------------------------------------------------------------------------------------------------------------------XXX----------------------------------------------------------------------------------------------------------------------------------------------------
-------------------------------------------X--------------------------------------------------------------------------------------------------------------------------------------------------------------------------------------------------------------------------------------------
-----E----------E-------------------------XX------------X-X---------------------------------------------------------------------------------------------------------------SSSSSSS-----------------E-----------------------------------------------------------X-----------------------E-
----<>---------<>----------E--------------XXX------------------SS---XXX----------XX------------------------------X------------------------SS--------------------------E-------------S?-----------<>-------S-------------------------------QQQ--QQ------------------SS---SSS----------<>-
----[]---------[]---------<>--------------XXX------------------------------------XX------------------------------X---------------------------------------------------<>--------------------------[]----------------------------------------------------------------------------------[]-
----[]---------[]---------[]--------------XXX------------------------------------XX-----------------------------XXX--------------------------------------------------[]--------------------------[]----------------------------------------------------------------------------------[]-
----[]---------[]---------[]-E-E-------E-XXXX------------------------------EE-E--XX-------------EE-------E------XX------------------------------------------------E--[]--------E-E---------------[]-------------------E---------------------------------------------------------E-E--[]-
XXXXXXXXXXXXXXXXXXXXXXXXXXXXXXXXXXXXXXXXXXXXXXXX-----X-X------XX-----X-XXXXXXXXXXXXX------XXXXXXXXXXXXXXXXXXXXXXXXXXXXXXXX---XXXXXXXXXXXXXXXXXXXXXXX---XXXXXXXXXXXXXXXXX---XXXXXXXXXXXXXXXX-XXXXXXXXXXXXXXXXXXXXXXXXXXXXXXXXXXXXXXXXXXXXXXXXXXXXXXXXXXXXXXXXXXXXXXXXXXXXX-----X-XXXXXXXX
