----------------------------------------------------------------------------------------------------------------------------------------------------------------------------------------------------------------------------------------------------------------------------------------
----------------------------------------------------------------------------------------------------------------------------------------------------------------------------------------------------------------------------------------------------------------------------------------
----------------------------------------------------------------------------------------------------------------------------------------------------------------------------------------------------------------------------------------------------------------------------------------
----------------------------------------------------------------------------------------------------------------------------------------------------------------------------------------------------------------------------------------------------------------------------------------
----------------------------------------------------------------------------------------------------------------------------------------------------------------------------------------------------------------------------------------------------------------------------------------
------------------------XXXX----------------------------Q------------------------------------------------------------------------------------------------------S----SS---------------------------------------QSS-S-----X---------------------------------XXX----------------------------
----------------------------------------------------------------------------------------------------------------------------------------------------------------------------------------------------------------------------------------------------------------------------------------
----------------------------------------------------------------------------------------------------------------------------------------------------------------------------------------------------------------------------------------------------------------------------------------
------------------------------------------------------------------------------------------------------------------------------------------E----X-----------------------------------------------------XXXXX--------------------E---------------------------------------------------------
------------------------S-----------------XXXX-----------------------XXXXX--------------------------X------------X-----------------------QQ---XXX---------------------------------------------------------------SS-----------<>-----------------------SSS------------------XX-----------
---------------------------------------------------------------------------------------------------XX----------E-X-----------------------------------------------------------------------------------------------------------[]-----------------E-------------------------EXXX----------
---------------------------------------------------------------------------------------------------XX---------<>-X-----------------------------------------------------------------------------------------------------------[]----------------<>-------------------------XXXXX---------
---------------------------------------------------------------------------------------E-------E-XXXX---------[]XXX-----------------------------------------------------------------E----------------------------------------[]------E----E----[]-----E-------------------XXXXX-------XX
X-XXXXXXXXXXXXXXXXXXXXXXXXXXX----X-----XX--------XXXXXXXXX--X----XXXX---------------XXXXX-XXXXXXXXXXXX----XX--XXXXXXXXXXXXXX--XXXXXXXXXXXXXXXXX---XXX------XXXXXXXXXXX--XXXXXXXXXXXXXXXX-----XX-XXXXXXXXXXXXX-------XXXXXXXXXXX-XXXXXXXXXXXXXXXXXXXXXXXXXXXXXXXXXXXX--XXXXXXXXX--------X
