----------------------------------------------------------------------------------------------------------------------------------------------------------------------------------------------------------------------------------------------------------------------------------------
----------------------------------------------------------------------------------------------------------------------------------------------------------------------------------------------------------------------------------------------------------------------------------------
--------------------------------------------------------------------------------------------------------------------------------------------------------------------------------------------------------------------------------SSSSSSSSSSSSSSSSSSSSSSSSSSSS----------------------------
----------------------------------------------------------------------------------------------------------------------------------------------------------------------------------------------------------------------------------------------------------------------------------------
----------------------------------------------------------------------------------------------------------------------------------------------------------------------------------------------------------------------------------------------------------------------------------------
----------------------------------------------------------------------------------------------------------------------------SS--------------X---SSSSSSSSS------------------------------------------------------------XXX----------------------------------------------------------------
--------------------------------------------XXXX----------------------------------------------------------------------------------------------------------------------------------------------------------------------------------------------------------------------------------------
--------------------------------------------------------------------------------------------------------------------------------------------X-------------------------------------------------------------------------------------------------------------------------------------------
------------------------------------------------------E------------------------------------------------------------XXXX-------------------XX------------------------------------------------------------XXX-------------------E-----------E---------------------------------------------
---------------<>------------X-----------------------QQS------Q---------E-----------------------------------------------------------S-------------SSSS--?SS----------X-------------------------------X-----------------------<>----S-----<>-----------------------------------------S---
---------------[]------------X-----------------------------------------<>----------------------------------------X---------------------------------------------------XX------------------------------------------------------[]----------[]--------<>------X----------------------------
---------------[]-----------XXXX---------------------------------------[]------------------------X-------------------------------------------------------------------XX------------------------------------------------------[]-SS-------[]--------[]-----------------------------------
---------------[]-----------XXXX---------------------------------------[]-E---------------------E---------------XXX---------------------------------------------E-E--XX-------------------------------X----------------------[]-S--------[]--------[]------X----------------------------
XXXXXXXXXXXXXXXXXXXX--XXXXXXXXXXXXXXXXX--XXXXXXXXXXXXXXXXXXXXXXXXXXXXXXXXXXXXXXXXXXXXXXXXXX-XXXXXXXXXXXXXXXXXXXX------XXXXX---XXXXXXXXXXX---XXXXXXXXXXXXXX--XXXXXXXXXXX----XXXXXXXXXXXXXXXXXXXXXXXXXXXX--XXX---------XXXXXXXXXXXXXXXXXXXXXXXXXXXXXXXXXXXXXXXXXXXXXXXX---XXXXXXXXXXXXXXXX
