----------------------------------------------------------------------------------------------------------------------------------------------------------------------------------------------------------------------------------------------------------------------------------------
----------------------------------------------------------------------------------------------------------------------------------------------------------------------------------------------------------------------------------------------------------------------------------------
---------------------------------------------------------------------------------------------------------------------------------------------------------------------------------------------------------SSSSSSSSSSSSSSS---S------------------------------------------------------------
----------------------------------------------------------------------------------------------------------------------------------------------------------------------------------------------------------------------------------------------------------------------------------------
----------------------------------------------------------------------------------------------------------------------------------------------------------------------------------------------------------------------------------------------------------------------------------------
SSSS---SS--------------------------------------S----------------------------------XX------------------------------------------------------X-SSS--------------------S-----------SS--------SSS-----------------------------------------------------------------------QQ-QS----------------
----------------------------------------------------------------------------------------------------------------------------------------------------------------------------------------------------------------------------------------------------------------------------------------
----------------------------------------------------------------------------------------------------------------------------------------------------------------------------------------------------------------------------------------------------------------------------------------
------------------------------------------------------------------------------------------------------------------------------------------------------------------------------------------------------------------------------------------------E----------------------------------E----
SSSS--------------------------XXX--------------------------------------------S-SSSS----------------X-------------------------XXX------------SQQ---------------XX----------SXS-----------------------SSSS---------------XX------X------Q----Q---<>----------------QQ---QQ----------<>----
------------------XX--------------------------------------------------------------------------------------------------------XXX------------------------------XXX-------------------------------------------E---------XXXX------X---------------[]------E-----<>-------------------[]----
----------------XXXX-------------------------------------------------------------------------------------------------------XXXX-----------------------------XXXX------------------------------------------<>--------XXXXX------X---------------[]-----<>-----[]-------------------[]----
------E--------XXXXX-------X-----------------------------------EE---------------------------------------------E-----------XXXX----------E------------------XXXXX------------------------------E--X--------[]-------XXXXXX----XXX---------------[]-----[]-----[]-------------------[]----
XXXXXXXXXXXXXXXXXXXXXXXXXXXXXXXXXXXXXXXXX--XXXXXXXXXXXXXXXXXXXXXXXXXXXXXXXXXXXXXXXXXXXXXXXX-XXXXXX------------X-XXXXXXX--XXXXXX--XXXXXXXXXXXXXXXXXXXXXXXXXXXXXXXXXXXXXXXXXXXXXXXX--XXXXXXXXXXXXXXXXXXXXXXXXXXXXXXXXXXXXXXXXXXXXXXXXXXXXXXXXXXXXXXXXXXXXX-XXXXXXXXXXXXXXXXXXXXXXXXXXXXXXX
