----------------------------------------------------------------------------------------------------------------------------------------------------------------------------------------------------------------------------------------------------------------------------------------
----------------------------------------------------------------------------------------------------------------------------------------------------------------------------------------------------------------------------------------------------------------------------------------
SSSSSSSSSSSSSSSSSSSSSSSSSSSS------------------------------------------------------------------------------------------------------------------------------------------------------------------------------------------------------------------------------------------------------------
----------------------------------------------------------------------------------------------------------------------------------------------------------------------------------------------------------------------------------------------------------------------------------------
----------------------------------------------------------------------------------------XX----------------------------------------------------------------------------------------------------------------------------------------------------------------------------------------------
-SSS----S-------------------------------------------------------------------------------------------------SXXX--------------------XXX----S--------------------------------------------------------XX-------------------------------S----------------------------------------XX----------
-------------------------------------------------------------------------------------------------------------------------------------------------------------------------------------------------------------------X-------------------------------------------------------XXX----------
------------------------------------------------------------------------------------------------------------------------------------------------------------------------------------------------------------------XX------------------------------------------------------XXXX----------
-------------------------------------------------------------------------------------------------------------------XX--------------------------------------------------------------------------------------------XXX-----------------------------------------------------XXXXX----------
SSSS---SSSS---------E----------------------XX-------------------------XXX-----------XQQ---------------EXXX-------------------X-----------------------------------------------------------------------------------XXX---------------------Q----------------------------XX-XXXXX----------
-------------------<>----------------------XX----------------------------------------------------XXXXXXXX--------------------------------------------------XXX------------------------------------------------XXXXXX--------------------------------------------------XXXXXXXX----------
----------------<>-XX----------------------XX--------------------------------------------------------------------------------------------------------------XXX-----------------------------------------------XXXXXXX-------------------------------------------------XXXXXXXXX----------
E-----E---------[]-XX----------------------X---------------------------------------------------------------------------------------------------------------XXXX---------------------------------------------XXXXXXXX--------E---------------------E---------EE-E-----XXXXXXXXX----------
XXXXXXXXXXXXXXXXXXXX--XXXXXXXXXXXXXXXXXXXXXXXXXX---XXXXX---X----XXXXX---------------XX-------XXXX------XXX---XXXXXX----XXX------------------XXXXX--XXXXXXXXXXXXXXX--XXXXXXXXXXXXXXXXXXXXXXXXXXXXXXXXXXXXX-XXXXXXXXXXXXXXXXXXXXXXXXXXXXXXXXXXXXXXXXXXXXXXXXXXXXXXXX-XXXXXXXXXXXXX-X-XXXXX
