----------------------------------------------------------------------------------------------------------------------------------------------------------------------------------------------------------------------------------------------------------------------------------------
----------------------------------------------------------------------------------------------------------------------------------------------------------------------------------------------------------------------------------------------------------------------------------------
----------------------------------------------------------------------------------------------------------------------------------------------------------------------------------------------------------------------------------------------------------------------------------------
----------------------------------------------------------------------------------------------------------------------------------------------------------------------------------------------------------E-----------------------------------------------------------------------------
------------------------------------------------------------------------------------------------------------------------------------------------------------------------------------------------------XXXXXXX---------------------------------------------------------------------------
-------------------------------------------------------------SSSSSSSS----------------------------S-----------------S-------------------------------------------------------------------------------------------------XXXX------------------------XX----------SSS----S-------------------
------------------XX----------------------------------------------------------------------------------------------------------------------------------------------------------------------------------------------------------------------------XXX-------------------------------------
------------------------------------------------------------------------------------------------------------------------------------------------------------------------------------------------------------------------------------------------XXX-------------------------------------
-------------------------------------------------------------------------------E-----XSSS---------------------E------------------------E---------------------------------------------------------------XXXX--------------------S---------------XXXX--------------------------------E----
---------------------------S---------------------------------SSSSSSS----------<>---------------SSSS----------<>-----------------------<>-----------------------------------------------XX-------------XXX-------XXX-----XX----------------X-----XXX------------S-----Q------------<>----
------------------------------------------------------E--<>-------------------[]-----------------------------[]-----------------------[]--------------------E---------------------------------------------------------------XXXX-------------XXXXXX-------------------------------[]----
-----------------------------------------------------<>--[]-------------------[]-----------------------------[]-----------------------[]-------------------<>-------------------------------------------------------------------------------XXXXXXX---------------------------X---[]----
-----------------------------------------------------[]--[]---------------E---[]-----------------------E-----[]-----------------------[]--------EE---------[]----------E-------------------------------------------------XX-----E--E-------XXXXXXXX-------------------------------[]----
-----XXXXXXX--XXX----XXXXXXXXXXXXXXXXXXXXXXXXXX-XXXXXXXXXXXXXXXXXXXXXXXXXXXXXXXXXXXXXXXXXXXXXX--XXXXXXXXXXXXXXXXXXXXXXXXX-XXXXXXXXXXXXXXXXXXXXXXXXXXX-XXXXXXXXXXXXXXXXXX---X----XXXXXXX--XXXXXXXXXXX----------------------------XXXXXXXXXXXXXXXXXXXXX--XXXXXXXXXXXXXXXXXXXXXXXXXXXXXXXXX
