22222222222222222222222222222222
22222222222222222222222222222222
22222222222222222222222222222222
22222222222222222222222222222222
22222222222222222222222222222222
22222222222222222222222222222222
22222222222222222222222222222222
22222222222222222222222222222222
22222222222222222222222222222222
22222222222222222222222222222222
22222222222222222222222222222222
22222222222222222222222222222222
22222222222222222222222222222222
22222222222222222222222222222222
22222222222222222222222222222222
22222222222222222222222222222222
22222222222222222222222222222222
22222222222222222222222222222222
22222222222222222222222222222222
22222222222222222222222222222222
22211111111111111111111111111111
22222222222222222222222222222222
22222222222222222222222222222222
11122222222222252222222222222222
22222222222222672222222222222222
12222222222222892222222222222222
21222222222222892222222122222222
22122222252211891122252222522222
22222222672222892222672226722222
22222222892222892222892228922222
22222222892522892222892228922222
00000000000000000000000000000000

