22222222222222222222222222222222
22222222222222222222222222222222
22222222222222222222222222222222
22222222222222222222222222222222
22222222222222222222222222222222
22222222222222222222222222222222
22222222222222222222222222222222
22222222222222222222222222222222
22222222222222222222222222222222
22222222222222222222222222222222
22222222222222222222222222222222
22222222222222222222222222222222
22222222222222222222222222222222
22222222222222222222222222222222
22222222222222222222222222222222
22222222222222222222222222222222
22222222222222222222222222222222
22222222222222222222222222222222
22222222222222222222222222222222
22222222222222222222222222222222
11111111111111111111111111122222
11111111111111112222222222222222
11111111111111112222222222222222
11111111111111112222252222222222
12222222222222222222672222222222
12222222222222222222892222222222
23222222222222222222892222222222
23311111111122220022892222222222
22222222222222200022892221122222
22222222222222000022892221122222
22222222552220000022892221122222
00000000000000000000000220022222

