22222222222222222222222222222222
22222222222222222222222222222222
22222222222222222222222222222222
22222222222222222222222222222222
22222222222222222222222222222222
22222222222222222222222222222222
22222222222222222222222222222222
22222222222222222222222222222222
22222222222222222222222222222222
22222222222222222222222222222222
22222222222222222222222222222222
22222222222222222222222222222222
22222222222222222222222222222222
22222222222222222222222222222222
22222222222222222222222222222222
22222222222222222222222222222222
22222222222222222222222222222222
22222222222222222222222222222222
22222222222222222222222222222222
22222222222222222222222222222222
11111111112222222222222222222222
22222222222222222222222222222222
22222222222200022222222222222222
22222222222222222222222222200022
22222222222222222222222222222222
22222222222222222222222222222222
22222222222222222111113322222222
22222222000222222222222222222222
22222225000200022222222222222222
22222500000222222222222222222222
22222000000222222222522222222222
00000000002222222000000002200022

