22222222222222222222222222222222
22222222222222222222222222222222
22222222222222222222222222222222
22222222222222222222222222222222
22222222222222222222222222222222
22222222222222222222222222222222
22222222222222222222222222222222
22222222222222222222222222222222
22222222222222222222222222222222
22222222222222222222222222222222
22222222222222222222222222222222
22222222222222222222222222222222
22222222222222222222222222222222
22222222222222222222222222222222
22222222222222222222222222222222
22222222222222222222222222222222
22222222222222222222222222222222
22222222222222222222222222222222
22222222222222222222222222222222
22222222222222222222222222222222
22222222222222223222222222222222
22222222222222222222222222222222
22222222222222222222222222222222
11112222222222222222222222222222
22222222222222222211222222222222
22222222222222222222222022222222
52222222222222112222220022222220
11112222222222222222200022222200
22222202222222222222000022222000
22222202222222222220000022220000
22222202222222222200000022200000
00000000000000000200000000000000

