22222222222222222222222222222222
22222222222222222222222222222222
22222222222222222222222222222222
22222222222222222222222222222222
22222222222222222222222222222222
22222222222222222222222222222222
22222222222222222222222222222222
22222222222222222222222222222222
22222222222222222222222222222222
22222222222222222222222222222222
22222222222222222222222222222222
22222222222222222222222222222222
22222222222222222222222222222222
22222222222222222222222222222222
22222222222222222222222222222222
22222222222222222222222222222222
22222222222222222222222222222222
22222222222222222222222222222222
22222222222222222222222222222222
22222222222222222222222222222222
11111111111111111111111112222222
11111111111111112222222222222222
11111111111111112222222222200022
11111111111111112244222222222222
22222222222222222222222222222222
22222222222222222222222222222222
22222222225255222222222222222221
11111111111111112244224442222222
11111111111111112222222222222222
11111111111111112222222222222222
11111111111111112222222222222222
00000000000000000000000002222220

