22222222222222222222222222222222
22222222222222222222222222222222
22222222222222222222222222222222
22222222222222222222222222222222
22222222222222222222222222222222
22222222222222222222222222222222
22222222222222222222222222222222
22222222222222222222222222222222
22222222222222222222222222222222
22222222222222222222222222222222
22222222222222222222222222222222
22222222222222222222222222222222
22222222222222222222222222222222
22222222222222222222222222222222
22222222222222222222222222222222
22222222222222222222222222222222
22222222222222222222222222222222
22222222222222222222222222222222
22222222222222222222222222222222
22222222222222222222222222222222
11111111111111111111111113111111
22111122222211112222222222222222
22111122522211112222222222222222
22212222112222222222222222222222
22212222112222222222222222222222
22212222112222222222111111222222
22212332112225222222111111222222
22211122112211112222222222222222
22222222222552222222222222222222
22222222222222222222222222222222
22222222222222222222222222222222
00000000000000002220000000000000

