22222222222222222222222222222222
22222222222222222222222222222222
22222222222222222222222222222222
22222222222222222222222222222222
22222222222222222222222222222222
22222222222222222222222222222222
22222222222222222222222222222222
22222222222222222222222222222222
22222222222222222222222222222222
22222222222222222222222222222222
22222222222222222222222222222222
22222222222222222222222222222222
22222222222222222222222222222222
22222222222222222222222222222222
22222222222222222222222222222222
22222222222222222222222222222222
22222222222222222222222222222222
22222222222222222222222222222222
22222222222222222222222222222222
22222222222222222222222222222222
12222211111111111111111111111111
12222222222222222222222222222222
12222222222222222222222222222222
12222222222222222222222222222222
12222222222222222222222222222222
12222222222222222222222222222222
12222222222222222222222222222122
12222222224444422222222000022222
12222222222222222222200000000220
12222222222222222220000000000220
12222222222222552000000000000520
00000000000000000000000000000000

