----------------------------------------------------------------------------------------------------------------------------------------------------------------------------------------------------------------------------------------------------------------------------------------
----------------------------------------------------------------------------------------------------------------------------------------------------------------------------------------------------------------------------------------------------------------------------------------
--------------------------------------------------------------------------------------------------------------------------------------------------------------------------------------------------------------------------------SSSSSSSSSSSSSSSSSSSSSSSSSSSS----------------------------
-------------------------------------------------------------------------------------------------------------------------E------------------------------------------------------------------------------------------------------SSS----SSSS---------------------------------------------
------------------------------------------E------------------------------------------------------------------------------XXX-----------------------------------------------------------------------------------------------------------SSSS---------------------------------------------
---------------------------------------------E----------------------------------XXXX-----------------------------------------QQ------------------------------E---------------------------------XXXXX-------------------------------S---SSSS--------------------------QSSSSS---------SSSS
----------------------------------XX-------------XXXXX------------------------------------------------------------------------------------------------------XXXXX-----------------------------------------------------------------------------------------------------------------------
--------------XXXXXX----------------------------------------------------------------------------------------------------------------------------------------------------------------------------------------------------------------------S---------------------------------------------
---------------------------------------------------------------------------------------------------------------------SS-------------------------------------------------------------------------------------------------------------E-----E------------SS----XSSS-----------------------
--------------------------------------------XX---------Q---------------------S-SS------------------XX----------------------EQQQQQQ--------E---------------------------SS-----------------------------------------------------QQ----S-S--SSSS---------------------------SSSSS------------
---------------------E------------------X----------------------------------------------------------XX------------------------------------<>--------------------------------------------------------------------------------------SSSSS---SS--------<>-----------------------------------
--------------------<>------XXX--------------------------------------------------------------------XX------------------------------------[]-XXXX--------------------------------------------------------------------------------SSSSSS---SS--------[]-----------------------------------
-EE-EEE-E-EEE-EE------E--E-E------------EE-------E-E---------------------------------E-EE------E-XXXX--------------------E---------------[]----------------------------------------------------------------E-E------------------SSSSS--S-SS--------[]-----------------------------------
XXXXXXXXXXXXXXXXXXXXXXXXXXXX-----X--XX--XX-----XXXXXXXXXXXXXXXXXXXXXXXXXXXXXXXXXXXXXXXXXXXXXXXXXXXXXXXXXXXXXXXXXXXXXXXXXXXXXXXXXXXX--XXXXXXX-----XXXXXX-XXXXX----XXXXXXX-XXX---XXXXXXXXXXXXXX------XXXXXXXXXXXXXXXXXXX-----XXXXXXXXXXXXXXXXXXXXXXXXXXXXXXXXXXXXXXXXXXXXXXXXXXXXXXX-X----
