------------------------------------------------------------------------------------------------------------------------------------------------------------------------------------------------------------------------------------------------------------X---------------------------
------------------------------------------------------------------------------------------------------------------------------------------------------------------------------------------------------------------------------------------------------------X---------------------------
------------------------------------------------------------------------------------------------------------------------------------------------------------------------------------------------------------------------------------------------------------SSSSSSSSSSSSSSSSSSSSSSSSSSSS
-------------------------------------------------------------------------------------------------------------------------------------------------------------------------------------------------------------------------------------------------------------SS----SSSSSSS-------------S
------------------------------XEE----------------------------------------------------------------------------------------------------------------------------------------------------------------------------------------------------------------------------------SSSSSSS--------------
----------------------------SSS-S--S----------SS--------SSSSSSSSSS-------------------------------S-----------------------------------------------------------XX---------------------XX------------------------------------------------------?SS------XX-----------SSSS?SS---------------
-------------------------------------------------------------------------------------------------------------------------------------------------------------XX---------------------------------------------------------------------------------------------E---------------------------
-----------------XX--------------------------------------------------------------------------------------------------------------------------S---------------XX--------------------------------------------------XXXXXXX------------------------------------X---------S------------E----
----------------XXX-----------E-------------------------------------------------------------------------------XE----------------------------SS-------------XXXX-------------------------------------------------------------------SSSSSSS-------------------]--------?S-----------<>----
----------------XXX---------SXXXX-------------XX-----XX----SS--SS--------------------X------------------------SS---------------QQ-----------E---------------XXXX--X-------------------------SS--S-------------------------SS----------------SSS---------------E--SS--SSS----------[]----
---------------XXXX----------------E---EXX-------------------------------------------X------------------------------------------------------>-------------XXXXXX--X------X------------------------------------------E----E-----------------------------------<>--S---SS-----------[]----
--------------XXXXX---------------<>----------X-------X-------------------X---------X-------------------------------------------------------]------------XXXXXXX------XX-XX---------------------------------------------------------------------------------S[]--X---SS-----------[]----
-------------XXXXXX---------------[]-------XX-X-E-E--XX-------------------X---------XX-----E-E----------------------------------------------]------------XXXXXXX------XXXXX---------------------------E-EE----E----E------E--E-E-----------------------------[]------[S--------E--[]----
XXXXXXXX--XXXXXXXXXXXXXXXXXXXXX---XXX------XXX--XXXXXXXXXXXXXXXXXXXXXXXXXXXXX----XXXXXXXXXXXXXXXXXXXXXXXXXXXXXXXXXXXXXXXXXXXXXXXXXX------X-XXXXXXXXXXXXXXXXX-X-----XX---XXXXXXXXXXXX--XXXXXXXXXXXXXXXXXXXXXXXXXXXXXXXXXXXXXXXXXX----XXXXXX----XXXXXX--------XXXXXXXEXXXXXXXXXXXXXXXXXXXX
