----------------------------------------------------------------------------------------------------------------------------------------------------------------------------------------------------------------------------------------------------------------------------------------
----------------------------------------------------------------------------------------------------------------------------------------------------------------------------------------------------------------------------------------------------------------------------------------
----------------------------------------------------------------------------------------------------------------------------------------------------------------------------------------------------------------------------------------------------------------------------------------
-------------------------------------------------------------------------------------------------------------------------------------------------------------------------------------------------------------------------------------------------------------E----E---------------------
-------------------------------------------------------------------------------------------------------------------------------------------------------------------------------------------------------------------------------------------------------------XXXXXXXX-------------------
-------------------------------------------------------------------X-----XXXX----------------------------------------------------------XXXXX---------------XSSS-------------------------XX----------S--SSSSSSSS---SS---SSS-----S----------------------------?----------------SSSSSSSS---
----------------------------------X------------------------------------------------------------------------------------------------------------------------X----E----------------------XXX----------------------------------------------------------------------------------------------
-------------XX-XXXX---------------------------------------------------------------------------------------------------------------------------------------XX----E---------------------XXX----------------------------------------------------------------------------------------------
-------------------------------------------------------------------------------------------------------------------------------------------------E--------XXXE--<>-------------------XXXXX------------E---------------------------------------------------------------------------------
----------------------SS------------------XXXXXX---------XXX-------------SSSSS------------------------------S---------------------X----------E--<>---------XX---------------------XX-XXXXX-------------?SSSSS----EE----------XX-----------------------S--S--XXXXX-------------XXXX------
----------------E-----------------------------------------XX--------------------------------------------------------------------------------<>--[]-----XX-XXX----X-----<----------X-EXXXXX------------------------------------------------E----------------------------EXXX-------------
----------E---------------------------------------------------------------------------------------------------------------------------------[]--[]--------XXX---<>-----[---------XXXXXXXXX-----------------------------------XX-----------E------------------------X--------------------
--E-EE----S----E------E--E-E------------------------------XX-------------------------------E------------------------------------------------[]--[]-----E-XXXX---[]-----[EE-E------XXXXXXXX------------------------------E-E--XX------E-EE[]------------E-EE----------------X------------
XXXXXXXXXXXXXXXXXXXXXXXXXXXXXXXXXXX-----XXX---XXXXXXXXXX--------------XXXXXXXXXXXXXX---XXXXXXX--XXXXXXXXXXXXXX-XX--XXXXXX--XXXXXXXXXXXXXXXXXXXXXXXXXXXXX--XXX---XXXXXXXXXXXXXXXXXXXXXXXXXXXXX--XXXXXXXXXXXXXXXXXXX-XXXXXXXXXXXXXXXXXXXXXXXXXXXXXXXXXXXXXXXXX----------------------------
