----------------------------------------------------------------------------------------------------------------------------------------------------------------------------------------------------------------------------------------------------------------------------------------
----------------------------------------------------------------------------------------------------------------------------------------------------------------------------------------------------------------------------------------------------------------------------------------
------------------------------------------------------------------------------------SSSSSSSSSSSSSSSSSSSSSSSSSSSS----------------------------------------------------------------------------------------------------------------SSSSSSSSSSS------SS---------------SSSSSSSSSSSSS---------
----------------------------------------------------------------------------------------------------------------------------------------------------------------------------------------------------------------------------------------------------------------------------------------
----------------------------------------------------------------------------------------------------------------------------------------------------------------------------------------------------------------------------------------------------------------------------------------
----------------------------SSSSSSSSSS----------------------SSSSSQSS-----------------------------------------------------------------------------------------SSS--------Q-----------------E---XXXX---------------------------XXX----------------------------SS--------------------------
-------------------------------------------------------------------------------------------------------------------------------XX-------------------------------------------E-----------------------------------------------------------------------------------------------------------
------------------------------------------------------------------------------------------------------------------------------XXX-------------------------------------------------------------------------------------------------------------------------------------------------------
----------E------------E-------E--------------------------------------------------------------E------SSS---------------------XXXXX--------------------------------------------------------------------------------------------------------E------------E--------------------------------
---------QS-----------<>-----SSSSS-SS----------E------X-------SSSSSSQ---------<---E-<>-------<>------------------------------XXXX-----------XXQXX-------------XXXX----X-X--------------EXXEX-------------------------------SS--------S---<>-----------<>----SSSQ--------------XXX-X----X
----------------------[]-----------S----------X>------------------------------[]-<>-[]-------[]-----------X-----------------XXXXXX-----------------E----XXX-------------X-------------EXXXXX---------------------------------------------[]-----------[]--E--------E---------XXXX------X
----------------------[]----------SS--------X-XX------------------------------[]-[]-[]-------[]-----E--EXXX---XX-----------XXXXXXX---------[------XX--------------------X-------------------------------------------------------S--------[]-----------[]----------<>-------XXXXXX-----XX
---------E------------[]--------------------X-X]-----XXX-------------------E--[]-[]-[]--E----[]--E-------XX---XX-E-E------XXXXXXXX---------X---------------X------E---X---------------------------------------E--------------------------[]-----------[]----]-----[]-------XXXXXX----XXX
XXXXXXXXXXXXXXXXXXXXXXXXXXXXXXXX-XXXX--XXX-XXXX-XXXXXXXXXXXXXXXXXXXXXXXXXXXXXXXXXXXXXXXXXXXXXXXXXXXXXX--XXXXXXXXXXXXXXXXXXXXXXXXXXXX--XXXXXXXXXX-XXX-XXXX--XXXXXXXXXXXXX---------XXXXXX---XXXXX-XXXXXXXXXXXXXXXXXXXXXXXXXXXXXXXXXXXXXXXXXXXXXXXXXXXXXXXXXXXXXXXXXXXXXXXXXXXXXX----XXX-XX
