----------------------------------------------------------------------------------------------------------------------------------------------------------------------------------------------------------------------------------------------------------------------------------------
----------------------------------------------------------------------------------------------------------------------------------------------------------------------------------------------------------------------------------------------------------------------------------------
--------------------------------------------------------SSSSSSSSSSSSSSSSSSSSSSSSSSSS----------------------------------------------------------------------------------------------------------------SSSSSSSSS------SSSSSSSSSSSSS--------------------------------------------------------
----------------------------------------------------------------------------------------------------------------------------------------------------------------------------------------------------------------------------------------------------------------------------------------
----------------------------------------------------------------------------------------------------------------------------------------------------------------------------------------------------------------------------------------------------------------------------------------
------------SS------------------------------X-----------------------------------------------------------------------------------XX-----------------QQ-QQQ-------------------------QQ--------------------------------------------X----------SS-------------------------SQSQQ-------------
-------------------------------------------XXX---------------------------------------------------------------------------------XXX------------------------------------------------------------------------------------------------------------------------------------------------------
-------------------------------------------XXX---------------------------------------------------------------------------------XXX------------------------------------------------------------------------------------------------------------------------------------------------------
-XXXXX--------------------E---------------XXXX--------------------E------SS--------------------------------------------------XXXXX---------------------------------E---------------------------E--------------E------SSS-------------------------------------XSSSSSSS-------------------
------------SS-----------X-------------X-XXXXX-------------S-----<>----------------------------QQ-------------------------XX-XXXXX---------E--E--QQ--SSQ----------<>---------QQ---QQ----E-----<>-------------<>----------------------E---E------E----------------------SSSSS---------E--
-------------------------[X-----------X-EXXXXX-------------------[]-------------------------------------------E-----------X-EXXXXX--------<>-<>-------------------[]------>-------------------[]-------------[]---------------------<>---------<>---E------E-------------------------E--
-------------------------X-----------X-XXXXXXX-------------------[]--------EX--------------------------------<>----------XXXXXXXXX--------[]-[]-------------------[]--------------------------[]----<>-------[]-----E--EX-X----X----[]---------[]--<><>---<>-------------------------X--
-------------------E--------EE-E-------XXXXXXX----------E-----E--[]--------[---------------------------------[]-EE-E-------XXXXXXX----X---[]-[]---------------EE--[]----------------------E---[]----[]-------[]--E--------X----X----[]---------[]--[][]---[]-------------------E--------
-XXXXXXX----XXXXXXXXXXXXXXX-XXXXXXXXXXXXXXXXXXXX---XXXXXXXXXXXXXXXXXXXXXXXXXXXXXXXXXXXXXXXXXXXXXXXXXXXXXXXXXXXXXXXXXXXXX--XXXXXXXX--XXXXX-XXXXXXXXXXXXXXXXXXXXXXXXXXXXXXXXXXXXXXXXXXXXXXXXXXXXXXXXXXXXXXXXXXXXXXXXXXXXXXXXXXXXXX--XXXXXXXXXXXXXXXXXXXXXXXXXXXXXXXXXXXXXXXXXXXXXXXXXXXXX-
