--------------------------------------------------------X---------------------------------------------------------------------------------------------------------------------------------------------------------------------------------------------------X---------------------------
----------------------------------------------------------------------------------------------------------------------------------------------------------------S-S---------------------------------------------------------------------------------------------------------------------
--------------------------------------------------------SSSSSSSSSSSSSSSSSSSSSSSSSSSS-----------------------------------------------------------SSSSSS----SSS----SSSSSSSS------------------------------------------------------------------------------------SSSSSSSSSSSSSSSSSSSSSSSSSSSS
--------------------------------------------------------SSSSSSSSSSSSSS---------S--SS-----------------------------------------------------------SSSSSSSSSSSSS----SSSSSSSS---------------X--------------------------------------------------------------------SSS----SSSS-----------------
--------------------------------------------------------SSSSSSSSSSSSSS------------S------------------------------------------------------------SSSSSSSSSSSSS----SSSSSSSS------------------------------------------------------------------------------------S------SSS?-----------------
----------------------------X---SSSSSSSS------SS---------SSSSSSSSSS--S------------SS----------------------SSSSSS---SSSSSS------S-?-S-------S---SSSSSSSSSSSSS----SSSSSSSS---------------X------------Q--------------------------------------------------------S------SS?-----------------
-----------------------------------------------------------S--------------------------------------------------------------------------------EE----------------------------------------XXX-----------------------------------------------------------------------------------------------
------------------------------------------------------------------S-------------------------------------------------------------------------X----------------------------------------XXXX-----------------------------------------------------------------------------S------------E----
----------------------------X-X-----------------------------?-----S------------SS---------------------------------EE----------------------------E-----------------------------------XXXXXX----------------------------------------------------------------------------E-----------<>----
-----------------------------------SS---?SS----------<>-SSSSSSSSSSSS--------E------X------------Q----------------?S?SS-------------X------------SSSSSSSS---------------------------XXXXXX------------------------XXXX-----------------------X--------------->--S-----[]---------E-[]---X
-----------------------------------------------------[]-SSSSSSSSSSS--------<>------X-----------------------------------E----X-----------------E-----------------------------------XXXXXXX----X------------------XX--------------------------X---------------SSSSS?---[]--------<>-[]---X
-------------------------<E--------------------------[]-SSSSSSSSSSS--------[]------X----------------------------------X----------------------SS--X-------------------------------XXXXXXXX----X-----------------XXX--------------------------X---------------SS?SS----[]--------[]-[]---X
-------------------------[]--------------------EE-E--[]-SSSSSSSSSSS--------[]------X------------------------------------------------E-E-----------------------EEE-------EE-E----XXXXXXXXXX---X-----X-----------XXX----------E-----------E---X----------EEEEESSSSS--S-[]--------[]-[]---X
XXX-XXX-----XX-------XXXXXXX--XXXXXXX---XXXXXXXXXXXXXXXXXXXXXXXXXXXXXXXXXXXXXXXXXXXXXXXXXXXXXXXXXXXXXXXXXXXXXXXXXXXXXXXXXXXXXXXXXXXXXXXXXXXXXXXXXXXXXXXXXXXXXXXXXXXXXXXXXXXXXXXXXXXXXXXXXXXXXXXXXXXXXXXXXXX--XXXX---------------XXXXXXXXXXXXXXXXXXXXXXXXXXXXXXXXXXXXXXXXXXXXXXXXXXXXXXXX
