----------------------------------------------------------------------------------------------------------------------------------------------------------------------------------------------------------------------------------------------------------------------------------------
----------------------------------------------------------------------------------------------------------------------------------------------------------------------------------------------------------------------------------------------------------------------------------------
----------------------------------------------------------------------------------------------------------------------------------------------------------------------------------------------------SSSSSSSSSSSSSSSSSSSSSSSSSSSS----------------------------SSSSSSSSSSSSSSSSSSSSSSSSS---
----------------------------------------------------------------------------------------------------------------------------------------------------------------------------------------------------------------------------------------------------------------------------------------
----------------------------------------------------------------------------------------------------------------------------------------------------------------------------------------------------------------------------------------------------------------------------------------
------------------------------------------------------------------------------------------SQQQQQ----------------------------------------------------------------------XX-----------------SSSS-----------------------------------------------------E-----XXX-----------------------------
------------------------------------------------------------------------------XXXX---------------------------------------------------------------------------------------------------------------------------------------------------------------<>-------------------------------------
---------------------------------------------------------------------------------------------------------------------------------------------------------XX--XXX--------------------------------------------------------------------------------XX--------------------------------------
---------------------------------E----------E--------------------------------------------------------------E---------E----------E------------------------X----------------------------------------------------E-------------------------------XXXX--------------------E------SSS--------
X----------------XXX------------<>---------<>----------E--------------XXXX----------------SS--QSQ---------<>--E-----<>---------<>----------E----------------------SSSS---XXXX-------------XXXX----X->--S-----<>---------E------X-------------XXXXX---------->--------<>-----------X-----
--------------XXX---------------[]---------[]----E----<>--------------------------------------------------[]-->-----[]---------[]---------<>--------------------------------------------------------SSSS-----[]--------<>------X------------XXXXXX-------------------[]-----------X----E
--------------------------------[]---------[]---<>----[]--------------------------------------------------[]-[------[]---------[]---------[]--------------------------------------------------------SS-S-----[]--------[]------X-----------XXXXXXX----------<>-------[]---X-<>-E--X---<>
--------------------------------[]---------[]---[]----[]---------------------E----------------------------[]-[------[]---------[]---------[]--E--EEEE-E-E--------EEE-E-----------------X------------S-----E--[]--------[]-----XX----------XXXXXXXXX---------[]-------[]--XX-[]----X---[]
X---------XXX-X----XXXXXXXXXXXXXXXXXXXXX-X-XX---XXXXXXXXXX--XX--XXXXX--------X----XXXXXXXXXXXX-XXXXXXXXXXXXXXXXX-XXXXXXXXXXX-X-XXXXXXXXXXXXXXXXXXXXXXXXXXXXXXXXXXXXXXXXXXX----XX-------XXXXXXXXXXXXXXXXXXXXXXXXXXXXXXXXXXXXXXXXXXXXXXX--XXXXXXXXXXXXXXX-XXXXXXXXXXXXXXXXXXXXXXXXXXXXXXXX
