----------------------------------------------------------------------------------------------------------------------------------------------------------------------------------------------------------------------------------------------------------------------------------------
--------------------------------------------------------------------------------------------------------S--------------------------------------------------------------------------------------------------------------------------------------E----S-----------------------------------
---------------------------------------------------------------------------------------SSSSSS-----S>----SSSS--SS--------------------------------------------------------SSSSSSSSSSSSSSSSSSSSSSSSSSSS------------------------------------------<>----------------------------------------
---------------------------------------------------------------------------------------SSSSSSSSS--SS----SSSSSSSS------------------------------------------------------------------------------------------------------------------------------[]----------------------------------------
---------------------------------------------------------------------------------------SSSSSSS----SS----SSSSSSSS--------------------------------------------------------------------------------------XXXX------------------------------------[]-----E----------------------------------
-------------S----------------------------------------------------------------------SSSSSSSSSSSSSSSS----SSSSSSSS-----------------------S----------------------------X-XX---------------------------------------------SSSS-------X--SSSSSSSSSSSSS----SSS--SSS----------------------------
----------------------------------------------------------------------------------------------------------------------------------------------------------------------------------------------------------------------------------------------------------------------------XXXX--------
---------------------------------------------------------------------------X-------------------------------------------------------------------------------------------------------------S--------------------------------------X-------------------------------------------------------
---SS---------------------E-------------------------------------------------------------E-------------------------------------------------------------------E----------------------------SSS------------------------------------X-------------------------------------------------------
------------S------------<>----------------XXX--------------------------------S--------?SSSSSS----------------XX-QQ----------------------------------------<>-----------S--S----SQS------X----X------XXXX-------------XXXX---XX------SSSSS--?SS----------X--------------------------SSSS
-X-----------------------[]---------------------------------------E-----E-----------------------------------------------------EXXXX------------------------[]----------------------------X-XX-X----X-------E---EXX------------X---------------------------XX-E--------------------------
-------------------------[]---------------------------------------E----<>----------------X------------<----------------------------------------------------[]-------------------------X-[]-XX-X---XX------XX-----------------XX-----------------------------XXX-------------------------
XX-----------------------[]---------------------------------EE----S----[]--------E--------------------[-E---------------------------------------E----------[]-----------E-----E------XX-[]-X--X--XXX---------------XX---XXX------------------------EE-E-----XX------E-------------------
----XXXX----------------XXX------X--XXXXX-----------X---XXXXXXXXXXXXXXXXXXXXXXXXXXXXXXXXXXXXXXXXXXXXXXXXXXX--X--XXXXXXXXXXXXX--XXXXX-----XXXXXXXX-XXXXXXXXXXXXXXX----XXXXXXXXXXXXXXXXXXXXXXXXXXXXXXXX---------------XXXXXXX-XXX-XXXXXXXXXXXXXX--XXXXXXXXXXX-X----XXXXXX-XXXXXXXXXXXXXXXX
