----------------------------------------------------------------------------------------------------------------------------------------------------------------------------------------------------------------------------------------------------------------------------------------
----------------------------------------------------------------------------------------------------------------------------------------------------------------------------------------------------------------------------------------------------------------------------------------
----------------------------------------------------------------------------------------------------------------------------------------------------------------------------------------------------------------------------------------------------------------------------------------
----------------------------------------------------------------------------------------------------------------------------------------------------------------------------------------------------------------------------------------------------------------------------------------
----------------------------------------------------------------------------------------------------------------------------------------------------------------------------------------------------------------------------------------------------------------------------------------
-----------------S---------------------------SS----------------QQQQQQQQ----------------------------------------------------SS-----------------------------------------------------------SS--------------------------X----------------------XXX-----------------------------------------X
------------------------------------------------E--------------------------------------------------------------------------------------------------------------------------------------XX--------------------------XX-------------------------------------------------------------------
--------------XXXX-X-----------------------XX-----------E------------------------------------------------------------------------------------------------------------------------------XX--------------------------XXX------------------------------------------------------------------
---------------------------------E---------X--------------------------------------E-------------------------------------------------------------S-------------------------------------XXX------------------------XXXXX------------------------------------------------------------------
-----------------------------E--<>---------[-----------E------Q---QSQQQQ-Q-------<>----------------------------------E---E?-----E-----------------------S?-----------QQ--E-------------XX------------E---------XXXXXX--------------------------XXSSSSS----------------------------------
-----E---------------E-----<----[]----------E----E----<>-------------------------[]---------------------------------<>---------<>---E--E-----------------------------[----------------XXX----X-----E<>-------XXXXXXXX----X--------XX----------------------------------------------------
----<>---------<>---<>-----[----[]---------XX---<>----[]-------------------------[]---------------------------------[]---------[]-----<>---------------------------------------------XXXX----X-----[[]-------X-XXXXXX----XX-------------------------------------------------------------
-E--[]-----E--E[]---[]-----[-E--[]-----E--E[]---[]----[]-------------------EE-E--[]-------------E-------------------[]---------[]-----[]-----------E-E----------------E-EE-EE------E-XXXX----X-----[[]-EE-------XXXXX----X--------------------------------------------------------------
XXXXXXXXXXXXXXXXXXXXXXXXXXXXXXXXXXXXXXXX--XXX-XXXXXXXXXXXXXXXXXXXXXXXXXXXXXXXXXXXXXX--XXXXXXXXXXXXXXXXXXXXXXXXXX-XXXXXXXXXXXXXXXXXXXXXXXXXXXXXXXXXXXXXXXXXXXXXXXXXXXXXXXXXXXXXXXXXXX-XXXX---XXXXX-XXXXXXXXXXXXXXXXXXXXXXXXXXXXXX--------------X---XXXXXXXXXXXXXXXXXXX--XXXXXXXXXXXXXXXXX
