----------------------------------------------------------------------------------------------------------------------------------------------------------------------------------------------------------------------------------------------------------------------------------------
------------------------------------------------------------------------------------------------------------------------------------------------------------------------------------------------------------------------------------------------------------X---------------------------
------------------------------------------------------------------------------------------------------------------------------------------------------------------------------------------------------------------------------------------------------------SSSSSSSSSSSSSSSSSSSSSSSSSSSS
---------------------------------------------------------------------------------------------E------------------------------------------------------------------------------------------------------------------------------------------------------------------------------------------
---------------------------------------------------------------------------------------------XXX----------------------------------------------------------------------------------------------------------------------------------------------------------------------------------------
----------------------------------------------------XXXX--XX------------------------------------EQQ-------------------------------------------XX---------------------------------------E----------------------------------------E---------------------------------------------S---------
-----------------------------------------------------------------------------------------------------------------------------------------------------------------------------------------------------------------------------------XXXX--------------XXXXX------------------------------
-------------------------------------------------------------------------------------------S----------------------------------------------------------------XXXX-----------------------X---------------------------X---------------------------------------------------------S----------
--------------------------------------------------------------------------------------SSSSSSS-----------------------------------------------------------------------------------------XX---------------------------X--------------------------------------------------E------SSS--------
---------------X------------------------------------------------------------SSSSSSSS-----------QQQSQ---------<>---------------------------------------------------------------------X--------------------------------------------------------XXXXXX---------<>---S---<>-----------X-----
-------------------------------------------------------------------------------------------------------------[]-------------------------------------------------------------------XXXXXX-----------------------X--------------------------------------------[]--<>---[]----------XX----E
-------------EXX---------------------------------------------------------------------------------------------[]-------------------------------------------------------------------XXXX-X-----------[---------------X----------------------------------------[]--X----[]---X-E--EXXX---<>
-----------E-XXX-------------------EE-E----------------------EEEE---E--------EEE-------------E---------------[]-----------E-------------------E-----E-E-E------------EE---------XXXXXXXX--------EE-[-E--E-----EEE-EX----------------------------------------[]--E----[]--XX------XX---[]
XXXXX---XXXXXXXXXXXXXXXXXXXXXXXXXXXXXXXXXXXXXXX------XXXXXXXXXXXXXXXXXXXXXXXXXXXXXXX--XXXXXXXXXXXXXXXXXXX-XXXXXXXXXXXXXXXXXXXXXXXXXXXXXXXXXXXXXXXXXXXXXXXXXXXX--XXXXXXXXXXXXXXXXXXXXXXXXXXXXXXXXXXXXXXXXX-XXXXXXXXXXXXXXXX--XXXX---------X------------------XXXXXXXXXXXX-XXXXX--XXXXXXXX
