----------------------------------------------------------------------------------------------------------------------------------------------------------------------------------------------------------------------------------------------------------------------------------------
----------------------------------------------------------------------------------------------------------------------------------------------------------------------------------------------------X-----------------------------------------------------------------------------------
----------------------------------------------------------------------------------------------------------------------------------------------------------------------------------------------------SSSSSSSSSSSS---SSSSSSSSSSSSS-------------------SSSSSSSSS----------------------------
----------------------------------------------------------------------------------------------------------------------------------------------------------------------------------------------------------------------------------------------------------------------------------------
----------------------------------------------------------------------------------------------------------------------------------------------------------------------------------------------------------------------------------------------------------------------------------------
--------------------------------------------------------------------------------X-X-Q----------------------------------------QQ---------------------------------------------------------------------X------------------------------------SSS--------------------------------------------
----------------------------------------------------------------------------------------XX------------------------------------------------------------------XXX-------------------------------------------------------------------------------------------------------------XXXX--------
-----------------------------------------X-----------------------------------------------------------------------------------------------------------------------------------------------XX---------------------------------------------------------------------------------------------
-----------------------------------------X---------------------------------------------------------------------------SS-----------------------------------------------------------------XXX-------------------E-------SS------------------E---------------------------------------------
-------------------------S-----------------------SSSSSSS-------------X---------------------------XXXXXX--------------------QQQQQQ------------X----------------------SSSS----------------XXX--------->----S---<>-----E-------------E--SS--<>------------------X------------------------SS
----------E---------------------------E-----------------------------XX-----------------------------------------------------------------------------------------------------------------XXXX------------------[]----<----?------X-<>------[]---------E------X-X--------------------------
----------E--------------------------<>----------------------------XXX----------------------------------------------------------------------XXX---------------------------------------XXXXX---------<>-------[]-----E--<><>---XX-[]------[]--------<>------XXXX-------------------------
-------E-[]---------------E------E-EE[]------------E---------------XXX-------E--E-----------------------------------------------------------XX-----EE--------------E-----------------XXXXXX---------[]--E----[]--E-----[][]---XX-[]------[]--------[]------XXX--------------------------
--XXXXXXXXXXXXXXXXX-XXXXXXXXXXXXXXXXXXXXXXXXXXXXXXXXXXXX---XXX-XXXXXXXXXXXXXXXX-XXXX----------XXXXX----XXXXXXXXXXXXXXXXXXXXXXXXXXXXXX-XXXXXXXXXXXXXXXXXXXXXXXXXXXXXXXXXXXXXXXXXXXXXXXXXXXXXXXXXXXXXXXXXXXXXXXXXXXXXXXXXXXXXXXXXXXXXXXXXXXXXXXXXXXXXXXXXXXXXX-----XXXXXX--XXXXXX-XXXXXXXX
