----------------------------------------------------------------------------------------------------------------------------------------------------------------------------------------------------------------------------------------------------------------------------------------
----------------------------------------------------------------------------------------------------------------------------------------------------------------------------------------------------------------------------------------------------------------------------------------
-------------------------------------------------------------------------------SS-------------------------------S-SSSSSSSSSSSSSSSSSSSSSS------------------------------------------------------------------------------------------------------------------------------------------------
-----------------------------------------------------------------------------------------------------------------------SS---------------------------------------------------------------------------------------------------------------------------------------------------------------
-----------------------------------XX----------------------------------------------------------------------------------SSS--------------------------------------------------------------------------------------------------------------------------------------------------------------
----------S--------------S-SX----------------XXX------------------SSS-------------------------------------------SSSSSSSSSS------------------SSSSSSSSSS-----S----------------------------X------------------------------------------------------------------S----------------------------
----------------------------------------------------------------------------------------------------------------------------------------------------------------------------------------XX---------------------------------------------------------------------------------X------------
----------------------------------------------------------------------------------------------------------------------------------------------------------------------------------------XX--------------------------------------------------------------------------------XX------------
----------------------------X-XXXXX--------------------------------------------------------------------------------E-------------------E------EE---------------------------------------XXX-------------------------------------------------------------------------------XXX------------
-----------QQQ--------------------------XXX----------X----E--QQ--SS-----E---------------------------------------SSSSS--SS----------E--<>------S?SS-SS-----E----------------------------XXX---------E----------------------------------------QQQQ-------------------------XXX------------
----------------------------------------------------XXXX-<>------------<>---E---------------------------------------S--SS---------<>--[]-----------S----------------------------------XXXX--------<>------------------------------------------------------------------XXXXXX------------
-----------------------------------------------------X---[]--X---------[]--<>--------------------------------------SS-SSS-------XX[]--[]--------------------X-----------------------XXXXXX----X---[]-----------------------------------------------------------------XXXXXXXX----------[
---------------------------------------------------------[]------------[]--[]-----------------------------------------SS--------X-[]--[]--------------------------------EE-E--------XXXXXX----X---[]----------------------------------------------------------------XXXXXXXXX-------E--[
XXXXXXXXX--XXXXXXXXXXXXXXXXX-------X---------XXXXXXXXX--XXXXXXXXXXXXXXXXXXXXX-XXXXXXXXXXXXXX-----XXXXXXXXXXXXXXXXXXXXXXXXXXXXXXXXXXXXXXXXXXXXXX---XXXXX-----------------XXXXXXXXXXXXXXXXXXXXXXXXXXXXXXXXXXXXXX-X---XXXXXXXXXXXXXXXXXXXXXXX-XXXXXXXXXXXXXXX-XXXXXXXXXXXXXXXXXXXXXXXXXX---
