----------------------------------------------------------------------------------------------------------------X-----------------------------------------------------------------------------------------------------------------------------------------------------------------------
----------------------------------------------------------------------------S-----------------------------------------------------------------------------------------------------------------------------------------------------------------------------------------------------------
----------------------------SSSSSSSSSSSSSSSSSSSSSSSSSSSS---SSSSSS-----------SS----------------------------------SSSSSSSSSSSSSSSSSSSSSSSSSSSS--------------------------------------------------------------------------------------------------------------------------------------------
-----------------------------------SS----------------------SSSSSSS----------S----SSS----------------------------S------S----------------------------------------------------------------------------------------------------------------------------------------------------------------
-----------------------------------SSS?--------------------SSSSSS-----------SS---SSS----------------------------S------SSS?-------------------------------E-----------------------------------------------------------------------------------------------------------------------------
-----------------------------SS----SS-----------------S-SSSSSSSSSSS--SSS----SS----SS----------------------------[S--------------------------E--E--E----------E----------SSS--------------------S--------------------------------------------------E-------------------------------------
------------------------------------------------------------------------------------------X-------------------------------------------------XXXXXXXXX-----------XXXXXX---------------------------------------------------------------------------<>-------------------------------------
------------------------------------------------------------------------------------------------------------------------------------------------------------------------------------------------------------------------------------------------XXX-----------------------XX------------
---------------------------------------------------SS----------------------------------------------------------------------------------S-------------------------------------------------------------------------------------------------------XXXX----------------------XXX------------
---------------X------------SSSSS--SSSS--------EX------X---?SSSSSS----------------XX--------------XXXXXX--------SSSSS--SSSS---------E------XX------------XXXXXXX-------QSQQQ--------------XXX----------------------------SSSSSSS--------------XXXXX----------------------XXX------------
-----------------------------------SSS---------XX------X--------------------------------------------------------[--S---SSSS--------XX-X----X-----------------------------------E---------XXXX------------------------------------------------XXXXXX--------E----------XXXXXX------------
-------------------------------S--SSS-------<>XXX------X-----X------------<>------------------------------------S]-S---SSSS-----<>-XX-----XXXXXX------------------------------<>---------XXXX----------------------------------------------XXXXXXXX-------<>---------XXXXXXXX-----------
--------------------------E-E--SS-SSS-------[]-]X------X------------------[]E-E--------------------------E-E----S--SS-ESSS------[]-XX----XXX----------------------------------[]-------XXXXXX------------E-EE-E------------E-E------------XXXXXXXXX-----E-[]---------XXXXXXXX-------E--E
XXXXXXX-XXXXXX------------X-XXXXXXXXXXXXXXXXXXXXXXXXXXXXXXXXXXXXXXXXXXXXXXXXXXXXXXXXXXX-XXX-----XXX---XXXXXXXXXXXXXXXXXXXXXXXXXXXXXXXXXXXXXX--------------------------XXXXXXXXXXXXXXX--X------------XXXXXXXXXXXXXXXXXXXXXXXXXXXXXXXXXXX---XXXXX--XXXXXXXX-XXXXXXX----XXXXX-------X--X---
