----------------------------------------------------------------------------------------------------------------------------------------------------------------------------------------------------------------------------------------------------------------------------------------
----------------------------------------------------------------------------------------------------------------X-----------------------------------------------------------------------------------------------------------------------------------------------------------------------
SSSSSSSSSSSSSSSSSSSSSSSSSSSS------------------------------------------------------------------------------------SSS--------------------SSSS---------------------------------------------------------------------------------------------------------------------------------------------
----------------------------------------------------------------------------------------------------------------------------------------------------------------------------------------------------------------------------------------------------------------------------------------
----------------------------------------------------------------------------------------------------------------------------------------------------------------------------------------------------------------------------------------------------------------------------------------
---------------------------------------------------------------------------------------------------------------------------------------------------------------XXXXSSSS-----------------------SSSS--------SSQQQQ------------------XX----------------------------------------------------
----------------------------------------------------------------------------------------------------------------------------------------------------------------------------------------------------------------------------------------------------------------------------------------
--------------------------------------------XXXX------------------------XXXX------------------------------------------------------------------------------------------------------------------------------------------------------------------------------------------------------------
----------E------SSS------------------------------------------------------------------------------------------------------E--------------------XXXX-------------------------------------------------------------------------------------------------------------------------------------
<----S---<>-----E---------------------------------------------------------------------------------------------S------E---<>-----E-----------------------XXX------X------SSSXS--------------X--------------SS--QQQ------------------------------------SSSSSSS------------------------S---
---------[]-----------X---------------------------------------------------------------------------------------------<>---[]----<>---E------E-----------------------------------E----------XX-------------------------------E------------------------------------------------------------
<>-------[]-----E--EX<X----X------------------------------------------------------------------------------------S---[]---[]----[]--<><>---<>----------------------------------<>--------X-XX------------------------------<>------------------------------------------------------------
[]--E----[]--E-------X]----X--E--EE-E-E-E-----------------E-----E-EEE-EE---------E-E-------EE-----------------------[]---[]--E-[]--[][]---[]----------------------------------[]-------XX-XX------------------------------[]---------EEEE---E--------EEE-----------E--------------------
XXXXXXXXXXXXXXXXXX--XXXXXXXXXXXXXXXXXXXXXXXXXXXX----XXXXXXXXXXXXXXXXXXXXXXXXXXXXXXXXXXXXXXXXXXXXXXXXXXXXXXXXXXXXXXXXXXXXXXXXXXXXXXXXXXXXXXXX----------------XXXXXXXX---XXXXXXXXXXXXXXXXXXXXXXXXXXXXXXXXXXXXXXXXXXXXXXXXXXXXXXXXXXXXXXXXXXXXXXXXXXXXXXXXXXXXXXXXXXXXXXXXXXXXXXXXXXXXXXXXX
