----------------------------X-----------------------------------------------------------------------------------------------------------------------------------------------------------------------------------------------------------------------------------------------------------
X-------------------------------------------------S----S--------------------------------------------------------X-----------------------------------------------------------------------------------------------------------------------------------------------------------------------
SS--------------------------SSSSSSSSSSSSSSSSSSSSSSSSSSSS--SSSSSSSSSSSSSSSSSSSSSSSSSS---------------------------------------------------------------------------------------------------------------------------------------------------------------------------SSSSSSSSSSS--------------
----------------------------SSSSSSSSSSSSSSSS----SSSSSSSS--S----SS-----------------------------------------------------------------------------------------------------------------------------------------------------------------------------------------------------------------------
----------------------------SSSSSSSSSSSSSSSS----SSSSSSSS-------SSS-------------------------------------------------------------------------------------------------------------------------------------------------------------------------------------------------SS-------------------
-----------SS---------------SSSSSSSSSSS--SSS----------SS-SSSSSSSSS---SSS-------SS-----------------------------------------------------------SSS-------------------SSS----------------------------------------------X----------------------------------------SSSSSSSSSS------------------
------------------------------------------------------------------------------------------------------------------------------------------------------------------------------------------------------------------XX--------------------------------------------------------------------
-----------------------------------------------------------------------------------------------------------------------------------X------------------------------------------------------------------------------XX--------------------------------------------------------------------
----------E------------------?--?------------------??------E----------------------------------------------------------------------------------------------------------------------------------------------------XXXX-----------------E----------E--------------E-------------------E----
--E--E---<>-----E------>----SSSSSSSSSSS--------E------XX-SSSSS-SSS---------E-------------------QQQQQ----------E-----------------------SS----SSSQS-------------XX-----------------------------------------------XXXXX----------------<>---------<>------------SSSS--SS---------XE--<>----
-<>-<>---[]----<>---E-[]----XSSSSSSSSSS-------<>-----------SS--SSS--------<>-------------------------------E-<>------E----------E----E-------------E----------XX----------------------------------------------XXXXXX-----E----------[]---------[]----X-----E----S--SSS--------<>--[]----
-[]-[]---[]----[]--<>-[]---XSSSSSSSSSSS-------[]-------X---SS-SSS---------[]---------------------------------[]-----<>---------<>---<>-----[------<>--------XXXX---------------------------------------------XXXXXXX----->----------[]---------[]----<>---<>---S--SSS-------X-[]--[]----
-[]-[]---[]----[]--[]-[]--XXSSSSSSSSSSS-------[]-----XXX------SS----------[]------------------------------E--[]-----[]----E----[]---[]-----E------[]-------XX-XX--------------------E----------E-E---E-E----XXXXXXXX-----]--E--EEE--[]-----E-E-[]----[]---[]------SSS-------X-[]--[]----
-XXXXXXXXXXXXXXXXXXXXXXXXXXXXXXXXXXXXXXXXXXXXXXXXXXXXXXXXXXXXXXXXXXXXXXXXXXXXXXXXXXXXXXXXXXXX--XXXXXXXXXXXXXXXXXXXXXXXXXXXXXXXXXXXXXXXXXXXXXXXXXXXXXXXXXX--XXXX-------XXXXXXXXX-XXXXXX-----XXXXXXXXXXXXXX-XXXXXXXXXXXXXXXXXXXXXXXXXXXXXXXXXX---XX---XXXXXXXXXXXXXXXXXXXXXXXXXXXXXXXXXXXX
