----------------------------------------------------------------------------------------------------------------------------------------------------------------------------------------------------------------------------------------------------------------------------------------
-----------------------------------------------------------------------------------------------------------------------------------------------------------------------S----------------------------------------------------------------------------------------------------------------
-----------------------------------------------------------------------------------------------------------------------------------------------SSSS-------------SS-----S----------------------------SSSSSSSSSSSSSSSSSSSSSSSSSSSS--------------------------------------------------------
-----------------------------------------------------------------------------------------------------------------------------------------------SSS--------------SS----SS------------------------------S------SS---------------------------------------------XEEE--E---------------------
-----------------------------------------------------------------------------------------------------------------------------------------------SS---------------SS---SSS-----------------------------------SSSS---------------------------------------------<XXX?XXXX-------------------
--------------------------------------------------------------------------------------------------------------------------------------------SSSSSSSSSS----SS-??S--------------------------------------------SS?---------------------------------------------?----------------SSSSSS-----
----------------------------------------------------------------------------------------------------------------------------------------------------------------------------------------------------------------------------------------------------------------------------------------
-----------------------------------------------------------------------------------------------------------------------------------X--------------------------------------------------------------------------S-------------------------------------------------------------------------
----------------------------------SSS---------------------------------------------------------------------------------------------------------EE-------------------E------------------------------------------S------------E------------------------------------------------------------
-----------------------------------------QQQ----------Q--------------Q----------------------------------------------------------------------SXS?SSSS------E----E--<>-X------------------X-------------E--SS--[]-----------[]---------------------X---S------XXXXX------------XXXXX-----X
--------------------------------------------------------------------------------------------------------------E-----------------E----------------SSSS--EX-----<---[]----------------X----------------<E------[]---------E-[]---------------------------------------X---EXXX-----------XX
-------------------------------------------------------------------------------------------------------------------------------<>----------------SSS--------X-X---[]--------------------------------S[]S-S---[]--------<>-[]---X----------------------------------XX--------------------
-------------------------------------E------------------------------------------------------E-EEE-------------E---E-EE----E----[]--------EE-----------------X-X-E-[]----------------EE-------E-E-----[]------[]--------[]-[]---X---------------------E---------------------XX---XXX-----
XXXXXXXXXXXX--XXXXXXXXXXXXXXXXXXXXXXXXXXXXXXXXXXX-XXXXXXXXXXXXXXXXXXXXXXXX----------XXXXXXXXXXXXXXXXXXXXXXXXXXXXXXXXXXXXXXXXXXXXXXXXXXXXXXXXXXX--XXXXXX-----X----XXXXXXXXX-XXXX-XXXXXXXXX-XXXXXXXXXXXXXXXXXXXXXXXXXXXXXXXXXXXXXX-----X--XXXXXXXXXXXXXXXXXXXX----------------------------
