------------------------------------------------------------------------------------------------------------------------------------------------------------------------------------------------------------------------------------------------------------X---------------------------
------------------------------------------------------------------------------S---------------------------------------------------------------------------------------------------------------------------------------------------------------------------------------------------S----S
--------------------------------------------------------SSSSSSSSSSSSSSSSSSSSSSSSSSSS--------------------------------------------------------------------------------------------------------------------------------------------SSSSSSSSSSSSSSSSSSSSSSSSSSSSSSSSSSSSSSSSSSSSSSSSSSSSSSSS
----------------------------------------------------------SSSSSSSSSSSSSS-----SSSSSSS------------------------------------------------------------------------------------------------------------------------------------------------------------------------SSSSSSSSSSSSSSSS----SSSSSSSS
--------------------------------------------------------S-SSSSSSSSSSSSS------SSSSSS-------------------------------------------------------------------------------------------------------------------------------------------------------------------------SSSSSSSSSSSSSSS-----SSSSSSSS
---------------------------------------------------XXX--SSSSSSSSSSS--SSS------SSSSSS---------------------------X--------------------------------------------------------------------EQQ-----XXXXXXXX-----------------------------S---------------------S----SSSSSSSSSSS--SSS----S-----SS
-------------------------------------------------------------------------------------------------------------------------------------------------------------------------------------------------------------------------------------------------------------S-S------------------------
------------------------------------------------------------------------------------------------------------------------------------------------------------------------------------------------------------------XX-------------S------------------------------------S-----------------
------------------------------------------------------------E------------------SS--------------------------------XXXXX---------------------------------------------------XSSSSSSS--------------------------------XXX-----------------------------------SS-------?------------------??---
SSS---------------XX----------------------XXXX------------SSSSSSSSS--------E-----------------------------SSSSSSS------------XX--------------------Q---------E-----------------------SSSS-----S-SS---------------XXXX------------SSSS----S-----------X--------SSSSSSSSSSS-------E--<>---X
-----------------XXX--------------------------------------SSSSSSSS--------<>------------------------------------------------------------X------------------<>-------------------------------------------------XXXXXX-----------<[------E---------X-XX-------XSSSSSSSSSS-------<>--[]----
---------------XXXXX-------X------------------------------SSSSSSSS--------[]-------------------------------------------------------------------------------[]------------------------------------------------XXXXXXX-----------[------<>--------XXXXX-------SSSSSSSSSSS-------[]--[]----
---------------XXXXX-----XXX-------------------------------SSSSSSS--------[]---------------EE------------E-E-----------------------------------------------[]-E---------------------------------------------XXXXXXXX--------E--[]-----[]------XXXX-XX-------SSSSSSSSSSS-------[]--[]---X
XXXXXXXXXXXXXXXXXXXXXXXXXXXXX----X--XXXXX------X-------XXXXXXXXXXXXXXXXXXXXXXXXXXXXX---XXXXXXXXXXXXXXXXXXXXXXXXX------XX----------X---------XXXXXXXXXXXXXXXXXXXXXXXX-XXX---XXXXXXXXXXXXXXXXXXXXX---XXXXXXXXX-XXXXX---XXXXXXXX-XXXXXXXXXXXXXXXXXXXXXX------XXXXXXXXXXXXXXXXXXXXXXXXXXXXXX
