----------------------------------------------------------------------------------------------------------------------------------------------------------------------------------------------------------------------------------------------------------------------------------------
----------------------------------------------------------------------------------------------------------------------------------------------------------------------------------------------------------------------------------------------------------------------------------------
------------------------------------------------------------------------------------SSSSSSSSSSSSSSSSSSSSSSSSSSSS-----S-SSSSS------------------------------------------------------------------------SSSSSSSSSSSSSSSSSSSSSSSSSSSS--------------------------------------------------------
------------------------------------------------------------------------------------SSS----SSSS-----------------------------------------------------------------------------------------------------SSS----SSS--------------------------------------------------------------------------
----XXX------------------------------XXX---------------------------------------------------SSSS-----------------------------------------------------------------------------------------------------SSS----SSS?--------------------------XXX--------------------------------------------
E----------------------------------------QQ---------SSSXX---SSSSQQSSSSS----------------S---SSSS---------------S-----------------XX-----------------------------------------SSSSSSSSSS-SS------------[SSS---SS------------------------------------------------------QQ-QQQQ--------------
--------------------------------------------------------------------------------------------------------------------------------XX-------------------------XXX--------------------------------------------------------------------------------------------------------------------------
--------------------------------------------------------]-------------------------------------S---------------------------------XX------------------------XXX---------------------------------------------------------------------------------------------------------------------------
---------------------------------SS---------------------X-X-----------------------E-----E-----E------------SS------------------XXXX----------------------XXXXX---------------------------------E---------------------------SS-----------------------------------------------------------
X---------------XXXX-------------------EQQQQQQ------S---------SS?S-SSSS----------<>----SSS-SSSSS--------E---------------Q-X-----XX----X------------------XXXX---------------SSSSSSSS----------<>----SSSSS--SSSS---------E------X-------------------------S--------QS?-QSSQQQ---------<>-
X------------XXXXX-X-------------------------------------------------------------[]-SSSSSS--SSS--------<>------X------------EXX-XX----X----E----------XXXXXXXX--------------------------------[]-------SS--SSSS--------<>------X----------E------------------------------------------[]-
---------------------------------------------------------------------------------[]-SSSSSSSSSSS--------[]------->-----------XXXXXX----X---XX---------XXXXXXXXX---------[----------------------[]-X---]SSS-SSSSS-----<>-[]----------------<>------------------------------------------[]-
-------------------------------------E--------E----------------------------EE-E--[]-SSSSSSSSSSS--------[]-------EE-E--------XXXXXX----X---XX---E----XXXXXXXXXX------E--[--------------------E-[]-X--S-SSSSSSSSS-----[]-[]------------E---[]--------------EE--------------------E-----[]-
XXX-------XX--------------X-XXXXXXXXXXXXXXXXXXXXX--XXXXXXXXXXXXXX---XXXXXXXXXXXXXXXXXXXXXXXXXXXXXXXXXXXXXXXXXXXXXXXXXXXXXXXXXXXXXX---XXXXXXXXXXXXXXX-XXXXXXXXXXXXXXXX-XXXXXXXXXXXXXXXXXXXXX-XXXXXXXXXXXXXXXXXXXXXXXXXXXXXXXXXXXXXXXXXXXXXXXXXXXXXXX---XXXXXXXXXXXXXXX--XXXXXXXXXXXXXXXXX
