----------------------------------------------------------------------------------------------------------------------------------------------------------------------------------------------------------------------------------------------------------------------------------------
----------------------------------------------------------------------------------------------------------------X-----------------------------------------------------------------------------------------------------------------------------------------------------------------------
----------------------------------------------------------------------------------------------------------------------------------------------------------------------------------------------------------------------------------------------------------------------------------------
----------------------------------------------------------------------------------------------------------------------------------------------------------------------------------------------------------------------------------------------------------------------------------------
----------------------------------------------------------------------------------------------------------------------------------------------------------------------------------------------------------------------------------------------------------------------------------------
-----------------------------------QQQQQ-----------SSSSSS-----------------X---------X-------QQQSQQS------SS----S-----------SS----------------XXX---------------------------------------------------------------?SSS---------------------------------------------------------------------
--------------------------------------------------------------------------X-------------------------------------------------------------------------------------------------------------------------------------------------------------------------------------------------------------
--------------------------------------------------------------------------X---------E---------------------------------------------------------------------------------------------------------------------------------------------------------------------------------------------------
-----E----------E--------------------------------------------------------XX-----------------------------------------------------E-------------------------------------------------------E------------XSSSSSSS-----------------E---------------------------------------E------------E----
----<>---------<>----------E------Q---QQQQ--------------XQQ--------------XXX---------------S?SQSSSSS---------X-------E---E-----<>--------------------------------------------E---------<>----------------------SSSSS---------<>----------------------------E-----S---<>-----------<>----
----[]---------[]---------<>----------------------------X-------------EXXXXXX-------------------------------XXXX----<>---------[]---E-------------------X-------------------<>---------[]------E--E--------------------------[]-----------------E----E----<>---------[]-----------[]----
----[]---------[]---------[]----------------------------]-------------XXXXXX------XX--------------------------------[]---------[]--<><>-----------------X-------------------[]---------[]-----<>-----------------------------[-----------------<>---------[]---------[]-----------[]----
-E--[]---------[]---------[]------------------E---------]---------------XXXX-----XXX-------------------E------------[]---------[]--[][]----------EE-E---X----------E-EE-----[]---------[]-----[]------------------------------------EE---------[]---------[]---------[]-----------[]----
-XXXXXXXXXXX---XX-X-XXXXXXXXXXXXXXXXXXXXXXXXXXXXXXXXXXXXXXXXXXXX--XXXXX-----XXXXXXXX-XXXXXXXX--XXXXXXXXXXXXXXX----XXXXXXXXXXXXXXXXXXXXXXXXXXXXXXXXXXXXXXXXXXX---XXXXXXXX-XXXXXXXXXXXXXXXXXXXXXXXXXXX---XXXXXXX--XXXXXXXXXXXXXXXXXXXXXXXXX-XX-XXXXXXXXXXXXXXXXXXXXXXXXXXXXXXXXXXXXXXXXXXX
