----------------------------------------------------------------------------------------------------------------------------------------------------------------------------------------------------------------------------------------------------------------------------------------
----------------------------------------------------------------------------------------------------------------X-----------------------------------------------------------------------------------------------------------------------------------------------------------------------
------------------------------------------------------------------------------------SSSSSSSSSSSSSSSSSSSSSSSSSSSS------------------------------------------------------------------------------------------------------------------------------------------------------------------------
------------------------------------------------------------------------------------------------------------------------------------------------------------------------------E---------------------XEEE--E-----------------------------------------------------------------------------
---------------------------------------------------------------------------------------------S?---------------------------------------------------------------------------XXXXXXX--------------------XXXXXXXX---------------------------------------------------------------------------
----------------------------------------------------------------------------------------------------------------------------S------------------------------------------------------------XXXX-------?----------------SSSS--------------------------------------S------------------------
----------------------------------------------------------------------------------------------------------------------------------------------------------------------------------------------------------------------------------------------------------------------------------------
----------------------------------------------------------------------------------------------------------------------------------------------------------XXXXXX------------------------------------------------------------------------------------------------------------------------
----------------------------------------------------------------------------------------------E---------------------------------E------------------------------------------XXXX--------------------S---------------------------S--------------------------------------------------------
-----E----------E------------------------------------------------------XX----------->--S-----<]---------E------X-----E---------<>----------E------------------------------XXX-------XXX-----XX------XXXXX------------XXXXX--------------------------SSSSSSSQ---XX-----------------------
----<>---E-----<>---------------------------E---------------------------------------SSSSS----[]--------<>------X----<>---------[]---------<>---------------------E------------------------------XXXX-----------EXXX-----------XX--------------------------------------------------------
----[]---------[]----<X--------------------<>---------------------------------------SS?SS----[]--------[]------X----[]---------[]----<>---[]---------------------------[-----------------------------------X------------------X-XXX-----------------------------------------------------
EE--[]-----E-E-[]----[-----X----EE---------[]----------E----------------------------SSSSS-ES-[]--------[]----XXX----[]---------[]----[]---[]-EE-EEE-E-EEE-EE--------EE-E---------------------XX--------------------X-----XX-------------E------------E-E--------------------------------
XXXXXXXXXXXXXXXXXX-XXXXXXXXXXXXXXXXXX-XXXXXXXXXXXXXXXXXX---X----XXXXXXX--XXXXXXXXXXXXXXXXXXXXXXXXXXXXXXXXXXXXXXX-XXXXXXXXXXX-X-XXXXXXXXXXXXXXXXXXXXXXXXXXXXXXXXXXXXXXXXX--------------------------------------------------------X----XXXXXXXXXXXXXXXXXXXXXXXXXXX--XXXXXX----XXXXXXX--XX-
