----------------------------------------------------------------------------------------------------------------------------------------------------------------------------------------------------------------------------------------------------------------------------------------
----------------------------------------------------------------------------------------------------------------------------------------------------------------------------------------------------------------------------------------------------------------------------------------
----------------------------------------------------------------------------------------------------------------------------------------------------------------------------------------------------------------------------------------------------------------------------------------
----------------------------------------------------------------------------------------------------------------------------------------------------------------------------------------------------------------------------------------------------------------------------------------
--------------------------------------------------------------------------------------------------------------------------------------------------------------------------------------------------------------------------------------------------------------------------E-------------
----------------------------------------------E---XXXX------------QQQQQ--------------SSS---SSS-------------------------------------S-----------S---SSS--------------SS-----S------------------------------------------------------------------------------------------------------------
----------------------------------------------------------------------------------------------------------------------------------------------------------------------------------------------------------------------------------------------------------------------------------------
--------------------------------------------------------E------S------------------------------------------------------------------------------------------------------------------------------------------------------------------------------------------------------------------------
----------------------------------------------------------S-SSSSS-----------------E------------------------E-----------------------------------E-------------------------------------------------------------------X--------------------------------------------------------------------
-------------XXX--------------------------XXX----------------------SSSSS-Q-------<>----SS-----------------<>-----------------------------------?S-----------------------------------------------------------------XXX------------X-----------------------QQS---------------------------S
------------XXXX-------------------------XXXXX-----------------------------------[]-------------------X---[]------------------------------------------------------------------------------------------------------XXX-------------------------------------------------------------------
----------XXXXXX-------------------------XX-X------------------------------------[--------------------X---[]-----------------------------------------------------------------------------------------------------XXXX----------------------------------------XXX------------------------
---------XXXXXXX--------E--------------------------------------------------E--------------------------X---[]------------------------------------------------------------------------------E--------------------E-XXXXX----------XX-----E----------------------------E---EE---------E----
XXXXXXXXXXXXXXXXXXXX----XXXXXXXXX---XXXXXX--------------XXXXXXXXXXXXXXXXXXXXXXXXXXXXXXXXXXXX---XXXXXXXXXXXXXXXXXXXXXXXXX--XXX-XXXXXXXXXXXXXXXXX---XXXXXX----XXX---------XXXXXXXXXXXXXXXXXXXXXXXXXXXXXXXXXXXXXXXXXXXXXXXX-----XXXXXXXXXXXXX---XXXXXXXXXXXXXXXXXX-XXXXXXXXXXXX-----XXXXXXX
