----------------------------------------------------------------------------------------------------------------------------------------------------------------------------------------------------------------------------------------------------------------------------------------
----------------------S-----------------------------------------------------------------------------------------------------------------------------------------------------------------------------------------------------------------------------------------------------------------
---SSSSSSSSSSSSSSSSSSSSSSSSS--------------------------------------------------------SSSSSSSSSSSSSSSSSSSSSSSSSSSSSSSSSSSSSSSSSSSSSSSSSSSSSSSS--------------------------------------------------------------------------------------------------------------------------------------------
--SS----------------SSSSSS-S--------------------------------------------------------SSSSSSSSSS------------SS----------------------------------------------------------------------------------------------------------------------------------------------------------------------------
-SSS----------------SSSSSSSS--------------------------------------------------------SSSSSSSSSS?------------S----------------------------------------------------------------------------------------------------------------------------------------------------------------------------
SSS----S-----S--------SSS---------SQQQQQQ-------------------------------------------SSSSS--SS----S---------SS----SSS---SSS----------------S-----SSSSSSSSS---------------------SQQQSQ-----------------------------------------------------------------------------------SS---------------
----------------------------------------------------------------------------------------------------------------------------------------------------------------------------------------------------------------------------------------------------------------------------------------
------------------------------------------------------------------------XXXX------------------------------------------------------------------------------------------------------------------------------------------------------------------------------------------------------------
--E--------------------SS--------------------------E-------------------------------------------------------SS------------------------------------------------------E---------------------------E-----------------------------------------------------------------E----------E-----------
SSS??-------------XXX-----XX------S--SQSQ---------<>--------------------------------SSSSS--SSSS--------E?----------SS--SSSS----------------------SSSSSSS----------<>---------SS--SSQ----------<>----------------------X-------------------------X---------------<>---------<>----------E
-------E----X----XXXX-----------------------------[]-----------------------------------SS-SSSS--------->-----------S-----SS--------<-------X-->-------------------[]--------------------------[]------------------EXXX-------------------------XX----------E----[]---------[]---E-----<>
------<>--------XXXXX-----------------------------[]-----------------------------------SSSSSSS------<XXXX----------S-----SS--------[]------X-[--------------------[]--------------------------[]-----------------------------------------------XXX--------<>----[]---------[]---------[]
------[]-------XXXXXX--------------------------E--[]------E--EE-E-E-E---------E--E-E---SSSSSSS------[][]X-------------E--S---------[]----XXX-------------------E--[]--------------------------[]-----------------------------XX--------------XXXXX--------[]----[]---------[]---------[]
XXXX-XXXXXXXX--XXXX------XX-XXXXXXXXXX-XXXXXXXXXXXXXXXXXXXXXXXXXXXXXXXXXXXXXXXXXXXXXXXXXXXXXXXXXXXXXXXXX------XXXXXXXXXXXXXXXXXXXXXXXXXXXXXXXXXXXXXXXXXXXXXXXXXXXXXXXXXXXXXXXXXXXX-XXXXXXXXXXXXXXXXXXXXXXXX--XXXXXX----XXXXXXXXXXXXXXXXXXXXXXXXXXXXXXXXXXXXX--XXXXXXXXXXXXXXXXXXXXXXXXXX
