--------------------------------------------------------X-------------------------------------------------------------------------------------------------------------------------------------------------------------------------------------------------------------------------------
----------------------------------------------------------------------------SSS----S----------------------------------------------------------------------------------------------------------------------------------------------------------------------------------------------------
----------------------------------------------------------SSSSSSSSSSSSSS----SSSSSSSS----------------------------------------------------------------------------------------------------------------------------------------------------------------------------------------------------
----------------------------------------------------------SSSSSSSSSSSSSS----SSSSSSSS----------------------------------------------------------------------------------------------------------------------------------------------------------------------------------------------------
--------------------------------------------------------X--SSSSSSSSSSSSS----SSSSSSSS-----------------------------------------------------------------XX---------------------------------------------------------------------------------------------------------------------------------
-------Q--QQQQQ--------------------------------------------SSSSSSSSSSSSS----SS----SS----------------------------Q--------------------------------------QQQQ---------SSSS----------S-----------------------------------------------------------------------------------------------------
--------------------------------------------------------EE-S----------------------------------------------------------------------------------------------------------------------------------------------------------------------------------------------------------------------------
--------------------------------------------------------X------------------------------------------XXXXX-------------------------------------------------------------------------------------------------------------------------------------------X------------------------------------
------------------------------------------------------------E-----------------------------------------------------------------------------------------------E---------------------------------------------------------SS----------------------------------------------------------------
------Q---QQQQQQQQ------------------------XXXX------------E-SSSSSSSS---------------------------------------------------------XXXXX--------------E-----QQQQ-?QQ------------E--SS--SS--------------------------E------E-------------------------------------------------------X-----------
----------------------------------------------------------E--------------------E-------------------------E---------------------------------------------------------------<>--------------------E-------------E-----------------E-----E----------E----E---------------------XX----------E
-------------------------X]------------------------------SS--X----------------<>-------------------------------[---------------------------------------------------------[]-------------------<>-------------------XE----<X---<>----<>---------<>----------[---------------XX---------<>
-------------------E-----[]------------------------------[]------E--------EEE-[]-----EE-EEE-E-EEE-EE------E-EE-E----------------------------------------------EE---------[]------E--------EE--[]----E]-----------E-------XX---[]----[]---------[]----------[---E-------E-XXXX---------[]
XXXXXXXXXXXXXXXXXXXXXXXXXXXXX----X-----XX--------XXXXXXXXXXXXXXXXXXXXXXXXXXXXXXXXXXXXXXXXXXXXXXXXXXXXXXXXXXXXXXXXX--X----XXXX---------------XXXXXXXXXXXXXXXXXXXXXXXXXXXXXXXXXXXXXXXXXXXXXXXXXXXXXXXXXXXXXXXXXXXXXXXXXXXXXXXXXXXXXXXXXXXXXXXXXXXXXXXXXXXXXXXXXXXXX-XXXXXXXXXXXX----XX--XX
