----------------------------------------------------------------------------------------------------------------------------------------------------------------------------------------------------------------------------------------------------------------------------------------
------------------------------------------------------------------------------------------------------------------------------------------------------------------------------------------------------------------------------------------------------------X---------------------------
------------------------------------------------------------------------------------------------------------------------------------------------------------------------------------------------------------------------------------------------------SSSSS-----------------------------
------E---------------------------------------------------------------------------------------------------------------------------------------------------------------------------------------------------------------------------------------------------------------------------------
-----XXXX-------------------------------------------------------------------------------------------------------------------------------------------------------------------------------------------------------------------------------------------------------------------------------
-----------------XXXX------------------------------------------------Q--------------------------------------------------------------------------------?SS-------------------------------------------------------------------------------------------------S-----------------SSS---------
----------------------------------------------------------------------------------------------------------------------------------------------------------------------------------------------------------------------XX--------------------------------------------------------E-------
-------------------------------------------X-----------------------------------------------------X------------------------------------------------------------------------------------XXXXXX--------------------------------------------------------------------------------X----E------
---XXXX------------------------------------X------------------SSS--------------------------------X-----------------XXX---------------------X----------E------------E----------------------------------------------------------------------E----------------------E----------XE--<>------
------------XXX----------X-------------------------------------------?S---------S?SS----------------------SSSSSS------------------------------E--SS--S]-----E-----<>-----------------------------------------------------------S-----SS--SS------------------E--<>---------XX-----------
-------------------------XXX-----------XXXXX--------------------------------------------------E------------------X---------------------------<>------[]----<------[]---------E---------------E-----------------------------------<>-----------------E-------<>--[]---X--X-XXX----X------
-------------------------XX-----------XXXXXX-------------------------------------------------<>----------------------------------------------[]--X---[]----[------[]-------------------X----<>-----------------------------------[]----------------<>-------[]--[]--------XXX---<>X-----
----------------------X--X----------XXXXXXXX--------E--E-------E-E-----------------------E-E-[]------------E--E-XXX--------------------------[]------[]----[------[]-----EE-EE----EE--EE----[]------------------------------------]------E---------[]-------[]--[]-----E-XXXX---[]------
------------------XXXXXXXXX-XXXX--XXXXXXXXXXXXXXXXXXXXXXXXXXXXXXXXXXXXXXXXXXXXXXXXXXXXXXXXXXXXXXXXXXXXX-XXXXXXXXXXXXXXXXXXX---XXXXXXXXXXX---XXXXXXXXXXXXXXXXXXXXXXXXXXXXXXXXXXXXXXXXXXXXXXXXXXXXXXXX-----XXXXXXX--XXX----XXXXXXXXXXXXXXXXXXXXXXXXXXXXXXXXXXXXXXXXXXXXXXX--XXX---XXXXXXXX
