----------------------------------------------------------------------------------------------------------------------------------------------------------------------------------------------------------------------------------------------------------------------------------------
----------------------------------------------------------------------------SS-----S--------------------------------------------------------------------------------------------------------------------------------------------X-------------------------------------------------------
----------------------------------------------------------SSSSSSSSSSSSSSSS--SSSS-SSS----------------------------SSSSSSSSSSSSSSSSSSSSSSSSSSSS--------------------------------------------------------------------------------------------------------------------------------------------
---------------X------------------------------------------SSSSSSSSSSSSSS----SSSSSSSS----------------------------------------------------------------------------------------------------------------------------------------------------------------------------------------------------
---------------X----------------------------------------]-SSSSSSSSSSSSSS----SSSSSSSS----------------------------------------------------------------------------------------------------------------------------------------------------------------------------------------------------
---------------X-S---------------------------XXXXXXXXS---SSSSSSSSSSSSSSS----SS----SS-----SSSSSSSSS-------S--SSSS-------------------------------------------------------------------------------------XXX------------------------X----------SS----------------XXXX-----------------------
--------------XX----------------------------------------ES------------------------------------------------------------------------------------------------------------------------------------------------------------------------------------------------------------------------------
-------------XXXX----E--------------------------------------------------------------X---------------------------------------------------------------------------------------------------------------------------------------------------------------------------------------------------
------------XXXXXE--<>----------XXX-------------------------E------------------E------------------------------------------E----------------------------------------------------------------------------------------------------------E----------E---------------------------------------
-E---------XXXXXX-----------------------------X-XX---------?SSSSSSSS-------E--<>---------SSSSSSSQQ-----------------S-----<>----------------X------------------------------------------XXXX-------------------------------------------E---------<>---------------------------------------
<>---E----XXXXXXX----X-----<------------------------------E-SSSS----------<>--[]---------------------------------SES-----[]--------<>------X----------------------------------------------------------------------------------------<>---------[]---------------------------------------
[]--<>-----XXXXXX---<>-----[-----------------------------SSSSSSS----------[]--[]--------------------------------SS?S-----[]--------[]------X---------------XXX----------------------------------------------------------------------[]---------[]---X<>----X----------------------------
[]--[]---X-XXXXXX---[]-----[-------------------------------------E--------[]E-[]-----------------------EE-------S-S------[]--------[]------X--------------X-XX--------------------------------------------------E------------EE-----[]-------E-[]---][]----X--------E---E---------------
XXXXXXXXXXXX--XXXXXXXXXXXXXX---------X-----XXXXXXXXX---XXXXXXXXXXXXXXXXXXXXXXXXXXXXXXXXXXXXXXXXXXXXXXXXXXXXXXXXXXXXXXXXXXXXXXXXXXXXXXXXXXXXXXXXXXXXXXXXXXXXXXXXXXXXXXXXX---------X---------------------XXXXXX--XXXXXXXXXXXXXXXXX--XXXXXXXXXX-XXXX---XXXXXXXX-----XXXXXXXXXXXX----XXXXXXX
