----------------------------------------------------------------------------------------------------------------------------------------------------------------------------------------------------------------------------------------------------------------------------------------
----------------------------------------------------------------------------------------------------------------------------------------------------------------------------------------------------------------------------------------------------------------------------------------
------------------------------------------------------------------------------------------------------------------------------------------------------------------------SSSSSSSSSSSSSSSSSSSSSSSSSSSS------------------------------------------------------------------------------------
----------------------------------------------------------------------------------------------------------------------------------------------------------------------------------------------------------------------------------------------------------------------------------------
------------------------------------------------------------------------------------------------------------------------X---------------------------------------------------------------------------------------------------------------------------------------------------------------
----------------------------------------------------------------------------------------------SQSQ-------------------------------XXX----------------------------------------------------------------------------SSS------XX-----SSSSSSSSSSS---------------------------------------------
----------------------------------------------------------------------------------------------------------------------------------------------------------------------------------------------------------------------------------------------------------------------------------------
-----------------------------------------------------------------------------------------------------------------------------------------------------------------------------------------XX---------------------------------------------------------------------------------------------
--------------------------------------------------------------------------------------S-SSSSS-----------------E--XXXXXX-------------------E---------------------------------------------XXXS---------XXXXX---------------------X----------------------------------------------SS--------
-------------XXX------------QQQ---------------X--------------------------------------------S?--SSSSS---------<>-------------XX-----------<>-------------------------------------Q-S-----XXX---X-----------------SS-----------------SS--SS-------------------<>---E----------E-----------
-----------XXXXX--------------------------EXXXXX-------------------------------------------------------------[]--------------------------[]------------XXXXX----------------------------XX----X------X-------------------------------------------------E----[]--<>---E-----<>-----X----E
----------XXXXXX---------------------------------------------------------------------------------------------[]--------------------------[]-----------XXXXXX--------------------------XXXXXX--X----X----------------------------------------------<---<>----[]--[]---------[]----<>---<>
---------XXXXXXX--------E--E------------------------------------E--------------E-EE--------------------E-----[]--------------------------[]---------XXXXXXXX--------E--EE--E--E------XXXXXX--------X-X--------------------------------------------E---[]----[]--[]-----E-XX[]----[]---[]
XXXXXXXXXXXXXXXX-XXXXXXXXXXXXXXXX---XXXXXXXX--XXXXX-XXXXXXXXXXXXXXXXXXXXXXXXXXXXXXXXXXXXXXXXX---XXXXXXX-XXXXXXXX------XX---------XXXXXXXXXX-XXXXXXXXXXXXXXXX-XXXXXXXXXXXXXXXXXXXXXXXXXXXXXXX---X-------XXXXXXXXX--XXXXXXXXXXX---XXXXXXXXXXXXXXXXXXXXXXXXXXXXXXXXXXXXXXXX-XXXXXX-XXXXXXXX
