----------------------------------------------------------------------------------------------------------------------------------------------------------------------------------------------------------------------------------------------------------------------------------------
----------------------------------------------------------------------------------------------------------------------------------------------------------------------------------------------------X-----------------------------------------------------------------------------------
SS--------------------SSSSSS------------------------------------------------------------------------------------------------------------------------------------------------------------------------------------------------------------------------------------------------------------
----------------------------------------------------------------------------------------------------------------------------------------------------------------------------------------------------------------------------------------------------------------------------------------
-------------------------------------------------------------------------------------------------------------------------------------------------------------------------------------------------------------XXX------------------------------------------------------------------------
-----------------------------------Q--QQQQQ---------SSSS------------------------------------------------------------------------------SSSSS----S---------------------------------------------------X-------------------------------------------------------------------?SSS-------------
----------------------------------------------------------------------------------------------------------------------------------------------------------------------------------------------------------------------------------------------------------------------------------------
----------------------------------------------------------------------------------------------------------------------------------------------------------------------------------------------------------------------------------------------XXXXXX------------------------------------
----------E------------E---------------------------------------------------------------------------------------------------------------------------------------------------------------------------------E----------Q----------------------------------------XSSSSSSS------------------E
--E--S---<>-----E-----<>--------E-Q---QQQQQQQQ---------------------------------------------------------------S----------------X--------------------------------------------------------------SSSSSS----------------->-----S--------------------------------E-----------SSSSS------------
-<>------[]----<>---E-[]--------------------------------------------------X-------------------------------------------------------------------------------------------------------E----------------------E----E----[]---------------------------E---------<>----------------------------
-[]--X---[]----[]--<>-[]---X--------------------------------------------XXX-----------------------------------------------------------------------------------X------------------<>---------------------<>---<>----[]--------------------------<>---------[]----------------------------
-[]------[]----[]--[]-[]-----------------------E------------------------XXX-----------------E----E---------E--------------------------------------------------X--------------E---[]---------------------[]---[]----[]---------E[--E-EE----E----[]---------[]----------------------------
XXXXXXXXXXXXXXXXXXXXXXXXXXXXXXXXXXXXXXXXXXXXXXXXXXXXXXXXXXXXXXXXXXXXXXXXXXXXXXXXXXXXXXXXXXXXXX-XXXXXXXXXXXXXXXXX-------XXXXXXXXXXXXXXXX--XXXXXXXXXXXXXXXXXXXXXXXXXXXXXXXXXXXXXXXXXXXXXXXXXXXXXXXXXXXXXXXXXXXXXXXXXXXXXXX--XXXXXXXXXXXXXXXXXXXXXXXXXXXXXXXXXX---XXXXXXXXXXXXXXXXXX-------
