----------------------------------------------------------------------------------------------------------------------------------------------------------------------------------------------------------------------------------------------------------------------------------------
----------------------------------------------------------------------------------------------------------------------------------------------------------------------------------------------------------------------------------------------------------------------------------------
--------------------------------------------------------S-SSSSSSSSSSSSSSSS--SS----------------------------------------------------------------------------------------------------------------------SSSSSSSSSSSSSSSSSSSSSSSSSSSS--------------------------------------------------------
----------------------------------------------------------SSSSSSSSSSSSSS----S------S-----------------------------------------------------------------------------------------------------------------------SS---------------------------------------------------------------------------
--------------------------------------------------------]-SSSSSSSSSSSSSS----SS----S----------XXX-----------------------------------------------------------------------------------------------------------SSS--------------------------------------------------------------------------
--------SQSS----------------------------------------X---SSSSSSSSSSS--SSS----S-----------------------------------------------------------------------------------------------------------X------------SSSS--SS----S----------------------------------------------------------------------
----------------------------------------------------------------------------------------------------------------------------------------------------------------------------------------X-----------------------------------------------------------------------------------------------
-----------------------------------------------------------------------------------------------------------------------------XX----X--------------------------------------------------------------------------------------------------------------X-------------------------------------
--S--------------------------------------------------------E-------------------E--?-----------------------------------------------------------------------------------------------------XX---------------------------------SS----S---------------XX-------------------------------------
-------S?--SSSSS---------<>---------------XXXX-----------SSSSSSSSS---------E--<>------------------QQ---------QQ-----------------------S--S-------------------------------E--------------X-----------SSSSS--SSSS--------E?------XSQQ-------------XXXX----------------------------------Q-
-------------------------[]-------------------------------SSSSSSSS--------<>--[]--------------E---------------------------E-----E---------------------------E---------E-<>-------X------X------------------SSS--------->X------X---------------XXXXX------------------------------------
-------------------------[]-------------------------------SSSSSSSS------X-[]--[]-------------<>--------------------------<>--------------------------------<>--------<>-[]----------XXXXXX-------------S--SSS-------<XXXX-------]--------------XXXXX------------------------------------
-------------------E-----[]--------------------------------SSSSSSS--------[]--[]-------------[]---------------E---E--E---[]------------E-EE-----EE---------[]--------[]-[]-E--------XXXXXX-------------SS-SSS-------[]-XX-------]-------------XXXXXX---------------E-EE--------------EE-
XXXXXXXXXXXXXXXXXXXXXXXXXXXXXXXXX-----XXXXX----XXXX-XXXXXXXXXXXXXXXXXXXXXXX-XXXXXXXX--XXXXXXXXXXXXXXXXXX--XXXXXXXXXXXXXXXXXXXXXXXXXXXXXXXXXXXXXXXXXXX-XXXX-XXX--XXXXXXXXXXXXXXXXXXXXXXXXX--XXXXXXXXXXXXXXXXXXXXXXXXXXXXXXXXXXXXXXXXXXXXXXXXXXXXXXXXXXXXXXXXXXXXXXXXXXXXXXXXXXX----XXXXXX
