----------------------------------------------------------------------------------------------------------------------------------------------------------------------------------------------------------------------------------------------------------------------------------------
----------------------------------------------------------------------------------------------------------------------------------------------------------------------------------------------------------------------------------------------------------------------------------------
SSSSSSSSSSSSSSSSSSSSSSSSSSSS------------------------------------------------------------------------------------------------------------------------------------------------------------------------------------------------------------------------------------------------------------
----------------------------------------------------------------------------------------------------------------------------------------------------------------------------------------------------------------------------------------------------------------------------------------
-------------------------------------------------------------------------------------------------------------------------------------------------------------------------------------------------------------XXX------------------------------------------------------------------------
-------------------------------------------------------------------------XX---------X-----------SSS----------S-------------------------------------QQQQQQ-----------SSSS-------SQQSS-------------------------------------------------------------XX-------------------------S-----------
-----------------------------------------------------------------------XXXX---------------------------------------------------------------------------------------------------------------------------------------------------------------------XXX-------------------------------------
----------------------------------------------------------------------XXXXX--------------------------------------------------------------------------------------------------------------------------------------------------------------------XXXX-------------------------------------
----------E----------------------------------------------------------XXXXXX---------XXXXX-----------------------------------------------------------------------------------------------------------------------------------------------------XXXXX-------------------------------------
---S----SSS---------E-------------------X-------------------------X--XXXXX-----------------S?---SSS---------------------------XXX----------------QQ---QQQ--?------------------SSS--SSSS----------<>----------------Q----------E-----------X--XXXXXX-------------------------X----------E
---------S---------<>------X-----------XXX------------------------XXXXXXXX----------------------------------XXXX-------------XX--------------<>--------------------------------------------------[]-----------E--------------<>-----------X-EXXXXXX------------------------XX---------<>
---------S---------[]------------------XXX-----------------------XXXXXXXXXX--------------------------------------------------XX--------------[]--------------------------------------------------[]----------<>--------------[]-----------XXXXXXXXX------------------------XX---------[]
------E--S---------[]---------------EXXXXX----------EE-E---------XXXXXXXXXX-----E------------------------------------------X------------E-EE-[]---------------EE---------------------------EE-E--[]----------[]--------------[]-----------XXXXXXXXX----------E--E------E-XXXX---------[]
XXXXXXXXXXXXXXXXXXXXXXXXXXXXXXXXXXXXXXXXXX-X--XXXXXXXXXXXXXXX---XXXXXXXXXXXXXXXXXXXX----XXXXXXX----XXXXXXXXXX---XXXXXXX---XXXXX---XXXXXXXXXXXXXXXXXXXXXXXXXXXXXXXXXX-XXXXXXXXXXXX---XXXXXXXXXXXXXXXXXXXXXXXXXXXXXXXXXXXXXXXXXXXXXXXXXX--XXXXXXXXXXXXXX-XXXXXXXXXXXXXXXXX-XXXXXXXXXXXXXXX
