------------------------------------------------------------------------------------------------------------------------------------------------------------------------X---------------------------------------------------------------------------------------------------------------
------------------------------------------------------------------------------S---------------------------------------------------------------------------------------------------------------S----S------------------------------------------------------------------------------------
--------------------------------------------------------SSSSSSSSSSSSSSSSSSSSSSSSSSSS------------------------------------------------------------------------------------SSSSSSSSSSSSSSSSSSSSSSSSSSSS------------------------------------------------------------------------------------
----------------------------------------------------------SSSSSSSSSSSSSS-----SSSSSSS------------------------------------------------------------------------------------SSSSSSSSSSSSSSSS----SSSSSSSS------------------------------------------------------------------------------------
--------------------------------------------------------S-SSSSSSSSSSSSS------SSSSSS-------------------------------------------------------------------------------------SSSSSSSSSSSSSSS-----SSSSSSSS------------------------------------------------------------------------------------
------------------------SSSS----------------------------SSSSSSSSSSS--SSS------SSSSSS---------------------------X--------------------------------------------------------SSSSSSSSSSS--SSS----S-----SS-------QQQQQQ--------SSSSSSS-XXX------------------------------------------X---------
-------------------------------------------------------------------------------------------------------------------------------------------------------------------------S-S--------------------------------------------------------------------------------------------------X---------
----------------------------------------------------------------------------------------------------------------------------------------------------------------------------------S------------------------------------------------------------------------------------------XX---------
------------------------------------------------------------E------------------SS--------------------------------XXXXX------------------------------------------------------?------------------??----------------------------------------------------------------------------XX---------
------------SS--------------SSS---------------XX----------SSSSSSSSS--------E-----------------------------SSSSSSS------------XX--------------------Q---------E------------SSSSSSSSSSS-------E--<>---X------SS--QQQQ----------------------------------------------------------XXX---------
---------------------------------------------XXX----------SSSSSSSS--------<>------------------------------------------------------------X------------------<>-----------XSSSSSSSSSS-------<>--[]--------------------------------------------------------------------------EXXXX---------
-------------------------------------------XXXXX-------X--SSSSSSSS--------[]-------------------------------------------------------------------------------[]-----------SSSSSSSSSSS-------[]--[]--------------------------------------------------------------------------XXXXX---------
-------------------------------------------XXXXX-----XXX---SSSSSSS--------[]---------------EE------------E-E-----------------------------------------------[]-E---------SSSSSSSSSSS-------[]--[]---X------------------E-----------------E---E-----------------------------XXXXX---------
XXXXXXXXXXXXXXXXXXXXXXXX-XXXXXXXXXXXXXXXXXXXXXXXXXXXXXXXXXXXXXXXXXXXXXXXXXXXXXXXXXXX---XXXXXXXXXXXXXXXXXXXXXXXXX------XX----------X---------XXXXXXXXXXXXXXXXXXXXXXXX-XXXXXXXXXXXXXXXXXXXXXXXXXXXXXXXXXXXXXXXXXXXXXXXXXXXXXXX-X-XXX---XXXXXXXXXXXX-------XXXXXXXXXXXXXXXXXXX-------------
