----------------------------------------------------------------------------------------------------------------------------------------------------------------------------------------------------------------------------------------------------------------------------------------
----------------------------------------------------------------------------------------------------------------------------------------------------------------------------------------------------------------------------------------------------------------------------------------
--------------------------------------------------------------------------------------------------------------------------------------------------------------------------------------------------------------------------------SSSSSSSSSSSSSSSSSSSS------------------------------------
----------------------------------------------------------------------------------------------------------------------------------------------------------------------------------------------------------------------------------------------------------------------------------------
----------------------------------------------------------------------------------------------------------------------------------------------------------------------------------------------------------------------------------------------------------------------------------------
-------------------------------------------------------------------------------------------------------------XXX------------------------------------------------------------SSSSQQSSS------------------S--SSSSS-------------------------------------------------------------------------
----------------------------------------------------------------------------------------------------------------------------------------------------------------------------------------------------------------------------------------------------------------------------------------
------------------------------------------------------------------------------------------------------------------------------------------------------------------------X---------------------------------------------------------------------------------------------------------------
----SSSSS----------------------------------------------------------------------E-------------------------------------------------------------------------------------------------------------------------------------------E---------------------------E--------------------------------
------------S?SQ----------E-----------------------------SSQ---------------XXX-<>------------------QQ-------SS-----------------XXX---------------------------------------------SSSS-SSSS----------X--------SSS-------------<>----SS-S----SQS-----------<>-------------------X-----------E
-------------------------<>------------------------------------E---------XXXX-[]---------------------------------------------XXXXX--------------------------XX-----------------------------------XX-----------------------[]-----------------------X--[]-------------------X----------<>
-------------------------[]-----------------------------------<>--------XXXX--[]---------------------------------------------XXXXX-------------------------XXXX----------------------------------XX-----------------------[]--------------------<>-X--[]------------------XXX---------[]
-------E-E---------------[]-----------------------------------[]-------XXXXXX-[]---X---------E-----------------------------XXXXXXX------------------------XXXXX----------------------------EE-E--XX-------------------E---[]----E-----E---------[]----[]---------------E--XX----------[]
XXXXXXXXXXXXXXXXXXXXXXXXXXXX---X---XXXXX--XXXXXXXXXXXXXXXXXXXXXX--XXXXXXXXXXXXXXXXXXXXXXXXXXXXXXXXXXXXXXX--XXX-XXXXXXXXXXXXXXXXXXXXXXXX-XXXXXXXXXXXXXXXXXXXXXXX--------XXXXXXXXXXXXXXXXXXXXXXXXXXXXXXXXXXXXXX--XXXXXXXXXXXXXXXXXXXXXXXXXXXXXXXXXXXXXXXXXXXXXXXXXXXXX--XXXXXXXXXXXXXXXXXX
