----------------------------------------------------------------------------------------------------------------------------------------------------------------------------------------------------------------------------------------------------------------------------------------
----------------------------------------------------------------------------------------------------------------------------------------------------------------------------------------------------------------------------------------------------------------------------------------
----------------------------------------------------------------------------------------------------------------------------------------------------------------------------------------------------------------------------------------------------------------------------------------
---------------------------------------------------------------------------------------------------------------------------------------------------------------------------------E------------------------------------------------------------------------------------------------------
---------------------------------------------------------------------------------------------------------------------------------------------------------------------------------XXX----------------------------------------------------------------------------------------------------
S----------------------------------------------------------------------X----------------------------------------Q-----------------------------------------------------------------------------------------------------------------------------------------------------------------------
-----------------------------------------------------------------------X-----------------------------XX-------------X-------------------------------------------------------------------------------------------------------------------------------------------------------XXXX--------
---------------------------------------------X------------------------XX----------------------------XXX---------------------------------------------------------------------------------------------------------------------------------------------------------------------------------
--------------------------------------------XXX---------------------XXXX---------------------------XXXX-------------------------------------------------------------------------------------------------------------------------------------------------------------------------------E-
SQQQ--------------XX----------------Q-------XX----------------------XXXX--------------------------XXXXX----------------------XXXXX---------------E---------<>--------------------------Q----------E--------------------------------------------<>------------X-----------------------QQS
-----------------XXX------------------------XX--------------------XXXXXX-------------------------XXXXXX-----------------------------------------<>---------[]---------------------E--------------<>---------------------------E----------------[]------------X--------------------------
----------------XXXX---------------------XXXXX-------------------XXXXXXX------------------------XXXXXXX-----------------------------------------[]---------[]--------------------<>--------------[]--------------------------<>----------------[]-----------XXXX------------------------
---------------XXXXX--------E--E--------XXXXXX-------------E----XXXXXXXX--------E--E----------XXXXXXXXX-----------------------------------------[]-----E---[]--------------------[]--------------[]--------------------------[]----------------[]-----------XXXX------------------------
XXXXXXXXXXXXXXXXXXXXXXXXXXXXXXXXXXXXXXXXXXXXXXXX----XXXXXXXXXXXXXXXXXXXXXXXX-X--XXXXXXXXX----XXXXXXXXXXX---XXXXXXX--XXX---XXX---------------XXXXXXXXXXXXXXXXXXXX---XXXXXXXXXXXXXXXXXXXXXXXXXXXXXXXXXXXXXXXXXXXXXXXXXXXXXXXXXXXXXXXXXXXXXXXXXXXXXXXXX--XXXXXXXXXXXXXXXXX--XXXXXXXXXXXXXXX
