----------------------------------------------------------------------------------------------------------------------------------------------------------------------------------------------------------------------------------------------------------------------------------------
----------------------------------------------------------------------------------------------------------------------------------------------------------------------------------------------------------------------------------------------------------------------------------------
----------------------------------------------------------------------------------------------------------------------------------------------------------------------------------------------------------------------------------------------------------------------------------------
----------------------------------------------------------------------------------------------------------------------------------------------------------------------------------------------------------------------------------------------------------------------------------------
------------------------------------------------------------------------------------------------------------------------------------------------------XX--------------------------------------------------------------------------------------------------------------------------------
--------------------------S------------------------------XXX----------------------------------------------XXXX---------------------------------------------------------------------------------------------------------------------------------------------------------------X----------
---------------------------------------------------------------------------------------------------------------------------------------------------------------------------------------------------------------------------------------------------------------------------XXX----------
--------------------------------------------------------------------------------------------------------------------------------------------------------------------------------------------------------------------------------------------------------------------------XXXX----------
----------------------------------------------------------------------------------------------------------------------SSS------------------------------------------------------------------------------------------------------------------------------------------------XXXXX----------
----------------E-----------XQQQ--------------XX--------------------------------------Q--------------------------------------QQQ---------------------------Q---------------------------<>----------------------------------------XQX--------------XX---------------------XXXXX---------E
---------------<>------------------E-----XXXX-XX---------------------------------------------------X------------------------------------------------------------------E----------------[]------------X----------------------------------------XX----------------------X-XXXXXX--------<>
---------------[]-----------------<>-----------X---------------------------------------------------------------------------------------------------------------------<>----------------[]----------------------------------------------------------------------------XXXXXXXXX--------[]
---------------[]-E---------------[]-------X----------------------E-E----------------------------------------------------E---------------------------E---------------[]----------------[]----------------------------------------------------------------------E-----XXXXXXXXX--------[]
XXXXXXXXXXXXXXXXXXXXXXXXXXXXXXXXXXXXXXXX----------------XXXXXXXXXXXXXXXXXXXXXXXXXXXXXXXX----XXXXXXXXXXXXXXX-XXXXXXXXXXXXXXXXXXXXXXX------X--XXXXXXXXXXXXXXXXXXXXXXXXXXXXXXXXXXXXXXXXXXXXXXXX---XXXXX----XXXXXXXX--XXXXXXXXXXXX-XXXX-------X-----------------XXXXXXXXXXXXXXXXXXX--XXXX-XX
