----------------------------------------------------------------------------------------------------------------------------------------------------------------------------------------------------------------------------------------------------------------------------------------
----------------------------------------------------------------------------------------------------------------------------------------------------------------------------------------------------X-------------------------------------------------------X---------------------------
----------------------------SSSSSSSSSSSSSSS-SSSSSSSSSSSS--------------------------------------------------------------------------------------------------------------------------------------------SSSSSSSSSSSSSSSSSSSSSSSSSSSS--------------------------------------------------------
------------------------------SS--SSSSSSS-----------------------------------------------------------------------------------------------------------------------------------------------------------------------------------------------------------------------------------------------
----------------------------------SSSSSSS-----------------------------------------------------------------------------------------------------------------------------------------------------------------------------------------------------------------------------------------------
------------------X----------S-S-SSSSSSSS----------------------------------------------------------X--------------------------------------X--XXX----------------------------------------------------------------------------------XX----------------------------------------SSS---------
------------------X---------X---------------------------------------------------------------------XX----------------------------------------------------------------------------------------------------------------------------------------------------------------------------E-------
-----------------XX-------------------S-----------------------------------------------------------XX---------------------------X-------------------------------------------------------------------------------------------------------------------------------------------------E------
-----------------XX-------------E-----S------------E--------------------------------------------XXXX--------------------------XX------------------------------------------------------------------------------E------SSS----------------------------------------------------E-----------
----------------XXX-----------E--SSSSSSS----------[]--------------------------------------------XXXX-----------E------------XXX--------------------------------------------------Q------E-----------<>---S---<>-----------X---------------------------------->---E---------<>----------E
--------------EXXXX----------<E------SS-----------[]--------------------XX--------------------XXXXXX----------<>----------XXXXXX------------------------X------------------------------<>-----------[]--<>---[]----------XX----E----------------------------[]--<>---E-----[]----X----<>
--------------XXXXX----------[]--X---SS-----------[]-------------------XXX-------------------XXXXXXX----------[]---------XXXXXXX------------------------X------------------------------[]-----------[]-------[]---X-E--E-XX---<>----------------------------[]--[]---------[]----<>---[]
--------------XXXXX----------[]------ES-------EE--[]------------------XXXX-----------E-E----XXXXXXXX----------[]--------XXXXXXXX------E-E-----------E---X--------E-E-------------------[]-----------[]--E----[]--XX------XX---[]--E---E-E-E-E---------E-----[]--[]-----E-E-[]----[]---[]
XXXXXXXXXXXXXXX-------------XXXXXXXXXXXXXXXXXXXXXXXXXXXXXXXXXXXXXXXXXXXXXXXXX-XXXXXXXXXXXXXXXXXXXXXXXXXX-XXXX-XXXXXXXXXXXXXXXXXXXXXXXXXXXXXXXXXXXXXXXXXXXXXXXX--XXX-XXXXXXXXXXXXXXXXXXXXXXXXXXXXXXXXXXXXXXXXXXXXXXXXXXX--XXXXXXXXXXXXXXXXXXXXXXXXXXXXXXXXXXXXXXXXXXXXXXX---XX---XXXXXXXX
