----------------------------------------------------------------------------------------------------------------------------------------------------------------------------------------------------------------------------------------------------------------------------------------
----------------------------------------------------------------------------------------------------------------------------------------------------------------------------------------------------------------------------------------------------------------------------------------
----------------------------------------------------------------------------------------------------------------------------------------------------------------------------------------------------------------------------------------------------------------------------------------
-------------------------------------E-----------------------------------------------------------------------------------------------------------------------------------------SSSS-S---------------------------------------------------------------------------------------------------
-------------------------------------XXX---------------------------------------------------------------------------------------------------------------------------------------SSSSSS---------------------------------------------------------------------------------------------------
-----------------------------------------------------------------------------------X--------------------------XX---------------X-------------------------------------------S-SSSSSSSS-------------SS-----------------------------------------------------------------------------------X
------------------------------------------------------------------------------------------------------------------------------XX--------------------------------------------------------------------------------------------------------------------------------------------------------
---------------XX------------------S------------------------------------------------------------------------------------------XX--------------------------------------------------S-----------------------------------------------------------------------------------------------------
---------------------------------SSSS---------------------------------------------------------------------------------------XXXX----------------SSSSS-----------------------------------------------------------------------------------------------------------------------E-----------
---------------------------E-----------QQQQQ-Q--------E--------------------------------------------------SSS----------------XXXX-----------------------QQQQQ----------E---E--SSSSSSS-------------------------------------------E-------------------------------------------QQ-----------
--------------------------<>-------------------------<>-------------------------------------------------------------------XXXXXX-------------------------------------<>--<>------------------------------E----------E----E----<>--------------------------------------------------------
---------------X>---------[]-------------------------[]------------------------------------------------------------------XXXXXXX-------------------------------------[]--[]--X--------------------------<>---------<>---------[]----------------E---------------------------------------
-E--E------E--EX----------[]-------------------E-----[]-------------------------------------E-E-E---------E------E-E----XXXXXXXX--------E--E-------------------------[]--[]------E--------EE------------[]---E-----[]---------[]----------------------------------------------E---------
XXXXXXXXXXXXXXXXXXXXXXXXXXXXXXXXXXXXXXXXXXXXXXXXXXXXXXXXXXXXXXXXXXXXXXXXXXXXXX--XXXXXXXXXXXXXXXXXXXXXXXXXXXXXXXXXXXXXXXXXXXXXXXXXXXXXXXXXXXXXXXXXXXXXX-XXXXXXXXXXXXXXXXXXXXXXXXXXXXXXXXXXXXXXXXX-XXXXXXXXXXXXXXXXXXXXXXXXXXXXXXXXXXXXXXXXXXXXXXXXXXXXXXXXXXXXXXXXXXXXXXXXXXXXXXXX--XXXXX
