----------------------------------------------------------------------------------------------------------------X-----------------------------------------------------------------------------------------------------------------------------------------------------------------------
----------------------------------------------------------------------------------------------------------------------------------------------------------------------------------------------------X-----------------------------------------------------------------------------------
------------------------------------------------------------------------------------SSSSSSSSSSSSSSSSSSSSSSSSSSSSSSSSSSSSSSSSSSSSSSSSSSSSSSSS--------------------------------------------------------SSSSSSSSSSSSSSSSSSSSSSSSSSSS--------------------------------------------------------
----------------------------------------------------------------------------------------------------------------SSSSSSSSSSSSSSS--------S--SS-------------------------------------------------------------------------------------------------------------------------------X------------
----------------------------------------------------------------------------------------------------------------SSSSSSSSSSSSSS------------S----------XXX-------------------------------------------------------------------------------------------------------------------X------------
-------------------------------------------------------------------------------------S-----SS--------------------SSSSSSSSSS--S------------SS----------------------------S-SSSSSSSS----SS----SS-----S--------------------------------SS--SSSS-------------------------------X------------
----------------------------------------------------------------------------------------------------------------ES-S------------------------------------------------------------------------------------------------------------------------------------------------------XX------------
--------------XX----------------------------------------------------------------------------------------------------------S----------------------------------------------------------------------------------------------------------------------------------------------XXX------------
-------------XXXX---------------------------E--------------------------------------------------------------E--------E-----S------------SS--------S----------E-------------EE----------------------------------E---------------------------------------------------------XXXX------------
-------------XXX-----------------E---------<>----------ESQQQ--------------XXX-------SSSSS--SS----------XX-<>---X---SSSSSSSSS--------E------X----E------E--QQQ---------E----?SSSSS-----E-----------X------S---[]----------------X-------SS---SS-------------------------XXXXX------------
----------XXXXXXX---------------<>---------[]------E--<>-------E---------XXXX--------------S---------X-XX-[]---X-SSSSS--SSS--------<>------X--------------------------E------------------------------<>------[]---------E------X-------------------------[]-----------XXXXXX-----E-----<
---------XXXXXXXX---------------[]---------[]-----<>--[]------<>--------XXXXX-------------<>--------XXXXX-[]---XSS?SSSSSSSS--------[]------X-------------------------[]-----------------------------S[]------[]--------<>------X-------------------------XX----------XXXXXXX-----X-----[
--------XXXXXXXXXX------E-------[]---------[]-----[]--[]------[]-------XXXXXX------X]-----[]-------XXXXXX-[]--XXSSSSSSSSSSS--------[]------X---------E---------E-----[]---------------------E-E-----S[]------[]--------[]------X-------------------------XX--E-E----XXXXXXXX-----X--E--[
XXXXXXXXXXXXXXXXXXXXXXXXXXXXXXXXXXXXXXXXXXXXXX----XXXXXXXXXXXXXXXXXXXXXXXXXXXXXXXXXXXXXXXXXXXXXXXXXXXXXXXXXXXXXXXXXXXXXXXXXXXXXXXXXXXXXXXXXXXXXXXXXXXXXXXXXXXXXXXXXXXXXXXXXXXXXXXXXXX---XXXXXXX--XX-XXXXXXXXXXXXXXXXXXXXXXXXXXXXXXXXXXXXX--XX---XXXXXXXXXXXXXXXXXXXXXXXXXXXXXXXXXXXXXXXX
