----------------------------------------------------------------------------------------------------------------------------------------------------------------------------------------------------------------------------------------------------------------------------------------
------------------------------------------------------------------------------------------------------------------------------------------------------------------------------------------------------------------------S---------------------------------------------------------------
-------------------------------------------------------------------------------------------------------------------------------------------------------------------------------------------------------SSSSSSS---SSS----SSSSSSSS----------------------------SS--------------------------
------------------------------------------------------------------------------------------------------------------------------------------------------------------------------------------------------SSSSSSSSSSSSSS----SS-SSSSS---------------X----------------------------------------
-------------------------------------------------------------------------------------------------------------------------------------------------------------------------------------------------------SSSSSSSSSSSSS----SSSSSSSS---------------X----------------------------------------
------------?S-------------------------------------------------------------------------------------------------------------------S---------------------------------------------------------------------SSSSSSSSSSSSS----SSSSSSSS---------------X----------------------------------------
----------------------------------------------------------------------------------------------------------------------------------------------------------------------------------------------------EE----------------------------------------XX----------------------------------------
-------------------------------------------------------------------------------------------------------------------------------XX--------------------------XX---------------------------------------X----------------------------------------XXX----------------------------------------
--------------------------XE---------------------------------------------------------------------------------------------------X-----------------E---------X--------------------------------------------E-----------------------------------XXXX-----------------------------SSS--------
-X----------------------S--SQQ----------------XX---------------------------------QQ--------------------------------------------XX----------E-------------------------------------Q------E---------------SSSSSSSS----------------------------XXXX------------<>---E---E------X----------E
-X----------------------------------------EXXXXX---E------------------------------------------E-----E--------------------------XX---------<>-----E----------E----E---------------------<--------------E-----------------------------------XXXXXX------------[]--<>---E-----XX-----X---<>
----------------------------------------------X----------------------------------------------<>-------------------------------XXX---------[]----<>---------<>---<>----------------------]------------SS--X-------------------------------XXXXXXX-----------[[]--[]--------XXE----<>---[]
XXX----E-E------------------------------------X------XX--------E-E----------------E------E---[]--------------EE--E--E------E--XXX---------[]-E--[]-----E---[]---[]-----E----------------]-E----------[]---------------EEE---------------XXXXXXXX--------E--[[]--[]-------XXXX----[]---[]
XXXXXXXXXXXXXXXXXXXXXXXXXX-XXXXXXXXX-XXXXXXXXXXXXXXXXXXX---XXXXXXXXXXXXXX------XXXXXXXXXXXXXXXXXXXXXXXXXXXXXXXXXXXXXXXXXX-XXXXXXXXXX--XXX-XXXXXXXXXXXXXX-XXXXXXXXXXXXXXXXXXXXXXXXXXXXXXXXXXXX---XXXXXXXXXXXXXXXXXXXXXXXXXXXXXXXXXXXXXXXXXXXXXXXXXXXXXXXXXXXXXXXXXXXXXXXX---XXX--XXXXXXXX
