----------------------------------------------------------------------------------------------------------------------------------------------------------------------------------------------------------------------------------------------------------------------------------------
----------------------------------------------------------------------------------------------------------------------------------------------------------------------------------------------------------------------------------------------------------------------------------------
SSSSSSSSSSSSSSSSSSSSSSSSSSSS--------------------------------------------------------SSSSSSSSSSSSSSSSSSSSSSSSSSS-------------------------------------------------------------------------------------------------------------------------------------------------------------------------
----------------------------------------------------------------------------------------------------------------------------------------------------------------------------------------------------------------------------------------------------------------------------------------
----------------------------------------------------------------------------------------------------------------------------------------------------------------------------------------------------------------------------------------------------------------------------------------
----------------------------------------?SS-------------------------------------S-------------------------------X---SSSSQQSSS---------------X------------------SSSS-----------------------------------------Q-QQ------------------------------------------------XX---------E----------X-
----------------------------------------------XX----------------------------------------------------------------------------------------------------------------------------------------------------------------------------------------------------------------------------------------
-----------------------------------------------------------------------------------------------------S----------X-----------------------------------------------------------------------------------------------------------------------------------------------------------XXXX--------
------------------------------------------------------XX---------------------------------------------XXS------------------------------------X-XXX----------------------------E----------E-----------------------------------------------------------------------------------------------
---S----S-S------------------X-----------------------------------Q--------------------------Q-S------X----X-----------SSSS-SSSS----------<>-------------XXX-----------------<>---------<>----------E----------QSQQ------------------------------------------------------X---------------
-------------------X---------X-----------------------------------------------------------------------X----X------------------------------[]---------------------------------[]---------[]---------<>-------------------------------------------------------------------XXX--------------
----------------<>-XX-------XXX----------------------------------------------------->-------------XXXX-X--X---XX-------------------------[]---------------------------------[]---------[]---------[]-------------------------------------------------------------------XX---------------
------E---------[]-X--------XXX-------------------------------------------E---------E-----E------XXXXX-X--X---XX-------------------EE-E--[]---------------------------------[]---E-----[]---------[]-----------------------------------E-----------------EE---E--EE-EXXXX---------E-EE-E
XXXXXXXXXXXXXXXXXXXXXXXXXXXXXXXXXXXXXXXX--XX--X--XXXXX--XXXXXXXXXXXXXXXXXXXXXX-XXXXXXXXXXXXXXXXXXXXXXXX---XXX-XXXXXXXXXXXXXXXXXXXXXXXXXXXXXX-------XXXX-------------------XXXXXXXXXXXXXXXXXX--XXXXXXXXXXXXXXXXXXXXXXXXXXXXXXXXX-XXXXXXXXXXXXXXXXXXXXXXXXXXXXXXXXXXXXXXXXXXXXXXXXXXXXXXXX
