----------------------------------------------------------------------------------------------------------------------------------------------------------------------------------------------------------------------------------------------------------------------------------------
----------------------------------------------------------------------------------------------------------------------------------------------------------------------------------------------------------------------------------------------------------------------------------------
----------------------------------------------------------------------------------------------------------------------------------------------------------------------------------------------------------------------------------------------------------------------------------------
----------------------------------------------------------------------------------------------------------------------------------------------------------------------------------------------------------------------------------------------------------------------------------------
--------------E-------------------------------------------------------------------------------------------------------------------------------------------------------------------------------------------------------------------------------------------------------------------------
--------------------------------------------------------------------------------------------------------------------------------------------Q-------------------------------------------------------X---SSSSSQSSSSS------S----------------------------------------------------E---------
------XX-------------XXXXX---------------------------------------------------------------------------------------------------------------------XXX----------------XXXX--------------------------------------------------------------------------XXXX-------------------------<>---------
---------------------------------------------------------------------------------------------------------------------------------------------------------------------------------------XXXXX--------]----------------------------------------------------------------------XXXX---------
--------------------------------------------------------------------------------------------------------------E-------------------------------------------------------------------------------------X-X-------------------------------------------------------------------XXXXX---------
---------------XXXX--------Q----------------------SS---------------------------------X-----------------------<>-------------XXXX------------X------------XXXXX---------------------------------------------S?S-S?SS----------XX----------------------SSSSSSS-------------XXXXX----------
---------------------------------E----E-----E-----------------------X----------------X-----------------------[]-----------XXXXXX---------------------------------------------------------------------------------------------XX-----------------------------------------XXXXXX----------
-XX----------------------------------<>----<>-----------------------X---------------XXXX---------------------[]-----------XXXXXX-------------------------X-------------------------------------------------------------------XX-XXX-----------------------------------XXXXXXXXX---------
-------------E-------E-E--------EE---[]----[]-----------------------XE-------E-E----XXXX---------------------[]---------XXXXXXXX------E-EE-E------------------------------E-EE----EE--EE-----------E-------------------EE-E--XX-XX-----EE------------E-E-------------XXXXXXXXX------E---
------------XXX----XXXXXXXXXXXXXXXXXXXXXXXXXXXXX---XXXXXXXXXXXXXXXXXXXXXX---XXXXXXXXXXXXXXXXX------X--XXXXXXXXXXXXXXXXXXXXXXXXXX-XXXXXXXXXXX---------XXXX---------------XXXXXXXXXXXXXXXXXXXXXXXXXXXXXXXXXXXXXXXXXXXXXXXXXXXXXXX------XXXXXXXXXXXXXXXXXXXXXXXXXXXXX---XXXXX----------X---
