----------------------------------------------------------------------------------------------------------------------------------------------------------------------------------------------------------------------------------------------------------------------------------------
----------------------------------------------------------------------------------------------------------------------------------------------------------------------------------------------------------------------------------------------------------------------------------------
----------------------------------------------------------------------------------------------------------------------------------------------------------------------------------------------------------------------------------------------------------------------------------------
---------E------------------------------------------------------------------------------------------------------------------------------------------------------------------------------------------------------------------------------------------>-----------------------------------
---------X---------------------------XXX-----------------------------------------------------------------------------------------------------------------------------------------------------------------------------------------------XX-----------------------------------------------
------------EQQ------------------------QQQQ-----------------------------------------Q----------------------XX--------------------------------------------------------------------------------------------------------------S---------------?SSS---XXXXX-------SS----S-----------SSSSSS--
----------------------------------------------------------------------------------------X---------------------------------------XX------------------------------------------------------------------------------------------------------------------------------------------------------
-------S-----------------------------------------------------------------------------------------------------------------------XXX------------------------------------------------------------------------------------------------------------------------------------------------------
--SSSSSSS-----------------E------S----------E---------------------------------------------------------------------------------XXXX-----------------------------------------------------------------------------------------------XXXXXX-------------------XX----------------------------
-----------SS?SQ---------<>-----E-----QQQQQQQQ--------E------------------------------------------XXXXXX-----------------------XXXX--------------------------------S--SSS----------------------------QQQ---------------XX--------------------XX--------------S?SXS--------------X--------
-------------------------[]--------------------------<>----------------------------------------------------------------------XXXXX--------------------E----------------------E----E-----E---------E---------------EXXXXX---------X----------------------XEXS----------------------------
-------------------------[]--------------------------[]--------------------------------------------------------------------XXXXXXX-------------------<>---------------------<>---------<>----------------------------XXX------------------------------------------------------X---------
-------------------------[]----------E---------E-----[]-------------------------------------------------------------------XXXXXXXX-----------------E-[]------------E--------[]---E-----[]---------E----------------X-XXX--------XX--------------------------------------------X---------
XXXXXXXXXXXXXXXXXXXXXXXXXXXXXXXXXXXXXXXXXXXXXXXXXX-XXXXXXXXXXXXXXXXXXXXXXXXXXXXXXXXX---------XXXXXX----X-X--X-XXXXXXXX-XXXXXXXXXXXXXX---XXXXXXXXXXXXXXXXXXXXXXXXXXXXXXXXXXXXXXXXXXXXXXXXXXXXXXXXXXXXXXXXXXXXXXXXXXXXXXXXXXXXXXXX-----------------XXXXXXX----XXXX--XXXXXXXXXXXXXXXXXXXXXX
