----------------------------------------------------------------------------------------------------------------------------------------------------------------------------------------------------------------------------------------------------------------------------------------
-----------------------------------------------------------------------E----SS-----S--------------------------------------------------------------------------------------------------------------------------------------S-------------------------------------------------------------
-----------------------------------------------------------SSSSSS-----<>----SSS---SS-------------------------------------------------------------------------------------S---S-SSSSSSSSSSS------------SSSSSSSSSSSSSSSSSSSSSSSSSSSSSSSSSSSSSSSSSSSSSSSSSSSSSS----------------------------
-----------------------------------------------------------SSSSSSSSSSSSS----SS-SSSSS------------------------------------------------------------------------------------------------------------------SS----------------SSSSSSSS--------------------------------------------------------
-----------------------------------------------------------SSSSSSS----SS----SSS-SSSS-----------------------------------------------------------------------------------------------------------------SSSS--SS-----------SSSSSSSS--------------------------------------------------------
--------------------------------------------------------?--SSSSSSSSSSSSS----SS----SS----------------------------------------------------------------------------------------------------XXX---------SSS-S--S-----SS---------------------------------------------------------------------
---------------------------------------------------------E------------------------------------------------------------------------------------------------------------------------------XXX------------------------------------------------------------------------------------XX-------
--------------------------------------------------------]-------------------------------------------------------------------------------------------------------------------------------XXX---------------------------------------------------------------------------------------------
-------------------------------------------------------------------------------------------------------------------------------------------------E----------E--------------------------XXXX-----------E--------------------SS-------------E------------E--------------------------------
---------------<>------------------------------------------?SSSSSS---------------XXX-------------------------SSSX----------------XXX------------<>---------<>----------E----------X-----XXX---X-----SXS??-------------XXXX---XXX>--S-----<>---------E-[]---------------------SS-SS--S--Q
-----E---------[]-----------------------------------------------------------------------------E-------------------------------XXX---------------[]---------[]----E----<>>------------XX-XXX---X------------X?--EX----XXXX-------SSSS-----[]--------<>-[]---X-E--------------------------
----<>---------[]----X---------------------------------------X----------------------------------------------------------------------------------[]---------[]---<>----[]]---------X-XXXXXXX---X----X------<>--------XXXXX------XSS-S-----[]--------[]-[]---XXXXX------------------------
-E--[]-----E-E-[]----------------------------------------------------------EE-E------------E-EE-------------------------------------------------[]---------[]---[]----[]]--E-------XXXXXXXX---X----X------[]-------XXXXXX------XS-----E--[]--------[]-[]---XXX--------------------------
XXXXXXXXXXXXXXXXXXXXXX-XXXXX-----X--XXXXXXXXX----XXXXXXXXXXXXXXXXXXXXXXXXXXXXXXXXXXXXXXXXXXXXXXXXXXXXX----XXXXXXX---------XXX-X----XXXXXXXXXXXXXXXXXXXXX-X-XX---XXXXXXXXXXXXXXXX-XXXXXXXXX----XXX-XXXXXX-XXXXXXXXX-XXXXXXXXXXXXXXXXXXXXXXXXXXXXXXXXXXXXXXXXX--------XX---XXXXXXXXXXXXXXX
