----------------------------------------------------------------------------------------------------------------------------------------------------------------------------------------------------------------------------------------------------------------------------------------
----------------------------------------------------------------------------------------------------------------------------------------------------------------------------------------------------------------------------------------------------------------------------------------
------------------------------------------------------------------------------------------------------------------------------------------------------------------------SSSSSSSSSSSSSSSSSSSSSSSSSSSS------------------------------------------------------------------------------------
------------------------------------------------------------------------------------------------------------------------------------------------------------------------SSSSSSSSSSSSS---------------------------------------------------------------------------------------------------
------------------------------------------------------------------------------------------------------------------------------------------------------------------------SSSSSSSSSSSSS-------------S-------------------------------------------------------------------------------------
-----------------------XX-------------------------------------------------------------------------------------X----SSSSSSSSSS-SS------SSSSSS-----------------------------SSSS-SSSSS---------------SS----------------------------X---S---S?SSS--------SSSSSSS----------------------------
------------------------------------------------------------------------------------------------------------------------------------------------------------------------ES--------------------------------------------------------------------------------------------------------------
--------------------------------------------E------------------------------------------------------------------------------------------------------------XX-XXXX------------------S-----------------------------------------------------------------------------------------------------
---------------------------------E---------<>-------------------------------------------------------------------------------------------------------------------------------E-----S------------SS-------------------------------X-X-----------------------------------------------------
-------------XXXXX--------------<>----------]----------E-------------X-XX-----------------------XX------------------SSSSSSS---------------------------------------S--------SSSSSSSSS-------------------------------------------S-------S?---?SS-----------------------------------------
--------------------------------[]---------[E----E----<>------------XX-------------------------XXX----------------------------------------------------E-----E------------SSSSS--SSS--------<-------X--------------------------------------------------------------------XX--------------
-------------XX-----------------[]---------<>---<>----[]-----------XXX------------------------XXXX--------------------------------<-------------------E----<>------------SSSSSS--SS--------[]--------XXX---------------------------------------------------------------XXX--------------
--------------------------------[]---------[]---------[]-----------XXX-------EE-EE-E--------XXXXXX-E-----EE-E---------------------E]----------E-EE----S----[]--------EE[-SSSS--S-SS--------[]-----------------------------------------------------------------------EXXXXXEE--------EE-E
XXXXX----XXXXXX----XXX--X-XXXXXXXXXXXXXXXXXXXXXXXXXXXXXXXXXXXXX---XXXX---XXXXXXXXXXX--XXXX-XXXXXXXXXXXXXXXXXXXXXXXXXXXXXXXXXXXXXXXXXXXXX-XXXXXXXXXXXXXXXXXXXXXXXXXXXXXXXXXXXXXXXXXXXXXXXXXXXXXXXXXXXXXX--XX-X----XXXX--XXXXXXXXX------XXXXX-----XXX---------XXXXXXXXXXXXXXXXXXXXXXXXXXXX
