----------------------------------------------------------------------------------------------------------------------------------------------------------------------------------------------------------------------------------------------------------------------------------------
----------------------------------------------------------------------------------------------------------------------------------------------------------------------------------------------------------------------------------------------------------------------------------------
----------------------------------------------------------------------------------------------------------------------------------------------------------------------------------------------------------------------------------------------------------------------------------------
----------------------------------------------------------------------------------------------------------------------------------------------------------------------------------------------------------------------------------------------------------------------------------------
----------------------------------------------------------------------------------------------------------------------------------------------------------------------------------------------------------------------------------------------------------------------------------------
-----------------SSS---------------QQQQQQ-----------SSSS------------------------S----SS-------------------SSSS---------------------------------------------E----------------------------------------------------------X----SS----------------------------------------S--------SS--------
----------------------------------------------------------------------------------------------------------------------------------------------------------------------------------------------------------------------X-----------------------E-----------------------------------------
-------------------------------------------------------------------------------------------------------------------------------------------------------------XXX-----------------------------------------------------XX----------------------XXXXXXX------------------------------------
----------------------------------------------------------------------------------------------------------------------------------------------------------------------------------------------------SS---------------XX-----------------------------------------------------------------
--XX--------------XX--------------Q---QQQ---------------------------------X-----------------------------------------------------------------------------X--------------------------------------S----QQ--------------XXX-------------------------------S-------------------------------E-
----------------------------------------------------------------------EXXXX------------------------X--X-------------------------E----------------------XXX------------------------------------------>-------------XXXXXX-----------------------------E-------------------------------<>-
-----------------------------------------------------------------------X-XX------------------------XX-X------------------------<>---------------------XXXX-------------[----------------------------]-------------XXXXXX-----------------------------------[-------------------------[]-
----------------------------------------------EE---------------------------------------------------X-----------------------E---[]-----------------E-XXXXXX-E------E-EE-[---------EE-----------------]-------------XXXXXX---------EE-EEE-E-EEE-EE------E-EE-E-------------------------[]-
XXXXXXXX---XX-XXXXXXXXXXXXXXXXXXXXXXXXXXXXXXXXXXXXXXXXXXXXXXXX--XXXXXXXXXXXXXXXXXXXXXXXXX--XXXXXX--XX-----------XXXXXXXXX-XXXXXXXXXXXXXXXXXXXXXXXXXXXXXXXXXXXXXXXXXXXXXXXXXXXXXXXXXXXXXXXXXXXXXXXXXXXXXXXXXXXXXXXXXXXXXXXX--XXXXXXXXXXXXXXXXXXXXXXXXXXXXXXXXXXXXXXXXX--X---XXXXXXXXXXXXX
