----------------------------------------------------------------------------------------------------------------------------------------------------------------------------------------------------------------------------------------------------------------------------------------
----------------------------------------------------------------------------------------------------------------------------------------------------------------------------------------------------------------------------------------------------------------------------------------
------------------------------------------------------------------------------------SSSSSSSSSSSSSSSSSSSSSSSSSSSS----------------------------------------------------------------------------------------------------------------SSSSSSSSSSSSSSSSSSSSSSSSSSSS----------------------------
----------------------------------------------------------------------------------------------------------------------------------------------------------------------------------------------------------------------------------------------------------------------------------------
----------------------------------------------------------------------------------------------------------------------------------------------------------------------------------------------------------------------------------------------------------------------------------------
-XXXX------------------------------Q--QQQ-----------SSSSX---SSSSSQSSS---------------------------------------------XXX--------------------------------------------------------------------------------------QQQQQQQ-------------------------------XX-----------------QQSS----------------
------------------------------------------------------------------------------------------------------------------------------------------------------------------------------------------------------------------------------------------------XXX-------------------------------------
-----------------------------------------------------------------------------------------------------S------------------------------------------------------------------------------------------------------------------------------------------XXX-------------------------------------
-------------X--------------------------------------------------------------------------------------XSSS-------------------------------------------------------------------------------------------------------------------------S-------------XXXX-------------------------------------
----------------------S--S----E--QQ---QQQ---Q-----------------SS?S-SSSS----------X--<>------SQS------X----X---------------------------S-------------------------------------------------------------------SS?-QSQQQQ---------<>-----------XX----XXXX--X------------S?--SSSS-------------
-----------------------------<>--------------------------------------------------XX-[]---------------]----X----X------------------------------------------------------------------E-----E------------------------------------[]->------------XX-XXX---X------------------------------X--
------------X----------------[]--------------------------------------------------XX-[]-----------XX-[]-XX-X---XX------------------------------------------------------------------E------------------------------------------[]-]---------X-XXXXXXXX--X----X-------------------------XX-
--E--EEEE-E-X----------E-EE--[]---------------EE------------------------------E-----[]----E------XX-[]----X--XXX--E--EEEE-E-E---------EE-E------------EEE-EE-----------------E---[]------------------------------------EE-E--[]-]--E--------XXXXXXXX--X----X-------------------------X--
XXXXXXXXXXXXXXXXXXXXXXXXXXXXXXXXXXXXXXXXXXXXXXXXXXXXXXXXXXXXXXXXXXX-XX--X----X---XX-XXXXXXXXXXXXXXXXXX--XXXXXXXXXXXXXXXXXXXXXXXXXXX-XXXXXXXXXXXXXXXXXXXXXXXXXXXXXXXXXXXXXXXXXXXXXXXXXXXXXXX-----XXXXXXXXXXXXXX-XXXXXXXXXXXXXXXXXXXXXXXXXXXXXXXXXXXX---XXX-XXXXXXXXXXXX-XXXXXXXXXXXXXXXX-
