----------------------------------------------------------------------------------------------------------------------------------------------------------------------------------------------------------------------------------------------------------------------------------------
----------------------------------------------------------------------------------------------------------------------------------------------------------------------------------------------------------------------------------------------------------------------------------------
------------------------------------------------------------------------------------SS-----------------SSSSSSSSS-------------------------------------------------------------------------------------------------------------------SSSSSS-----SS-----------------SSSSSSSSSSSSSSSSSSSSSSS
-----------------------------------------------------------------------------------------------------------------------------------------------------------------------------------------------------------------------------------SSSSSSSSSS-SS----------------------------------------
-------XX--------------------------------------------------------------------------------------------------------------------------------------------------------------------------------------------------------------------------SS--SSS-----------E----------------------------------
X-----------------XX---------------------------------------------------------------------------------------------------------------------------------------------------------------XXX----------------------------------------XXSSSSSSSSSSSSSSSS----SSSSSSSS-----------------------SS---
------------------------------------------------------------------------------------------------------------------------------------------------------------------------------------------XXX-------------------------------------------------------------------------------------------
----------------------------------------------------------------------------------------------------------------------------------------------------------------------------------------------------------------------------------------------------------------------------------------
XXXXXX--------------------E------E----------E-------------------------------------------------E-------------------------------------------------------------E-------------------------------------XX--------------------------------E----------------------------------------------SS---
------------XXX----------<>-----<E---------<>----------E--------------------------SS-----S---<>-----E--------------------------------------------E---------<>------------X------------------------------------------------SSS------?SSSSSSS-----------------SSSS------------------------
-------------------------[]-----[]---------[]---------<>-------------------------------------[]----<>---E------X----------E---------------------<>---------[]----------E-XX-----------------------------------------E----------------------------------------------E---------XXXX-------
-------------------------[]-----[]---------[]----<----[]-------------------------------------[]----[]--<>-----XX----------E---------------------[]---------[]----<>---<>-XX----------------------------------------<>----------------X------------<---------------<>--------XXXXX-------
-------------------E--E--[]--E--[]-----E-E-[]----[----[]-------------------------------------[]----[]--[]----XXX-------E-EE--------------EE-----[]-----E---[]----[]---[]XXX---------------------------E--E----E----[]-----E-----------------------E---------------[]-------XXXXXX-------
------XX-------XXXXXXXXXXXXXXXXXXXXXXXXX--XXXXXXXXXXXXXXXX---XXXXX----XXXXXXXXXXXXXXXXXXXXXXXXXXXXXXXXXXXXXXXXXXXXXXXXXXXXXXXXXXXXX-XXXXXXXXXXXXXXXXXXXX-XXXXXXXXXXXXXXX-------X----------X----XX---XXXXXXXXXXXXXXXXXXXXXXXXXXXXXXXXXXXXXXXXXXXXXXXXXXX--XXXXXXXXXXXXXXXXXXXXXXXX----XXX
