----------------------------------------------------------------------------------------------------------------------------------------------------------------------------------------------------------------------------------------------------------------------------------------
------------------------------------------------------------------------------------------------------------------------------------------------------------------------------------------------------------------------S------S--------------------------------------------------------
----------------------------SSSSSSSSSSSSSSSSSSSSSSSSSSSS-----------------------------------------------------------------------------------------------------------------------------------------------SSSSSSSSS-SSS----SSS--SSS--------------------------------------------------------
------------------------------------S-----------------------------------------------------------------------------------------------------------------------------------------------------------------SSSSSSSSSSSSSS----SSSSSSSS--------------------------------------------------------
-----------------------------------SSS-----------------------------------------------------------------------------------------------------------------------------------------------------------------SSSSSSS----SS----SSSSSSSS--------------------------------------------------------
-XXX------------------------SSS----SS----S-----------------------------------------------------SS----------------------------------XX-XXXX----------------------------------------------------------SSSSSSSSSSS--SSS----SS----SS----------QQ--------------------------------------------
----------------------------------------------------------------------------------------------------------------------------------------------------------------------------------------------------------------------------------------------------------------------------------------
-----------------------------------------------------------------------XXX--------------------------------------------------------------------------------------------------------------------------------------------------------------------------------------------------------------
---------------------------------------------------SS-----------------XXXX--------------------------E-----------------------------------------------------------------------------------E--------------E--------------------------------------------------------------------------------
----------------------------SSSSS--SS----------XX------X-------------XXXXX---------------E---------<>----------E-------------------------------------------------------------E---------<>----------E--S?SSSSSS---------E-----XXX------Q---QQQQQQ----------E-----------------------------
-----------------------------------SS--------X-XX------X------------XXXXXX--------------<>---------[]---E--E--<>------------------------------------------------------------<>---------[]------E--<>----SSSSS---------<>---------------------------------<>-----------------------------
----------------------------------<>--------XXXXX------X----------XXXXXXXX--------------[]---------[]-----<>--[]------------------------------------------------------------[]---------[]---------[]---SSSSSS-------X-[]---------------------------------[]-----------------------------
----------------------------]-----[]-------XXXXXX-----XX----------XXXXXXXX------E-------[]---------[]-----[]--[]----------------------------------------E-------------------[]-----E---[]---------[]------------------[]E-E---XX-------------------------[]----------E------------------
---XXXXXXXXXXXXXX---XXXXXXXXXXXXXXXXXXXXXXXXXXXX--XXXXXXXXXXXXX--XXXXXX-XXXXXXXXXXXX-XXXXXXXXXXXXXXXXXXXXXXXXXXXXXXX--XXXXXX---XXXXXXX------XXXXXXXXXXXXXXXXXXXXXXXXXXXXXXXXXXXXX-XX---XXXXXXXXXXXXXXXXXXXXXXXXXXXXXXXXXXXXXXXXXXXXXXXXXXXXXXXXXXXXXXXXXXXXXXXXXXXXXXXXXXXXXXXXXXXXXXXXX
