----------------------------------------------------------------------------------------------------------------------------------------------------------------------------------------------------------------------------------------------------------------------------------------
----------------------------------------------------------------------------------------------------------------------------------------------------------------------------------------------------------------------------------------------------------------------------------------
------------------------------------------------------------------------------------SSSSSSSSSSSSSSSSSSSSSSSSSSSS--------------------------------------------------------------------------------------SSSSSSSSSSSSSSSSSSSSSSSSSS--------------------------------------------------------
------------------------------------------------------------------------------------------------------------------------------------------------------------------------------------------------------SSSSSSSS--------------------------------------------------------------------------
-------------------------------------------------------------------------------------------------------------------------------------------------------------------------------------------------------SS-SSSS--------------------------------------------------------------------------
-----------------SSS--------------------------XX-------------------------SSS--------SSSS---SS-------------------X--SSSSSSSSSS-SS-----S---SSS----------QQ----------------------------------E----X-----SSSSSSSSS---SSS------SSSSSS----------------------------------SSSSSS---------------S
----------------------------------------------------------------------------------------------------------------------------------------------------------------------------------------------------------------------------------------------------------------------------------------
------------------------------------------------------------------------------------------------------------------------------------------------------------------------------------------------------------------------------------------------XXXX------------------------------------
---XX--------------------------XX---------------------E----XXXX---------------------------------------------------------------------------------------------E------------------------------------------E-------------------SS-----------------------------------------------------------
------------X------------<>-------------SS-----------<>-------------XXX-------------SSSSS---S-----------------------SSSSS---?SS----------XX-----EQQ---QQ---<>-----------X-------------XEX------------SSSSSSSSS---------E------------------------------S-----------SSS--S----------------
-------------------------[]--------------------------[]--------------------------XX--------------------X-------X-------------------------------------------[]------E------------------EXXX-------------SSSSSS---------<>----------------------------------------------------------------
-------------------------[]--------------------------[]--------------------------XX-----------------XXXXX-----XX-------------------------------------------[]-----<>------------------X----------------SSSSSS---------[]----------------------------------------------------------------
----------------------E--[]--------------------------[]-----------------------X--X--------E---------XX-XX----XXX--------------------E-E--------------------[]-----[]--------------------------------------SS----------[]----------E--EE-E-E-E---------EE-E-E------------------E---------
XXXXXXXX-----------------XX-----XXXXXXXX---XXXXXXXXXXXXXXX-----X--------------------XXXXXXXXXXXXXXXXXXXX--XXXXXXXXXXXXXXXXXXXXXXXXXXXXXXXXX-XXXXXXXXXXXXXXXXXXXXXXXXXXXXXXXXXX---XXXX---------------XXXXXXXXXXXXXXXXXXXXXXXXXXXXXXXXXXXXXXXXXXXXXXXXXXXXXXXXXXXXXXXXXXXXXXXXXXXXXXXXXXXX
