----------------------------------------------------------------------------------------------------------------------------------------------------------------------------------------------------------------------------------------------------------------------------------------
----------------------------------------------------------------------------------------------------------------------------------------------------------------------------------------------------------------------------------------------------------------------------------------
--------------------------------------------------------SSSSSSSSSSSSSSSSSSSSSSSSSSSS----------------------------------------------------------------------------------------------------------------------------------------------------------------------------------------------------
-------------------------------------E--------------------------------------------------------------------------------------------------------------------------------------------------------------------------------------------------------------------------------------------------
-------------------------------------XXX------------------------------------------------------------------------------------------------------------------------------------------------------------------------------------------------------------------------------------------------
------------------------XXXX------------EQ?----------------------------------------------------------------S----------------------------------------------------------------------------------------------------------------SSS---------------------------------------------------------
----------------------------------------------------------------------------------------------------------------------------------------------------------------------------------------------------------------------------------------------------------------------------------------
-----------------------------------S-----------------------------------------------------------------------------------------XX----X----------------------------------------------------------------------------------------------------------------------------------------------------
--------------------------------SSSSS-----------------------------E------SSS------------------------------------------------------------------------------------------------------------------------------------------------------------------------------------------------------------
---------------------S-SS---------------E?SQ---------<>->--S-----<>-----------------X-----------------EX------------------------------SS-S-------E----------E----------E---------------X------------------------------------------------------------------------------------------------
----------------------------------E------------------[]-S--------[]---------?-X----XX-------------EXXXXXX-----------------E-----E---------------<>---------<>---------<>-------------------------------------------X-----------------------XXX------------------------------------------
-----------------------------------------------------[]-SS-------[]-----<>-EX-X---XX-------------------------------------<>---------------------[]---------[]---------[]-------------------------------------------X-----------------------XXX-------------------------XXX--------------
-------------------------------------E---------------[]-S-----E--[]--E--[]----X--XXX------------------------------E--E---[]------------E-E---E--[]-----E-E-[]---------[]-------------------------------------------X--------------------EXXXXXXE--------E--E----------XXXX-E------------
XXXXXXXXXXXXXXXXXXXXXXXXXXXXXXXXXXXXXXXXXXXXXXX--XXXXXXXXXXXXXXXXXXXXXXXXXXX--XXXXXXXXXXXX---XXXXXX----XXXXXXXXXXXXXXXXXXXXXXXXXXXXXXXXXXXXXXXXXXXXXXXXX-XXXXXX---XXXXXXXXXXXX--XXXXXX----------XXXXXXXXX--XXXXXXXXXXXXXXX---XXXXXXXXXXXXXXXXXXXXXXXXXXXXXXXXXXXXXXXXXXXXXXXXXXXXX--XXXX
