----------------------------------------------------------------------------------------------------------------------------------------------------------------------------------------------------------------------------------------------------------------------------------------
----------------------------------------------------------------------------------------------------------------------------------------------------------------------------------------------------------------------------------------------------------------------------------------
--------------------------------------------------------------------------------------------------------------------------------------------------------------------------------------------------------------------------------SSSSSSSSSSSSSSSSSSSSSSSSSSSS----------------------------
-------------------------------------------------------------------------------------------------------------------------------X--------------------------------------------------------------------------------------------------------------------------------------------------------
-------------------------------------------------------------------------------------------------------------------------------X--------------------------------------------------------------------------------------------------------------------------------------------------------
-------------S--------------------------------------------------QQQQQQQ---------SSSS-----SSSSSSSS------------------------------X-S------------------------------------------------------S----------------------------------------S-------------------------------------?SSS-------------
------------------------------------------------------------------------------------------------------------------------------XX--------------------------------------------------------------------------------------------------------------------------------------------------------
-----------------------------------------------------------------------------------------------------------------------------XXX-----------------------------------------------------------------------------------X-------------S------------------------------------------------------
--SSS------------------------------------------------------------------------------------------------------E----------------XXXX--------------------------------------------------------E-------------------------XX----------------------------------------XXXXXX--------------------XX
------------SS-----------------------------------------S-------S?-QSSSQQ-----------------SSSSSSS----------<>---------------XXXXX----------------------------X----------------E---------<>----------E--------------XXX-----------SSSS----S-S------X-XX------X--------?---SSS----------X--
--------------------------------------------------------------------------------------?-------------------[]--------------XXXXXX-----E-----<---------E-----XX---------------[]---------[]-----[]--<>-------------XXXX-----------[----------------X-XX-X----X------------------------XXXX
-----------------------------XX------------------------------------------------------SS-------------------[]--------------XXXXXX-----X-----[--------------XXX-----X---------[]---------[]-----[]--[]-----------XXXXXX--------------------------XXXXXX------X----------------------------
-----------------------------------------E---------E-----------------------E--------------------------E---[]-----E-EE---XXXXXXXX-----X-----[EE-----------XXXX------------E--[]-----E-E-[]-----[]--[]---E------XXXXXXX-----------]-----E-------XXXX-XX------X----------------------------
XXXXXXXXX---XXXXXXXXXXXXXX--XX---XXXXX--XXXX----XXXXXXXXXXXXXXXXXXXXXXXXXXXXXXXXXX--XXXXXXXXXXXXXXXXXXXXXXXXXXXXXXXXXXXXXXXXXXXXXXXXXXXXXXXXXXXXXXXXXXXXXXXXX--XXXXXXXXXXXXXXXXXX-XX---XX-XXXXXXXXXXXXXXX--XXXXXXXXXXXXXXX--XXXXXXXXXXXXXXXXXXXXXXXXX-XXXXXX----XXXX-----XXXXXXXXXXXXX--
