----------------------------------------------------------------------------------------------------------------------------------------------------------------------------------------------------------------------------------------------------------------------------------------
----------------------------------------------------------------------------------------------------------------------------------------------------------------------------------------------------------------------------------------------------------------------------------------
-------------------------------------------------------------------------------S--------------------------------------------------------------------------------------------------------------------------------------------------------------------------------------------------------
----------------------------------------------------------------------------------------------------------------------------------------------------------------------------------------------------------------------------------------------------------------------------------------
----------------------------------------------------------------------------------------------------------------------------------------------------------------------------------------------------------------------------------------------------------------------------------------
----------------------------------------------------------------------------------------------------------------------------------------------------------------------------------------------------------------SS-----------------------------E------------SS--------------------------
--------------------------------------------------------------------------------------------------------------------------------XXXX----------------------------------------------------------------------------------------------------------------------------------------------------
-------------------------------------------------------------------------------------------------XX--XXX--------------------------------------------------------------------------------------------------------------------------------------XX----------------------------------------
------------------------------------------------------------------------------------------------------------------------------------------E------------------------------------------------------------XXXX-------------------XX--------------XX------------------------------X---------
-------------------------------------------<>----------------E----------E---------------------------------S------X-----------------------QQS------Q---------E-----------------------------------------------------------S-------------------X-X-------------QQQ---------------X---------
--------------------------E----------------[]---------------<>---E-----<>---------------------E-----E------------X-----------------------------------------<>----------------------------------------X------------------------------------XXXXXX---------------------------XXXXX--------
-------------------------<>----------------[]---------------[]---------[]----<>---------------E-----------------XXXX---------------------------------------[]------------------------X----------------------------------------------------XXXXXX------------]--------------XXXXX--------
-------------------------[]----------------[]-----------EE--[]-----E-E-[]----[]-------E--E----S-----------EE-E-EXXXX---------------------------------------[]-E---------------------E---------------XXX---------------------------------XXXXXXXX--------E--E]--------------XXX----------
XXXXXXXXXXXXXXXXXXXXXXXXXXXXXXXXXXXXXXXXXXXXXXXX--XXXXXXXXXXXXXXXXXXXXXXXXXXXXXXXXXXXXXXXXXXXXXXXXXXXXXXXXXXXXXXXXXXXXXXXXX--XXXXXXXXXXXXXXXXXXXXXXXXXXXXXXXXXXXXXXXXXXXXXXXXXX-XXXXXXXXXXXXXXXXXXXX------XXXXX---XXXXXXXXXXX---XXXXXXXXXXXXXXXXXXXXXXXXXXXXXXXXXXXXXXXXX---------------
