----------------------------------------------------------------------------------------------------------------------------------------------------------------------------------------------------------------------------------------------------------------------------------------
----------------------------------------------------------------------------------------------------------------------------------------------------------------------------------------------------------------------------------------------------------------------------------------
----------------------------SSSSSSSSSSSSSSSSSSSSSSSSSSSS--------------------------------------------------------------------------------------------------------------------------------------------------------------------------------------------------------------------------------
------------------------------S----SSSS--------------------------------------------------------------------------------------------------------------------------------------------------------------------------------------------E----------------------------------------------------
-----------------------------------SSSS-------------------------------E----------------------------------------------------------------------------------------------------------------------------------------------------------XXXXXXXX------------E----------------------------------
---------------XXX-----------SSS---SSSS---------------S--------------------------------------------------------------------------------------------------------------------------------------------------------------XX---------?----------------SSSSSSS----SSS-------------------------
--------------XXXX---------------------------------------------------------------------------------------------------------------------------------------------------------------------------------------------------XX-----------------------------------------------------------------
-------------XXXXX--------------------S----------------------------------------------------------------------------------------------------------------------------------------------------------------------------XXXX-----------------------------------------------------------------
------------XXXXXX--------------E-----E-------------------------------------------------------------X------------------------------------------------------------------------------------------------S------------XXXXX-----------------------------------------------------------------
-----------XXXXXXX-------------SSSSSSSS--------------------------------------------Q---------------XX-------------------------------------E----------------------------------E----------E----------E----------X---XXXXX----------XXXX-------------XXXX-----XSQQQ------------------------
----------XXXXXXXX------------SS-----SS--------<-------X------------X-----------------------------XXXX-----------------------------------<>-----------E---------------E-----<>---------<>---------<>-------------XXXXXX----------------X---EXX---------------------E------XXX-X---------
---------XXXXXXXXX-----------SSS-----SS--------[]------X-X----------X----------------------------EXXXX-----------------------------------[]--------------------------<>-----[]---------[]----<>---[]-----------XXXXXXXX---------------XX--------------------------<>------------------X-
EE-E----XXXXXXXXXX---------X--S------SS--------[]------X--------E---XE-------E-E-----------------XXXXX-----------------------------------[]----------EE--------------[]--E--[]-----E-E-[]----[]---[]]---------XXXXXXXXX------------------------XX----XX-----------[]-------X----------X-
XXXXXXXXXXXXXXXXXXX----XX--XXXXXXXXXXXXXXXXXXXXXXXXXXXXX-----XXXXX--XXXXXXXXXXXXXXXXXXXXXXXXXXXXXXXXXXXX----XXXXXXXXXXXXX----XXXXXXXXXXXXXXXXXXXXXXXXXXXXXXXXXXXXXXXXXXXXXXXXXXXXXXX---XX---XXXXXXXXXXXXXXXXXXXXXXXXXXXXXXXXXXXXX---------------------------XXXXXXXXXXXX----------------
