----------------------------------------------------------------------------------------------------------------------------------------------------------------------------------------------------------------------------------------------------------------------------------------
----------------------------------------------------------------------------------------------------------------------------------------------------------------------------------------------------------------------------------------------------------------------------------------
----------------------------------------------------------------------------------------------------------------------------------------------------------------------------------------------------------------------------------------------------------------------------------------
---------------X------------------------------------------------------------------------------------------------------------------------------------------------------------------------------------------------------------------------------------------------------------------------
---------------X------------------------------------------------------------------------------------------------------------------------------------------------------------------------------------------------------------------------------------------------------------------------
---------------X----------------------------------------------------------S----XX--------------SS------------------------------------------------------------S---------------------------SS----------------QQQQQQQQ----------------------------------------------------SS---------------
--------------XX---------------------------------------------------------XX-----------------------------------------------------------------------------------------------------------------E-------------------------------------------------------------------------------------------
-------------XXX---------------------------------------------------------XX-------------------------------------------------------------------------------XXXX-X-----------------------XX-----------E-----------------------------------------------------------------------------------
------------XXXX----------------------------------------SS---------------XX--------------------------------------------------------------------------------------------------E---------X--------------------------------------E---------------------------------------------------------
-----------XXXXX-----------------------------------SSSSSX---------------XXX--------------QQ--E?-----E--------------------------------------------------------------------E--<>---------[-----------E------Q---QSQQQQ-Q-------<>----------------------------------E---E?-----E-----------
----------XXXXXX-----E-----<------E---------------------X-------------EXXXXX-----------------------<>------E-------------------------------------E---------------E-----<----[]----------E----E----<>-------------------------[]---------------------------------<>---------<>---E--E----
---------XXXXXXX----<>-----[----------------------------]------------XXXXXX--------------X---------[]-----[]------------------------------------<>---------<>---<>-----[----[]---------XX---<>----[]-------------------------[]---------------------------------[]---------[]-----<>----
-E-EE-E-XXXXXXXX----[]--E--[-------E-EE-----------------]-------------X-XX-------------------------[]-----[]---------------------------------E--[]-----E--E[]---[]-----[-E--[]-----E--E[]---[]----[]-------------------EE-E--[]-------------E-------------------[]---------[]-----[]----
XXXXXXXXXXXXXXXXXXXXXXXXXXXXXXXXXXXXXXXXXXXXXXXXXXXXXXXXXXXXXX--XXXXXXXX-X-----------XXXXXXXXXXXXXXXXXXXXXXXXXXX---X-------XXXXXXXXXXXXXXXXXXXXXXXXXXXXXXXXXXXXXXXXXXXXXXXXXXXXXXXXX--XXX-XXXXXXXXXXXXXXXXXXXXXXXXXXXXXXXXXXXXXX--XXXXXXXXXXXXXXXXXXXXXXXXXX-XXXXXXXXXXXXXXXXXXXXXXXXXXX
