----------------------------------------------------------------------------------------------------------------------------------------------------------------------------------------------------------------------------------------------------------------------------------------
----------------------------------------------------------------------------------------------------------------------------------------------------------------------------------------------------------------------------------------------------------------------------------------
----------------------------------------------------------------------------------------------------------------------------------------------------------------------------------------------------------------------------------------------------------------------------------------
----------------------------------------------------------------------------------------------------------------------------------------------------------------------------------------------------------------------------------------------------------------------------------------
----------------------------------------------------------------------E----------------------XXX------------------------------E---------------------------------------------------------------------------------------------------------------------------------------------------------
---------------X--------------XX----------------------------------------------------------------------------------------------------------------------QQQQ---------------------------S----------------------------------------------------S?SSS-----------------------------------------
--------------XX------------------------------------------------------------------------------------------------------------------------------------------------------------------------------------------------------------------------------------------------------------------------
--------------XX-----------------------------------------------------------------------------------------------------------------------------------S------------------------------------------------------------------------------------------------------------------------------------
------------X-XX-------------------------------------------------------------------------E----------E----------------------------------------------SS--------------------XSSS-----------------------------------------X----------XSSSSSSS-----------------E-----------------------------
-----------X--XX----------------------------------SS------------------------SS-SS--Q---------------<>-------------------------------------------------QSSSSQ---------<>------------SSSSS-----------------------------XX--------------------SSSS----------<>----------------XXXXSSS------
-----E-----XXXXX-----E-------------------------------------------------------------------]---------[]---------E------------------------------------------------------[]---------------------------------------------XXXX---------------------------------[]-----------------------------
--------------EX----<>------------------X----------------XX-----------------------------<]---E-----[]--------->------------------------------------------------------[]--------------------------------------------XXXXX---------------------------------[]-----------------------------
-E--EE----EE--EX----[]-----E--E--EE-E-E-X---------EE-E-E--------E---EE-------E-E--------[]---E-----[]---------]-------------EE-------E-E-----------------------E-----[]-------------------------------------------XXXXXX---------------------------E-----[]-----------------------------
XXXXXXXXXXXXXXXXXXXXXXXXXXXXXXXXXXXXXXXXXXXXXXXXXXXXXXXXXXXXXXXXXXXXXXXXXXXXXXXXXXXX--XXXXXXXXXXXXXXXXXXXXXXXXXX-----XXXXXX-XXXXX--XXXXXXXXXXXXXXXXXXXXXXXXXXXXXXXXXXXXX---XXXXXXXXXXXXXXXXX--------XXXXXXXXXXXXXXXXXXXXXX--XXXXXXXXXXXXXXXXXXXXXXXXXXXXXXXXXXXXX---XXXXXXXXXXXXXXXXXXXX
