----------------------------------------------------------------------------------------------------------------------------------------------------------------------------------------------------------------------------------------------------------------------------------------
----------------------------------------------------------------------------------------------------------------------------------------------------------------------------------------------------------------------------------------------------------------------------------------
---------------------------------------------------------------------------------------------------------------------------------------------------------------------------------------------------------------------------------------------------------------SSSSSS-----------S-------
XE------------------------------------------------------------------------------------------------------------------------------------------------------------------------------------------------------------------------------------------------------------SSSSSSSSSSSS------------SS
>XXXXXX--------------------------------------------------------------------------------------------------------------------------------------------------------------------------------------------------------------------------------------------------------SSSSSSSSSS-------------S-
S-----------------------------XX------------------------------------------------------------------------------XX-------------------------XXX-----------?SSS-----XXX-------XXX----------------------------------------------------------------------------------SSSSSSSSSSSSS----S-----SS
--------------------------------------------------------------------------------------------------------------------------------------------------------------------------------------------------------------------X---------------------------------------EE--------------------------
----------------------------------------------------------------------------------------------------------------------------------------------------------------------------------------------------------------------------------------------------------------------------------------
---------------------------------------------------------------------------------------------------------------------------------------------XXXXX--------------------XX----------------------------------------------------------------------------------------E------------------E----
XQQQ--------------EXXX----XX----------------------SSSSSS--------------------------------------------------SS-------------------Q-------SS---------------SS------------------------------------------------------------------S-SQ--------------------------------SSSSSSSS----------<>----
-------E-----XXXXXXXX----------------------------------------------------------E--E------E----------E----E-----------------------------------X----------------------X--S--------------------------------------------------------------------------------------E-------------------[]----
------<>----------XXX-----XX-XX---------X-------------------------------------<>-<-----------------<>--------------------------------------------------------------------------------------------------------------------------------------------------------SS--X------------<---[]----
------[]-------X---XX------X-----EEEE---X--------EEE--------------------------[]--]-----EE----E----[]-----E--------------E------------------XX----------------------------------E---E----------E-EE---------E----E---------E---------------------------------[]------E--------EE--[]----
XXX--XXXXXXX----------------XXXXXXXXXXXXXXXXXXXXXXXXXXXXXXXXXXXXX--XXXXXXXXXXXXXXXXXXXXXXXXXXXXXXXXXXXXXXXXXXXXXXXXXXXXXXXXXXXXXXXXXXXXXXXXX------XX-XX-----------------XXXXXXXXXXXXXXXXXXXXXXXXXXXX-----XXXXXXXXXXXXX--XXXXXXXX-----XXXXX--XXXXXXXXXXXXXXXXXXXXXXXXXXXXXXXXXXXXXXXXXXXX
