----------------------------------------------------------------------------------------------------------------------------------------------------------------------------------------------------------------------------------------------------------------------------------------
-------------------------------------------------------------------------------------------------------------------------------E--------------------------------------------------------------------------------------------------------------------------------------------------------
------------------------------------------------------------------------------------------------------------------------------<>----------------------------------------------------------------------SS---------------SSSSSSSSS--------------------------------------------------------
------------------------------------------------------------------------------------------------------------------------------[]--------------------------------------------------------------------------------------------------------------------------------------------------------
-------------------------------------------------------------------------------------------------------------------EE---------[]-----E------------------------------------------------------------------------S-------------------------------------------------------------------------
------------S---------------------SQQQQQQ--------------S-XX-----------------------------------------------------X--SSS??SS-------??SSS-------XXX-------------------------XXXXX-----------------------S-S--SSSSSSS-------------S--------------E---E--------------------------------SSS---
------------------------------------------------------------------------XXX-----------------------------------------------------------------------------------------------------------------------------------------------------------XXX-------X--XXXXXXX------------------------------
----------------------------------------------------------------------------------------------------------------]---------------------------------------------------------------------------------------------S-------------------------------------------------------------------------
-----E----------E----------------------------------E------------------------------------------------------------X-X-------------------------------------------------------------------------------------------S-------------------------------------------------------------------------
----<>---------<>-------------E--QQ--SSQ----------<>------------------------------Q--------------------------SQS----SSSSS---XXX----------XX-----------------------------------------------------------E--SS--SSS--------------------------------XSS-S------QQQQQ--------------XX--------
----[]---------[]------------<>-------------------[]------------------------------------------E-----------------------------------------XXXX---------------------------------------------------------<>-------S------------------EX--------------------------------E------XX--XX--------
----[]---------[]----<-------[]--X----------------[]-----X-----------------------------------<>------------------------------------------XX----------------------------------------------------------[]-------S--------<--------XXXX------------------------------<>----------XX--------
----[]---------[]----[-------[]---------------EE--[]-----------EE----------------EE--------E-[]------------E--E---------------------E-E-------E--EEEE-E-E----------E-EE---------E-E-E------------E---[]------ES--------[------------------------------------------[]-------X------------
-XXXXXXXXXXXXXXXXXXXXXXXXXXXXXXXXXXXXXXXXXXXXXXXXXXXXXXXXXXXXXXXXXXXX-XX--------XXXXXXXXXXXXXXXXXXXXXXXXXXXXXXXX------XXXXXXXX-XXXXXXXXXXXX-XXXXXXXXXXXXXXXXXXX-XXXXXXXXXXXXXXXXXXXXXXXXXXXXXXXXXXXXXXXXXXXXXXXXXXXXXXXXXXXXXXXX---------------------XXXX-XXXXXX---XXXXXX--XXXXXXX---XXX
