----------------------------------------------------------------------------------------------------------------------------------------------------------------------------------------------------------------------------------------------------------------------------------------
----------------------------------------------------------------------------------------------------------------------------------------------------------------------------------------------------------------------------------------------------------------------------------------
SSSSSSSSSSSSSSSSSSSSSSSSSSSS------------------------------------------------------------------------------------------------------------------------------------------------------------------------------------------------------------------------------------------------------------
--SS-SSSSSS-----------------------------------------------------------------------------------------------------------------------------------------------------------------------------------------------------------------------------------------------------------------------------
--SS--SSSSS------------------------------------------------------------------------------------------------------E--XXX-----------------------------------------------------------------------------------------------------------------------------------------------------------------
-SSSS-SSSSS---------------SS-----------------SSS--------SSS--------------------S--------------------------------S---------------------SSS-----------------------------XX------------------X--------------------QS----------------XX---------------------------------SSS-----------------
-----------------------------------------------------------------------------------------------------------------------------------------------------------------------------------------XX---------------------------------------------------------------------------------------------
----------S----------------------------------------------------------------------------------------------------------------------------------------------XX----X-------------------------XX---------------------------------------------------------------------------------------------
----E-----S-----------------------------------------------------------------------------------E------------E-------------------------------------------------------------S--------------XXX-------------------------E-------------------------------------------------------------------
---SSSSSSSSS-----------------XXXX-------------XX--------SSSQ?-------------XX-------------S---<>-----E-----<>----XQQQ--------------EXXX----------------------------SS----X-------------XXXXX--------------E----??---<>---------------------------------------------------SS--------------
--SSSS--SSS--------<-------X-----------------------------------E----X-----XX-----------------[]----<>-----[]-----------------XXXXXXXX------------------------------------------------XXXXXX-------------<>---------[]---E---------------------------------------------------------------
-SSSSS-S-SS--------[]------X----------------------------------<>----------XX-----------------[]----[]-----[]-----------------------XX------------------------------------------------XXXXXX-------------[]---------[]----------------------------------------------------------------XX-
--SSS--SSSS--------[]------X----------------------------------[]-------XX-XX-----------------[]----[------[]---X------------------------------E--E--E-E-----------E--E---------------XXXXXX-------------[]---------[]-EE-------------------------------------------------------------X--
XXXXXXXXXXXXXXXXXXXXXXXXXXXXXXXX-XXX---XXXXXXXXXXXXXXXXXXXXX-XXXXXXXX--XXX------XXXXXXXXXXXXXXXXXXXXXXXXXXXXXXXXXXX-----XXXXX---------------XXXXXXXXXXXXXXXXXXXXXXXXXXXXXXXXXXX--XXXXXXXXXXXXXX-XXXX-XXXXXXXXXXXXXXXXXXXXXXXXXXXXXXXXXXXXXXXXXXXXX------XXXXXXXXXXXXXX-XXXXXXXXXXXXXXXXX
