----------------------------------------------------------------------------------------------------------------------------------------------------------------------------------------------------------------------------------------------------------------------------------------
----------------------------------------------------------------------------------------------------------------------------------------------------------------------------------------------------------------------------------------------------------------------------------------
----------------------------------------------------------------------------------------------------------------------------------------------------------------------------------------------------------------------------------------------------------------------------------------
----------------------------------------------------------------------------------------------------------------------------------------------------------------------------------------------------------------------------------------------------------------------------------------
------------------------------------------------------------------------------------------------------------------------------------------------------------------------------------------------------------------------------------XX--------------------------------------------------
-------S---------SSS---------------------------------------X-------------------------------------------------------------------------------------------------XXXX--------------QQ-SS------------------------------------------------------------------SSSS------------------------------
----------------------------------------------------------------------------------------------------------------------------------------------------------------------------------------------------------------------------------------------------------------------------------------
----------------------------------------------------------------------------------------------------------------------------------------------------------------------------------------------------------------------------------------------------------------------------------------
---------------------------------E----------E--------------------------------------------E----------E------------------------------------------XXXX--------------------------------------------E----------------------------------------------------------------------------------------
SXXXX-------------XX------------<>---------<>------------------------------------------------------<>----------------------------------------------------------------X-------SS--SSQ----------<>--------------------------------XQQ---------------EXXX--------------------------------SS
-------E---EX-----X----E--------[]---------[]--------------------------------------------E---------[]---------------------E------------------------------------------XXX-<>-------------------[]---------------------------------------------XXXXXXXX-----------------------------------
------<X----------X---<>--------[]---------[]-------------------------------------------<>---------[]--------------------->----------------------------------------------[]-------------------[]---------------------------------------------------X---------XX-------------------------
------[]-------XX-X-E-[]-X------[]---------[]----------X--------E---E--------E-E--------[]---E-----[]---------E----------[]--------------EE------------------------------[]---------------E---[]-----EE-------EEE-EE------E----------------------------------------------E--------------
XXXXXXXXXXXXXX-XXXXXXXXXXXXXXXXXXXXXXXXXXXXXX--XXXXXXXXXXX---XXXXXXXXXXXXXXXXXXXXXXXXXXXXXXXXXXXXXXXXXX----XXXXXXXXXXXXXXXXXXXXXXXXXXXXXXXXXXXX----X--------XXXXXXXXXX--XXXXXXXXXXXXXXXXXXXXXXXXXXXXXXXXXXXXXXXXXXXXXXXXXXXXXXXXXXX----XXXXXX----XXXXX---XXXX----XXXXX--XXXXXXXXXXXXXXXX
