----------------------------------------------------------------------------------------------------------------------------------------------------------------------------------------------------------------------------------------------------------------------------------------
----------------------------------------------------------------------------------------------------------------------------------------------------------------------------------------------------------------------------------------------------------------------------------------
-------SSSSS---SSSSSSSSSSS--------------------------------------------------------------------------------------------------------------------------------------------------------------------------------------------------------------------------------------------------------------
----------------------------------------------------------------------------------------------------------------------------------------------------------------------------------------------------------------------------------------------------------------------------------------
----------------------------------------------------------------------------------------------------------------------------------------------------------------------------------------------------------------------------------------------------------------------------------------
----------------------------SSS-----------------------------------------------------------------------------SSSX-----------------------XX--------------?EQQ------------------------?EQQ-------------S----------------------SS------------------E-------------------------QQ-------------
----------------------------------------------------------------------------------------------------------------------------------------------------------------------------------------------------------------------------------------------E-----------------------------------------
--------------------------------------------------------------------------------------------------------------------------------------------E------S------------------------------------------------------------------------------------------XXXXXX------------------------------------
-----------------SSS-------------------------------------------------------------------------------------------------------------------------XSSSSSSS-----------------E--XSSSSSSS-----------------E-------------------------------------------------------------SSSSS-------------------
--------Q-------------------SSSQ--------------XX---------------------------------SS-------------------------------------------XXX----------------------SSSSS---------<>------------SSSSS---------<>-QQQ---------------EX-----------------------------------------------QQQQQ------------
-----------------------------------E---------XXX--------------E---E--------------------------------------------------------------------------------------------------[]--------------------------[]---------------XXXXXX-------------------XX-------------------------------------------
--------------XXXX----------------<>--------XXXX------XX---------<>--------------------------------------------------------------------------------------------------[]--------------------------[]--------------------X--------------------S--------------[----------------------------
E-----E------XX-XX----------------[]-------XXXXX-----XXX-------E-[]--------------------------------------------------------------------------------------------E-----[]--------------------E-----[]------------------------------EE-EEE-E-XEE-EE------E-EE-E----------------------------
XXXXXXXXXXXXXXXXXXXX---XXXXXXXXXXXXXXXXXXX-XX-----XXXXXXXXXXXXXXXXXXXXXXXXXXXXXXXXXXXXXXXXXXXX-XXXXXXXXXXXXX-XXXXXXXX---XXXXX---------------XXXXXXXXX---XXXXXXXXXXXXXXXX---XXXXXXXXXXXXXXXXXXXXXXXXXXXXXXX-XXXXXX---------------XXXXXXXXXXXXXXXXXXXXXXXXXXXXXXXXXXXXXXXXXXXXXXXXXXXXXXXX
