----------------------------------------------------------------------------------------------------------------------------------------------------------------------------------------------------------------------------------------------------------------------------------------
--------------------------------------------------------------------------------------------------------------------------------------------X-------------------------------------------------------------------------------------------------------------------------------------------
----------------------------------------------------------------------------------------------------------------------------------------------------------------------------------------------------SSS-SSSSSSSSSSSSSSSSSSSSSSSS--------------------------------------------------------
----------------------------------------------------------------------------------------------------------------------------------------------------------------------------------------------------------------------------------------------------------------------------------------
----------------------------------------------------------------------------------------------------------------------------------------------------------------------------------------------------------------------------------------------------------------------------------------
-------------------------------------S-----------------------------XXX-----XXXX-------------------------------------------------------------X----------SS-------------------------?SS---------------SS-------------------------------SSSQQSS--------------SS-----X---------E------------
----------------------------------------------------------------------------------------------------------------------------------------------------------------E-----------------------------------------------------------------------------------------------------------------------
-----------------------------------------------------------------------------------------------------------------------------------------------------------------------------------------------------S----------------------------------------------------------------------------------
----------------XS------------------------------------------XXX--------------------E----------------E----------------E----------E---------------------------E--------------------?------E------E----------------------------------------------------------------------------------------
----------------X-------------------------------------E--XX-----------------S----------------------<>--------------------------<>----------------E---E-----<>----------E--E--E---E??---<>-----<>----SSSQ-------------XXXX------X------SSSSQSQQ--------------------------X---------------
---------E------X----------E-----------------------E-<>--XX------------------------------E---------[]--------------------------[]---------------<>---------[]---E-----<>-<--<>---------[]---E-[]-----------E---------XXXX------X---------------------------------------XXX--------------
--------------XXXX--------<>----------------------<>-[]---------------------------------<>---------[]--------------------------[]---------------[]---------[]--<><>---[]----[]---------[]-----[]----------<>-------XXXXXX----------------------------------------------XXX--------------
EE-----------XXXXX--------[]----------------------[]-[]--XX-----------------------------[]---------[]--------------------------[]-E-------------[]-------E-[]--[][]---[]-[--[]---------[]--E--[]----]-----[]------XXXXXXX-----------------------------------------E-EX-XXX-------EE-EE-E
XXXXXXXXXXXXXXXXXXX---XXXXXXXXXXXXXX---XXX-XXXXXXXXXXXXX------------------XXXXXX----XXXXXXXXXXXXXXXXXXXX-----XXXXXXXXXXXXXXXXXXXXXXXX----XXX--XXXXXXXXXX-XXXXXXXXXXXXXXX--XXXXXXXXXXXXXXXXXXXXXXXXXXXXXXXXXXXXXXXXXXXXXXXXXXXXXXXXXXXXXXXXXXXXXXXXXXXXX--X--XXXXXXXXXXXXXXXXXXXXXXXXXXXX
