----------------------------------------------------------------------------------------------------------------------------------------------------------------------------------------------------------------------------------------------------------------------------------------
------------------------------------------------------------------------------------------------------------------------------------S------SX-------------------------------------------------------------------------------------------------------------------------------------------
--------------------------------------------------------------------------------------------------------------------SSS-------S-----SS-----S--------------------------------------------------------------------------------------------------------------------------------------------
--------------------------------------------------------------------------------------------------------------------SSSSSSSSSSSS----SS----SS--------------------------------------------------------------------------------------------------------------------------------------------
------------------------------------X--------------------------------------------------------------------------------SSSSS----SS----SS----SS--------------------------------------------------------------------------------------------------------------------------------------------
----------------XX----------X----------------SSSSSS--S------------------X------------------------------------------SSSSSSSSSSSSS----SS-----S-------------------------------------------------------------------S-----------------------------------------XXX----------------------------
----------------XX------------------------------------------------------XX--------------------------------------XE----------------------------------------------------------------------------------------------------------------------------------------------------------------------
----------------XX-----------------------------------------------------XXX--------------------------------------X----------------------------------------XX----X---------------------XX-XXXX---------------------------------------------------------------------------------X----------
----------------XX----------X-XXX-------------------------------------XXXX-------------------------------------------------------------E------------------------------------------------------------------------------------------------------------------------------------XX----------
-E------Q--XXX--XX----X-----------------XXX---------------------------XXXX------------------------------------------SSSSSSSS----------<>-X------------------------SS-------------------------SSS---------QQ---??---<>--------------------------------SSSS-----------Q-------XX----------
<>-------X--XXX-XX---XX-----------------------------XXXX-------------XXXXX--------------------E-----E---------E-----------------------[]---------E----E-----E----E----------------E-----E--------------------------[]---------------------E-----E--------------------------XXX----------
[]-------X--XXXXXX---XX---------------------------------------------XXXXXX-------------------->--------------<>-----------------------[]--------<>----E----<>---------------------E--------------------------------[]--------------------<>----<>------------------------XXXXX----------
[]-E--------XXXXXX---XX----X-----------------------------E-E-------XXXXXXX-------------------E]--------------[]--------------------EE-[]-X------[]----S----[]-----E--E-E--E-EE----S-----------E--E-E---------------[]-E-------------EE---[]----[]-----E--------E--------XXXXXX---------X
XXXXXXXXXXXXXXXXXX---XXXX--X----------------XXXXXXXXXX--XXXXXXXXXXXXXXXXXXXXXX-XXXXXXXXXXXXXXXXXXXXXXXX-XXXXXXXXXXXXXXXXXXXXXXXXXXXXXXXXXXXXXXXXXXXXXXXXXXXXXXXXXXXXXXXXXXXXXXXXXXXXXXXXXXXXXXXXXXXXXXXXXXXXXXXXXXXXXXXXX--X-XXXXXXXXXXXXXXXXXXXXXXXXXXXXXXXXXXXXXXXXXXXXXXXXXXX---XX--X
