----------------------------------------------------------------------------------------------------------------------------------------------------------------------------------------------------------------------------------------------------------------------------------------
----------------------------------------------------------------------------------------------------------------------------------------------------------------------------------------------------------------------------------------------------------------------------------------
----------------------------------------------------------------------------------------------------------------------------------------------------------------------------------------------------------------------------------------------------------------------------------------
----------------------------------------------------------------------------------------------------------------------------------------------------------------------------------------------------------------------------------------------------------------------------------------
------------------------------------------E---------------------------------------------------------------------------------------------------------------------------------------------------------------------------------------------------------------------------------------------
-----------?EQS--------------------------------------------------------------------------------------SSSS-------------------------XXXXXXXX---------------Q------------------------------------------------------------------------------------------------------------------------------
----------------------------------XX------------------------------------------------------------------------------------------------------------------------------------------------------------------------------------------------------------XXXX------------------------------------
-----------------------------------------------------------------------------------------------------------------------------------------------------------------------------------------------------------------XX---------------------------------------------------------------------
-XSSSSSSS-----------------E-------------------------------------------------------------------------------------------------------------------SSSSSSS------------------------------------------------------------------------------------------------------------E----------E-----------
-----------SSSSS---------<>-----------------XXXSSS-S---Q-------------------------SS--XXXX--------------XXX--------XXX----------------X------------------S?SS---------<>--------------XXXX-----------------------------------------------------------SSSSSSSS---------------<>-----------
-------------------------[]---------------------------------------E-----------------------------X--------------------------------------------------------------------[]--------------X------------------------E-----E--------------------------------------------E---------[]-----------
-------------------------[]--------------------------------------<>--------------------------------------------------------------------------------------------------[]------------XXX-----------------------<>-----------------XXX----------------------------------------[]-----------
-------------------------[]-------------EE-------E-E-----------E-[]---------------------------------------E----------------------------------------------------------[]------------XXX----------E--------E---[]--------------EE-XX-----EE------------E-E--------E----------[]-----------
--XXXXXXXX--XXXXXXX-XXXXXXXX-----X--XXX-XXXXXXXXXXXXXXXX--XXXXXXXXXXXXXXXXX-XXXXXXXX-------X-------XXXXXXXXXXXX----------X------XXXXXX-----XXXXXXXXXXXXXXXXXXXXXXXXXXXXXXXXXXXX--XXXXX-------X--X---XXXXXXXXXXXXXXXXXXXXXXXXXXXXX---XXXXXXXXXXXXXXXXXXXXXXXXXXXXXXXXXXXXXXXXXXXX---X-XXX
