----------------------------------------------------------------------------------------------------------------------------------------------------------------------------------------------------------------------------------------------------------------------------------------
-------------------------------------------E--------------------------------------------------------------------------------------------------------------------------------------------------------------------------------------------------------------------------------------------
------------------------------------------<>--------------------------------------------------------------------------------------------------------------------------------------------------------------------------------------------------------------------------------------------
------------------------------------------<]--------------------------------------------------------------------------------------------------------------------------------------------------------------------------------------------------------------------------------------------
--------------E---------------------------[]--------------------------------------------------------------------------------------------------------------------------------------------------------------------------------------------------------------------------------------------
----------------------------X---S??-E?SSS------S---------------------------------------SSSSSSSS---SS------SSSSSS-----------------------------------------------------------------------X-----------------------------------XXX------------------------------------SSQQSQQ---------------
--------------------------------------------------------------------------------------------------------------------------------------------------------------------------------------XX-------------------------------------------------------X----------------------------------------
----------------------------]--------------------------------------------------------------------------------------------------------------------------------------------------------XXXX-----------------------------------------------------XX------------X---------------------------
----------------------------X-X-----------------------------------------------------------------------------------------------------------------------------------------------------XXXXXE---------------------------------------------------XXX-----------------------------------E--?-
-----------------------------------S?S--?SS----------X-----------QQ---------------------SSSSS---------------------------------------------SS----------QQQ--QQ----------------------XXXXXX-------------------------XXXXX---------------------XXXX--------------E--SS--SSSQ---------<>----
----------------------------------------------------XXXX--------------------------------------------------------------------------------------------------------------E-----------XXXXXXX----E--------------------------------------------XXXXXX-------------<>-------------------[]----
-----------------------------------------------------XX-----------------------------------------------<---------XX---------------------------------------------------<>----------XXXXXXXX----X-------------------------------------------XXXXXXX-------------[]-------------------[]----
--------E---EE-------E-E------------------------XXX--XX-----------------------------------------------E---------XX---------------------------------------------------[]--E-EE---XXXXXXXXX----X------------------------------------------XXXXXXXX--------E----[]----------------E--[]----
XX---XXXXXX-XXXX----XXXXXXXX-----XXXXXX-----------------XXXXXXXXXXXXXXXXXXXXXXXXXXXXXXXXXXXXXXXXXXXXXXXXXXXXXXXXXXXXXXXXXX---XXXXXXXXXXXXXXXXXXXXXXXXXXXXXXXX-----XXXXXXXXXXX-XXXXXXXXXXXXXXXXXXXXXXXX-------XXX-------X-X----XXXXXXX--XXXXXXXXXXXXXXXXXXXXXXXXXXXXXXXXXXXXXXXXXXXXXXXXX
