----------------------------------------------------------------------------------------------------------------------------------------------------------------------------------------------------------------------------------------------------------------------------------------
----------------------------------------------------------------------------------------------------------------------------------------------------------------SS-----S----------------------------------------------------------------------------------------------------------------
----------------------------------------------------------------------------------------------------------------------------------------------SSSSSSSSSSSSSSSS--SSSS-SSS----------------------------SSSSSSSSSSSSSSSSSSSSSSSSSSSS--------------------------------------------------------
-------------------------------------------------------------------------------------------------------------------------------X--------------SSSSSSSSSSSSSS----SSSSSSSS----------------------------------------------------------------------------------------------------------------
-------------------------------------------------------------------------------------------------------------------------------X------------]-SSSSSSSSSSSSSS----SSSSSSSS----------------------------------------------------------------------------------------------------------------
-------------------------------------------------------------------------------------XXXXX-------------------------------------X-S-----------SSSSSSSSSSSSSSS----SS----SS-----SSSSSSSSS-------S--SSSS---------------------------------------------------------XXX------------------------
--------------------------------------------XXXX------------------------------------------------------------------------------XX------------ES------------------------------------------------------------------------------------------------------------------------------------------
----------------------------------------------------------------------XX-----------------------------------------------------XXXX----E----------------------------------X---------------------------------------------------------------------------------------------------------------
---------------------------------------------------------------------XXX----------------------------------------------------XXXXXE--<>----------E------------------E------------------------------------------E-------------------------------------------------------------------------
--------------------------Q--------------------------SSS-------------XXX-----------------------------------------E---------XXXXXX--------------?SSSSSSSS-------E--<>---------SSSSSSSQQ-----------------S-----<>----------------X--------------------------------------------------------
------E---E--------------->---------------------------------------XXXXXX------------------------X---------------<>---E----XXXXXXX----X-----<--E-SSSS----------<>--[]---------------------------------SES-----[]--------<>------X--------------------------------------------------------
---------<>--------------[]-XXX----------------------------------XXXXXXX------------------------X---------------[]--<>-----XXXXXX---<>-----[-SSSSSSS----------[]--[]--------------------------------SS?S-----[]--------[]------X---------------XXX--------------------------------------
---------[]--------------[]-XX------E---------------------------XXXXXXXX--------E-----E--EE-E---X---------EE-E-E[]--[]---X-XXXXXX---[]-----[---------E--------[]E-[]-----------------------EE-------S-S------[]--------[]------X--------------X-XX----------------------E------------EE-
XXXXXXXXXXXXXXXXXX----XXXXXXXXXXXXXXXXX-XXXXXXXXXXXXXXXXXXXXXXXXXXXXXXXXXXXXXXXXXXXXX-XXXXXXXXXXXXXXXX--XXXXXXXXXXXXXXXXXXXX--XXXXXXXXXXXXXXXXXXXXXXXXXXXXXXXXXXXXXXXXXXXXXXXXXXXXXXXXXXXXXXXXXXXXXXXXXXXXXXXXXXXXXXXXXXXXXXXXXXXXXXXXXXXXXXXXXXXXXXXXXXXXXX---XXXXXX--XXXXXXXXXXXXXXXXX
