----------------------------------------------------------------------------------------------------------------------------------------------------------------------------------------------------------------------------------------------------------------------------------------
----------------------------------------------------------------------------------------------------------------------------------------------------------------------------------------------------------------------------------------------------------------------------------------
---SSSSSSSSSSS----------------------------------------------------------------------SSSSSSSSSSSSSSSSSSSSSSSSSSSS----------------------------------------------------------------------------------------------------------------SSSSSSSSS------SSSSSSSSSSSSS----------------------------
----------------------------------------------------------------------------------------------------------------------------------------------------------------------------------------------------------------------------------------------------------------------------------------
-------SS-------------------------------------------------------------------------------------------------------------------------------------------------------------------------------------------------------------------------------------------------------------------------------
SSSSSSSSSS------------------------------SS------------------------------X-----------------------------------------------------------------------------------XX-----------------QQ-QQQ-------------------------QQ--------------------------------------------X----------SS---------------
-----------------------------------------------------------------------XXX---------------------------------------------------------------------------------XXX--------------------------------------------------------------------------------------------------------------------------
-----------------------------------------------------------------------XXX---------------------------------------------------------------------------------XXX--------------------------------------------------------------------------------------------------------------------------
---E-------------------E-----XXXXX--------------------E---------------XXXX--------------------E------SS--------------------------------------------------XXXXX---------------------------------E---------------------------E--------------E------SSS------------------------------------
-SSSS--SS---------XE--<>----------------SS-----------X-------------X-XXXXX-------------S-----<>----------------------------QQ-------------------------XX-XXXXX---------E--E--QQ--SSQ----------<>---------QQ---QQ----E-----<>-------------<>----------------------E---E------E-----------
----S--SSS--------<>--[]-----------------------------[X-----------X-EXXXXX-------------------[]-------------------------------------------E-----------X-EXXXXX--------<>-<>-------------------[]------>-------------------[]-------------[]---------------------<>---------<>---E------E
---S--SSS-------X-[]--[]-----------------------------X-----------X-XXXXXXX-------------------[]--------EX--------------------------------<>----------XXXXXXXXX--------[]-[]-------------------[]--------------------------[]----<>-------[]-----E--EX-X----X----[]---------[]--<><>---<>
------SSS-------X-[]--[]-----------------------E--------EE-E-------XXXXXXX----------E-----E--[]--------[---------------------------------[]-EE-E-------XXXXXXX----X---[]-[]---------------EE--[]----------------------E---[]----[]-------[]--E--------X----X----[]---------[]--[][]---[]
XXXXXXXXXXXXXXXXXXXXXXXXXXXX-XXXXXXX----XXXXXXXXXXXXXXX-XXXXXXXXXXXXXXXXXXXX---XXXXXXXXXXXXXXXXXXXXXXXXXXXXXXXXXXXXXXXXXXXXXXXXXXXXXXXXXXXXXXXXXXXXX--XXXXXXXX--XXXXX-XXXXXXXXXXXXXXXXXXXXXXXXXXXXXXXXXXXXXXXXXXXXXXXXXXXXXXXXXXXXXXXXXXXXXXXXXXXXXXXXXXXXXX--XXXXXXXXXXXXXXXXXXXXXXXXXX
