----------------------------------------------------------------------------------------------------------------------------------------------------------------------------------------------------------------------------------------------------------------------------------------
----------------------------------------------------------------------------------------------------------------------------------------------------------------------------------------------------------------------------------------------------------------------------------------
----------------------------------------------------------------------------------------------------------------------------------------------------------------------------------------------------------------------------------------------------------------------------------------
----------------------------------------------------------------------------------------------------------------------------------------------------------------------------------------------------------------------------------------------------------------------------------------
----------------------------------------------------------------------------------------------------------------------------------------------------------------------------------------------------------------------------------------------------------------------------------------
---------------------------------------------------------XXX------------------------------------------------------------------------------------------------SSS---------SSSSSSSSSS-----S------SSSSS------------S------------------------------------------------------------------------
----------------------------------------------------------------------------------------------------------------------------------------------------------------E-----------------------------------------------------------------------------------------------------------------------
-------------------------------------------X---------------------------------------------------------------------------------------------------------------------E----------------------------------------------------------------------------------------------------------------------
-----------------------E------------------XX----------------------------------------------------------------------------------------------------------------XE-------------E-----------------------------------------------E------------------------------------------------------------
-----E----------E-----<>---E-------------XXX-------------------------------------------------------------------------------------------------E---E---------XX--------------SS----------------------------QQ--E?-----E-----<>------------------------------------------------------------
----<>---------<>-----[]--<>----------XXXXXXX----------E-----------------------------X-------------------------------------------------E----<>--<>---X-----XX----X-----E-------------------------------------------<>-----[]--E---------------------------------------------E---------E-
----[]---------[]-----[]--[]----------XXXXXXX----------[-----------------------------XXX----------------------------------------------<>----[]--[]--------XXX----XX---<>---------------------------------X---------[]-----[]-----------------------------------------------<>--------->-
----[]---------[]-----[]--[]---------XXXXXXXXX------E-E[-------EE-E--------------EE--XXX------------------------------------------E---[]----[]--[]-----E-XXXX----X----[]-------------------------------------------[]-----[]------------------------------------EE----E----[]---------]-
-XXXXXXXXXXX-X-XXXXXXXXXXXXXXXXXXXX---XXXXXXXXXXXXXXX-XX---XXXXXXXXXXXXXXXX--XXXXXXXXXXXXXXXXXX----XXXXXXXXXXXXXXXXXXXXXX--XXXXXXXXXXXXXXXXXXXXXXXXXXXXX--XXX----XXXXXXXXXXX--XXXXXXXX-XXXXXXXXXXXXX-XXXXXXXXXXXXXXXXXXXXXXXXXXXXXXXXXXXXXXXXXXXXXXXXXXXXXXXXXXXXXXXXXXXXXXXXX----XXXXXX
