----------------------------------------------------------------------------------------------------------------------------------------------------------------------------------------------------------------------------------------------------------------------------------------
------------------------------------------------------------------------------------------------------------------------------------------------------------------------------------------------------------------------------------------------------------X---------------------------
----------------------------------------------------------------------------------------------------------------------------------------------------------------------------------------------------SSSSSSSSSSSSSSSSSSSSSSSSSSSS--------------------------------------------------------
-----------------------------------------------------------------------------------------------------------------------------------------------------------X----------------------------------------------------------------------------------------------------------------------------
-----------------------------------------------------------------------------------------------------------------------------------------------------------X----------------------------------------------------------------------------------------------------------------------------
-----------------------------------QQQQSS--------------S-------------------------------------------XXS----------------------------SSS----S-----------------X-S----------Q-----------------E---XXX----------------------------------SS---S----------SSSSSSSS-----------------S-----------
---------------------------------------------------------------------------------------------------XX-----------------------------------------------------XX----E-----------E---------------------------------------------------------------------------------------------------E-------
--------------X-----------------------------------------------------------------------------------XXX----------------------------------------------------XXX-X-X-E-----------------------------------------------------------------------------------------------E----------------------
-------------------------------------------------------------E----------E-----------------------XXXXXE------------XXX-----------------------------------X-XX--------------------------------------------------E------SSS----------EX-----------------------------E----------E-----------
----------------------SS-S----E--QQ--SSS--------------------<>---------<>------------E---------XXXXXX-----------------------XXX------------------------XX-X-------------X--------------EXX---------->--------<>--------------------?S--------XX-----------------<>---------<>----------E
----------E------------------<>--------------------E--------[]---------[]-----------<>---E---XXXXXXXX----X---------------------------------------E----XXXXXX-----E-----<X-------------EXXXXX-----------------[]-------------------------------------------------[]---------[]----X----<>
---------<E------------------[]-----------------------------[]---------[]-----------[]-------X-XXXXXX----X--------------------------------------------XXS--X----<>-----[X-------------X-------------S--------[]-----E--EX---------------------------------------[]---------[]---<>X---[]
--E--E-E-[]------------E-E---[]---------------EE------------[]---------[]-----------[]-EE------XXXXXX----X-----X-----------------------------E--EEE-XXXXS-EX----[]-----[X---------------------------S--------[]--E-------------------------------------------E--[]-----E-E-[]---[]----[]
XXXXXXXXXXXXXXXXXXXXXXXXXXXXXXXXXXXXXXXXXXXXXXXXXXXXXXXXXXXXXXXXXXXXXXXXXXXX---X-XXXXXXXXXXXXXXX--XXX---XXXXXXXXXXX---XXXX------XXXXXXXXXX--XXXXXXXXXXXX-XXXXXXXXXXXXXXXXXXXX----XXXX---------------XXXXXXXXXXXXXXXXXXXXXXXXXXXXXXX---XXXXXX---XXXXXXXXX-XXX-XXXXXXXXXXX--XXXXXXXXXXXXXX
