----------------------------------------------------------------------------------------------------------------------------------------------------------------------------------------------------------------------------------------------------------------------------------------
--------------------------------------------------------------------------------------------------------------------------------------------------------------------------------------------------------------------------------------------------------------------------------S-------
------------------------------------------------------------------------------------------------------------------------------------------------------------------------SSSSSSSSSSSSSSSSSSSSSSSSSSSS----------------------------------------------------------------------------SS------
-----------------------------------------------------------------E-----------------------------------------------------------------------------------------------------------------------------------------------------------------------------------------------SSSSSSSSSSS----S------S
------------------------------XXXXXXX----------------------------XXX---------------------------------------------------------------------------------------------------------------------------------------------------------------------------------------------SSSSSSSS--S-----S----SS
X---SSSSSSSSS--------------------------------SSSSSS------------------QQ---------XSXX---------------------------------------------XXX----------------------------------------------------------------------------------------------------------------------------SSSSSSSSSSSS----SS-----S
------------------------------------------------------------------------------------------------------------------------------------------------------------------------------------------------------------------------------------------------------------E---------------------------
X-----------------------------------------------------------------------------------------------------------------------------------------------------------------------------------------------------------------------------------------------------------X---------------------------
-------------------------------------------------------------SSS----------------------------------------------------XXX-------------------E---------------------------------------E------------------------------------------------------------------------------------------------E--?-
------SSSS--?SS----------X---XXXX------------XXXXX-----------------E-QQQQ------SSS-------------------------------X-----------------------<>-SQQX--------------XX-----------S-----<>-----------------------------------------S------------------------------------SSSSSSSQ---------<>----
-------------------------XX------------E-------------------------------------------------------------------------------------------------[]--------E----XXX----------------------[]--------<>------X---------------------------------------------------------->-------------------[]----
-------------------------XX--------------------------------------------------------------------------------------------------------------[]-------XX--------------------SS-------[]--------[]----------------------------------------------------------------[]--X----------------[]----
--------------------E-E--XX--------------------------------------E--------E---------------------------------------X----------------------[]----------------X------------S--------[]--------[]------X------------------------------E-------E--------------EE--[]----------------EE-[]----
XXXXXXXXXXXXXX--XXXXXXXXXXX----------------XXXXXXXXXXXXXXXXXXXXXXXXXXXXXXXXX---XXXXX---XXXXXXXXXXXXXXXXXXXXXXXXXXXX--XXX---------XXXXXXXXXXXXXXX-----XXX---XXX--XXX-XXX-XXXXXXXXXXXXXXXXXXXXXXXXXXXXXXXXXXXXX---XXXXXXXXXXXXXXXXXXXXXXXXXXXXXXXXXXXXXXXXXXXXXXXXXXXXXXXXXXXXXXXXXXXXXXXX
