----------------------------------------------------------------------------------------------------------------------------------------------------------------------------------------------------------------------------------------------------------------------------------------
----------------------------------------------------------------------------------------------------------------------------------------------------------------------------------------------------------------------------------------------------------------------------------------
------------------------------------------------------------------------------------SSSSSSSSSSSSSSSSSSSSSSSSSSSS-----------------------------------------------------------------------------------------SSSSSSS------------------------------------------------------------------------
----------------------------------------------------------------------------------------------------------------------------------------------------------------------------------------------------------------------------------------------------------------------------------------
----------------------------------------------------------------------------------------------------------------------------------------------------------------------------------------------------------------------------------------------------------------------------------------
--XX---------------------------------------------------------------------------------------------------------------------------------------------------------XX---------S-SS------------------------SSSS---SSS-------------------------------------------------XXX----------------------
------------------------------------------------------------------------------------------------------------------------------------------------------------XXX-------------------------------------------------------------------------------------------------------------------------
------------------------------------------------------------------------------------------------------------------------------------------------------------XXX-------------------------------------------------------------------------------------------------------------------------
----------------------------------------------------------------------------------------------E------SS----------------------------------------------------XXXX-----------E------------------------------------------------E------------------------------------------------------------
-----------------------------------------XXXX----------------------------XX---<>---->--S-----<>-----------------------------------------------------Q-X-----XXX---X------XXXX-----------------------SSSSS---S-------------<>-------------------------------E----------------------------
----------------------------------------XXX----------------------------XXXX---[]-------------[]---------?------------------------------------------------XX-XXX---X------------E----X---------------------------------XX--[]---------E----------E----E----<>------------X---------------
---------------------------------------XXX-----------------------------XXXX---[]----SS-------[]--------EX-----------------------------------------------XXXXXXX---X-----------XX--------X---------------------------XXXX--[]--------<>---------<>---------[]------------X---------------
--------E---E----------E-EE-----------XXXX----------E-----------------XXXXX---[]----S-----E--[]--------[]-----------------------------------E--E--------XXXXXXX---X---------------------------X-----------E---------XXX---[]--------[]---------[]---------[]--E--EE-E---X--------EE-EE-E
XXXXXXXXXXXXXXXXXX-XXXXXXXXXXXXXXX--XXXXXX----XXXX--XXXXXXXXXXXXXXXXXXXXXXXXXXXXXXXXXXXXXXXXXXXXXXXXXXXXX--XXXXXXXXXXXXXXXXXX-XXXXXXXXXXXXXXXXXXXXXX-XXXXXXXXX-XXXXXXXXXXXX--XXXXXXX----X-----------XXXXXXXXXXXXXXXXXXX--XXXXXXXXXXXXXXXXXXXXXXXXXXXXXXXXXXXXXXXXXXXXXXXXXXXXXXXXXXXXXXX
