----------------------------------------------------------------------------------------------------------------------------------------------------------------------------------------------------------------------------------------------------------------------------------------
----------------------------------------------------------------------------------------------------------------------------------------------------------------------------------------------------------------------------------------------------------------------------------------
SSSSSSSSSSSSSSSSSSSS--------------------------------------------------------------------------------------------------------------------------------------------------------------------------------------------------------------------------------------------------------------------
----------------------------------------------------------------------------------------------------------------------------------------------------------------------------------------------------------------------------------------------------------------------------------------
-----------------------------------------------------------------------X----------------------------------------------------------------------------------------------------------------------------------------------------------------------------------------------------------------
-----------------------------------------------------------------------XSSS---------------------------SSS---SS----------------------------------------QQQQQ---------------------S?---SS----SSSSSSS--------------------------------------------------------------------------------------
----------------------------------------------------------------------XXX---E-----------------------------------------------------------------------------------------------------------------------------------------------------------------------------------------------------------
----------------------------------------------------------------------XXX----E--------------------------------------------------------------E------S------------------------------------------------------------------------------------------------------------------------------------
----------E------SS----E--------------------------------------------XXXXXE--<>---------------------------------------------------------------------SS-----------------E---XXX-----------------------------------------------------------------------------------------------------------
>--------<>-----------<>---E-----------------S--SS-------E--<>-----XXXXXX----------E-XXXX----------------X------Q-----------------XX------------------QSSQQQ-Q-------<>-------------XXX----------------------------------------------------------------S-------------------<>-----------
---------[]-----------[]--->----------------------------<>--[]-----XXXXXX----X----<>------------------------------------------EXXXXX---------------------------------[]-------------------------------------------------------------------------E--------------------------[]-----------
---------[]-----<>----[]--<>XXX-------------------------[]--[]-----XXXXXX---<X----[]---------------------------------------------------------------------------------[]------------------------------------------------------------------------<>--------------------------[]-----------
E-----E--[]--E--[]----[]--[]----------------------------[]--[]-----XXXXXX---[X----[]---------------------------------------------------------------------------E-----[]-------------------------------------E---E----------E-EE-----EE---------[]-----E---------E------E---[]---------EE
XXXXXXXXXXXXXXXXXXXXXXXXXXXX-------XXXXXXXXXXXXXXXXXXXXXXXXXXXXXXXXX---XX---XXXXXXXXXXXXXXXXX-----XXXXXXXXXXXXXXXXXXX---XXXXXXXX---X-XXXXXXXXXXXXXXXXXXXXXXXXXXXXXXXXXXX-------XXXX-----XXXXX-------XXXXXXXXXX--XXXXX--XXXXXXXXXXXXXXXXXXXXXXXXXXXXXXXXXXXXXXXXXXXXXXXXXXXXXXXXX---XXXXX
