--------------------------------------------------------------------------------------------------------------------------------------------------------------------------------------------------------------------------------X-------------------------------------------------------
-------------------------------------------E----SS-----S----------------------------------------------------------------------------------------------------------------------------------------------------------------------------------------------S---------------------------------
-------------------------------SSSSSS-----<>----SS----SS-----------------------------------------------------------------------------------------------S----------------SSSS--------------------------SSSSSSSSSSSSSSS-----------SSSSSSSSSSSSSSSSSSSSSSSSSSSS----------------------------
-------------------------------SSSSSSSSSSSS]----SS---SSS---------SS-------------------------------------------------------------------------------------------------------------------------------------------------------------SSSSSSSSSSSSSSS------SSS--SS----------------------------
-------------------------------SSSSSSS--S-SS----SS--SSSS-------S-SS-------------------------------------------------------------------------------------------------------------------------------------------------------------SSSSSSSSSSSSSSS-------SS--SS----------------------------
----------------------------?--SSSSSSSSSSSSS----SSS---SS---S-SSSSSSSS--------------------------XXXX------------------------SS---------------SS----------------------------------SSS------------------SSSS-SSSSS----S------------SSSSSSSSSSS--SS-----------SS----------------------------
----------------------------XE---------------------------------------------------------------------------------------------------------------------------------------------------------------------------------------------------S-S----------------------------------------------------
----------------------------]-------------------------------------S---------------------------------------------------------------------------------------------------------------S-------------------------------------------------------S------------E--------------------------------
----------------------------X---E---------------------------------S------------E------------------------------------------E------------E------------------------------------------E-----------<>---------------------------E--------?-----S-----------<>?-------------------------------
Q-Q---------------XX------------SSSSSS---ES----------XXX--E--SSSSSSS----------<>---------------------SSSSS-----------E---E?-----E-----<>----SSS----------------XX---------E--SS--SS-----------[]-------SSS-SSSS--------E--<>----XSSSSSSSSSSS-------E?-[]---X----------------------------
--------------XXXX---------------------------------------<>-------------------[]-----XXX----------------------------<>---------<>-----[]--E------------------XXXX------X-<>------[]-----------[]-------S--------------<>--[]----SSSSSSSSSSS-------<>--[]---X----------------------------
---------------------------------X-----------------------[]--X----------------[]------XX----------------------------[]---------[]-----[]-------------------XXXXXX------X-[]------[]-----------[]-------S--------------[]--[]----SSSSSSSSSSS-------[]X-[]---X----------------------------
------------------------------------------------E-E------[]------E--------E---[]------XX----------------------------[]---E-----[]-----[]----------E-------XXXXXX-----XXX-[]------[]-----------[]----------------------[]--[]----SSSSSSSSSSS-------[]X-[]---X----------------------------
XXXXXX--XXXXX---------------XXXXXXXXXXXXXX--XXXXXXX--XX-XXXXXXXXXXXXXXXXXXXXXXXXXXXX--------XXX---XXXXXXXXXXXXXX-XXXXXXXXXXXXXXXXXXXXXXXXXXXXXXXXXXXXXXXXXXXXXXXXXXXXXXXXXXXXXXXXXXXXXXXXXXXXXXXXXXXXXXXXXXXXXXXXXXXXXXXXXXXXXXXXXXXXXXXXXXXXXXXXXXXXXXXXXXXXXXXXXXXXX---XXXXXXXXXXXXXXX
