------------------------------------------------------------------------------------X---------------------------------------------------------------------------------------------------------------------------------------------------------------------------------------------------
----------------------------------------------------------------------------------------------------------S----S------------------------------------------------------------------------------------------------------------------------------------------------------------------------
------------------------------------------------------------------------------------SSSSSSSSSSSSSSSSSSSSSSSSSSSS------------------------------------------------------------------------------------SSSSSSSSSSSSSSSSSSSSSSSSSSSS-------------------------------S-SSSSSSSSSSSSSSSSSSSSSSS
------------------------------------------------------------------------------------SSSSSSSSSSSSSSSS----SSSSSSSS--------------------------------------------------------------------------------------SSSSSSSSSSSS----------------------------------------------------------------------
------------------------------------------------------------------------------------SSSSSSSSSSSSSSSS----SSSSSSSS--------------------------------------------------------------------------------------SSSSSSSSSSSS------------S---------------------------------------------------------
------SQQQQQ---------------S-----------------SS---------------------?SS-------------SSSSSSSSSSS--SSS----SSSSSSSS------------------------XXXX-----------------------------------------------------------SSSSSSSSSSS-S----------SSX-SSSSSSSSSS----------------SSS--------------------S----
-------------------------------------------------------------------------------------S---------------------------------------------------------------------------------------------------------------E----------------------------------------------------------------------------------
--------------------------------------------------------------------------------------------------------------------------------------------------------------------------------------------------------------S-------------------------------------------------------------------------
----------------------------------------------------------SSSSSSS-----------------------E------------------??-------------------------------------------------------------------------------------------E-----S------------SS------------------------------------------------------SS---
------S---QQ----------------------------------X---------------------SSS---------------SSSSSSSSS--------E-----XXX---------------------S-SSS-----------------------------S--------------QQ---------------SSSSSSSSS----------------------SSS---?SS-------------SSSSS--------------XX-------
-----------------------E--------------------------------------------------------------SSSSSSSS--------<>----------------------------------------------------------------------------------------------E------SS--------E-------------------------------------------E---------XXXX-------
----------------------<>-------------------------------------------------------------SSSSSSSSSS-------[]---------------------------------------------------------------------------------------------SSSSS---SS-------<>------------------------------------------<>--------XXXXX-------
------------------E---[]-------------------------------------------------------------SSSSSSSSS--------[]E--------------E-EE------------------------------E---------E-------------E-------------------SS------SS-------[]------------------------------E-----------[]-------XXXXXX-------
XXXXXXXXXX-XXXXXXXXXXXXXXXXX---X-------XXXXX---XXXXXXXXX---XXXXXXXXXXXXXXXX---------XXXXXXXXXXXXXXXXXXXXXXXXXXXX---XXXXXXXXXXXXXXXXXXXXXXXXXXX--XXXXXX--XXXXXXXXXXXXXXXXXXXXXXXXXX-XXXXXXXXXXXXXXX-XXXXXXXXXXXXXXXXXXXXXXXXXXXXXXXXXXXXXXXXXX---X--------X--XXXXXXXXXXXXXXXXXXXXXXXXXXXX
