----------------------------------------------------------------------------------------------------------------------------------------------------------------------------------------------------------------------------------------------------------------------------------------
----------------------------------------------------------------------------------------------------------------------------------------------------------------------------------------------------------------------------------------------------------------------------------------
--------------------------------------------------------------------------------------------------------------------------------------------------------------------------------------------------------------------------SSSSSS----------------------------SSSSSSSSSSSSSSSSSSSSSSSSSSSS
----------------------------------------------------------------------------------------------------------------------------------------------------------------------------------------------------------------------------------------------------------------------------------------
----------------------------------------------------------------------------------------------------------------------------------------------------------------------------------------------------------------------------------------------------------------------------------------
----------------XS-----------------------S------------------------------------------------------------------------------S-S---------------------------------------------X-------QQSSSSS----------S--------------------------------------------------------------------------------------
---------------XX-----------------------------------------------------------------------------------------------------------------------------------------------------------------------------------------------------------------------------------------------------------------------
----------------X-------------------------------------------------------------------------------------------------------------------------------------------------------E---------------------------------------------------------------------------------------------------------------
----------------XE----------------------------------------------------------------------------------E---------------------E---------------------------------------------XXX-------------------------------------------------------------------------------------------E-----------------
-E-------------XX--------------------------------S--S------------------------------------>---------<>----------------SS--SS------------------------------XXXXX-----------------S?--SSSSS---------X-------E---E------E---------------------------------SSSS-----S-----<>-----------------
<>-------X--X-XXX----X-----E------------------------------------------------------E-----[]---------[]-------------E-------S------------E--------------------------------------------------------XXXX----<>---E-----<>---------------------E-------------------E------[]--------<E------X
[]----------XXXXX----XX---<>-----------------------------------------------------<>-----[]---------[]---------------------------------<>----------------------------------------------------------------[]---------[]----<>------------------------------------------[]--------<>------X
[]-EE-------XXXXX----X----[]-------E-E-------------------------------------------[]-----[]---------[]--------------------E------------[]---------------------------------------------------E--------EE--[]-----E-E-[]----[]----------E-EE-E------------E-------------[]--------[]------X
XXXXXXXXXXXX---XX---XXXXXXXX---XXXXXXXXXXXXXXXXXXXXXX-XXXXXXXXXXXXXXXXXXXXXXXXXXXXXX-XXXXXXXX--XXXXXXXXXXXXXXXXXXXXXXXXXXXXXXXXXXXXXXXXXXXXXXXXXXX----XXXXX----XXXXXXXXX---XXXXXXX--XXXXXXXXXXXXXX--XXXXXXXXXXXXXXXXXXXXXXXXXXXXXXXXXXXXXXXXXXXXXXX--XXXXXXXXXXXXXXXXXXXXXXXXXXXXXXXXXXX
