----------------------------------------------------------------------------------------------------------------------------------------------------------------------------------------------------------------------------------------------------------------------------------------
----------------------------------------------------------------------------------------------------------------------------------------------------------------------------------------------------------------------------------------------------------------------------------------
----------------------------------------------------------------------------------------------------------------------------------------------------------------------------------------------------------------------------------------------------------------------------------------
----------------------------------------------------------------------------------------------------------------------------------------------------------------------------------------------------------------------------------------------------------------------------------------
----------------------------------------------------------------------------------------------------------------------------------------------------------------------------------------------------------------------------------------------E-----------------------------------------
-------------S-----X--X-------------------------------------------------------------SSSS---SS--------------SS----XXS----------------------------------------------------------SQQQQQQ------------------------------X--------------------------------------------SSSSSSSSS--------S---SSS
------------------------------------------------------------------------------------------------------------------------------------------------------------------------------------------------------------------E-------------------XX------------------------------------------------
-----------------------------------------------------------------------------------------------------------------------------------------------------------------------------------------------------------------XXXXXXX----------------------------------------------------------------
---XXXX-------------------XX------------------------------------------------------------------------------------------------------------------------------------------------------------------------------------------------------------------------------------------------------------
------------XX----------------------------------------------------------------------SSSSS----------------------------------------------------------------------------QQ-------SS?SQSSSQ----------<>---------------------------------------------XX---------Q------SSS---Q---------------
------------------------XEXS----------E-----E---------E-----------------------------------------------X------------------------X-------E---------------------------------------------------------[]------E---------------E-----<--------------------------------------------------------
-------------------------------------<>--------------<>---------------------------------------------XXXX------------------------X-----<>---------------------------------------------------------[]-----<>--------------<>-----[XXXX----------------------------------------------------
-------------------------------------[]--------------[]--------------------------------------------XX-X-------------------------------[]------------------------------E--------------------EE-E--[]--EE-[]----EE--EE----[]---E-[-------------E-------E-E------------------------E-------
------XXXX--------X---------XXXXXXXXXXXXXXXXXXXXXXXXXXXXXXXXXXXXXXXX---X--------XX--XXXX--XXXXXXXXXXXX----------XXXXXXXXX--XXX-XX-----XX-XXXXXXXXXXXXX---XXXXXXXXXXXXXXXXXXXXXXXXX-XXXXXXXXXXXXXXXXXXXXXXXXXXXXXXXXXXXXXXXXXXXXX-----XX-XX--XXXXXXXXXXXXXXXXXXXXXXXXXXXXXXXXXXXXXXXXXXX-
