----------------------------------------------------------------------------------------------------------------------------------------------------------------------------------------------------------------------------------------------------------------------------------------
----------------------------------------------------------------------------------------------------------------------------------------------------------------------------------------------------------------------------------------------------------------------------------------
----------------------------------------------------------------------------------------------------------------SSS----------------SSSSSSSSS----------------------------SSSSSSSSSSSSSSSSSSSSSSSSSSSS------------------------------------------------------------------------------------
----------------------------------------------------------------------------------------------------------------------------------------------------------------------------------------------------------------------------------------------------------------------------------------
----------------------------------------------------------------------------------------------XX----------------------------------------------------------------------------------------------------------------------------------------------------------------------------------------
SSSS---SS-----------------------------------------------------------------X--------------------------------------------------------------------------------------------------------------------------------------QQ-------X-XXXX--------------------------------------------------------
-------------------------------------------XXX----------------------------X-------------------------------------------------------------------------------------------------------------------------------------------------------------------------------------------------------------
------------------------------------------XXXX---------------------------XX--------------------------------------------------------------------------------------------------------------S----------------------------------------------------------------------------------------------
-----------------------------------------XXXXX-----------S---------------XX--------------S--------------------------------E-------SS-------------E----------E---------------------------XSSS----------SSSSSSS---------------------------------------------------------------XX----------
SSSSS--------------X---------------------XXXX-----------X--------------XXXX-----------------------QQ-----------------S---<>-----E---------------<>---------<>-----------<>------SQS------X----X----------------SSSSS--------------------------------------------------------X-----------
-------E----------XX------------------XXXXXXXX------------------------EXXXX-----------------------------------E----------[]----<>---------------[]---------[]----X------[]---------------]----X-----------------------------------------------------------------------------XX----------
----------------XXXX-----------------XXXXXXXXX-----------------------EXXXXX----------------------------------<>-<--------[]----[]--<><>---------[]---------[]---<>------[]----------XXXX[]----X---------------------------------------------------------------------------XXXX----------
---------------XXXXX-----------------XXXXXXXXX------E-----------------XXXXX------------------E---------------[]-E--------[]--E-[]--[][]------E--[]-----E-E-[]---[]-----X[]----E-----XXX-[X----X-------------------------------------------EEE-EE------------EE-E---------XXXXX----------
XXXXXXXXXXXXXXXXXXXXXXXXXXXXXXXXX---XXXXXXXXXXXXXX-XXXXXXXXXXXX---XXXXX--XXXXXXXXXXXXXXXXXXXXXXXXXXXXXXXXXXXXXXXXXXXXXXXXXXXXXXXX--XXXXXXXXXXXXXXXXXXXXX--XXXXXXXXXXXXXXXXXXXXXXXXXXXXXXXX----XXXXXX---XXXXXX---XXXXXXXXX-------XXXX--XXXXXXXXXXXXXX----XXXXXXXXXXXXXXXXXXXXX-----------
