----------------------------------------------------------------------------------------------------------------------------------------------------------------------------------------------------------------------------------------------------------------------------------------
----------------------------------------------------------------------------------------------------------------------------------------------------------------------------------------------------------------------------------------------------------------------------------------
-------SSSSS----------------SSSSSSSSSSSSSSSSSSSSSSSSSSSS--------------------------------------------------------------------------------------------------------------------------------------------------------------------------------------------------------------------------------
----------------------------------------------------------------------------------------------------------------------------------------------------------------------------------------------------------------------------------------------------------------------------------------
----------------------------------------------------------------------E---------------------------E-----------------------------------------------------------------------------------------------------XX--------------------------XX--------------------------------------------------
-------------------------------------------------------------------------E--------------------------------------------SSSSSS-------------------SSSSSSS-----S--------------------------------------------------------------SSS---------------------SS--------X-------E?--------SS--------
--------------------------------------------------------------XXX------------XXXXX--------X-----------------------------------------------------------------------------------XX--------------------------------------------------------------------------------------------------------
----------------------------------------------------------------------------------------------------------------------------------------------------------------------------------------------------------------------------------------------------------------------------------------
-----------------XX------------------------------------------------------------------------------------------------------------------------------------------------E----------------------------------------------------------------------------------------X-XXX-----------------------
--------Q-S------X-----------S------Q-S------X-------------------------XXXXSSS-----Q---------------XXX----------------SSS---Q------------------SS--SS-------------<>--------------------XSSSSS------XQQQ--------------XXXX------XXXXX-------------XXXX----XX------------XXX----------X--
----------------XX---------------------------X-X---------------------------------------------------------------------------------------E----------------------X---[]---------------------------------------------XXXXX-XX--------------E---EXXXX---X---------------------------------XX-
--------------XXXXXX-----------------------XXX-X--------XXXX--------------------------------------------------------------------------<>----------------------<---[]----XXXX------------------------------XX-----------X--------------XX-----------X---------------------------------XX-
------E------XXXXXXX--------E-----E-------XXXX-X---------------------E-------E-E-----------------E------------------------------------[]-X--------------------[---[]-----------------------------------------------X---------------------------X---X----------------------------XXX--XX-
XXXXXXXXXXXXXXXXXXXXX-XXXXXXXXXXXXXXXXXXXXXXXXXXX-XXXXXX------------XXXX--XXXXXXXXXX-----X--XXX-XXX----XXXXXXXXXXXXXXXXXXXXXXXXXXXXXXXXXXXXXXXXXXXXXXXXXXXXXXXXXXXXXXXXX--------XX--XXXXXXXXXXXXXXXXXXXXXXX---XXXXXXXXXXXXXXXXXXXXX--XXX--XXX--XXXXXXXXXXXXXXXX---XX-----------------X--
