----------------------------------------------------------------------------------------------------------------------------------------------------------------------------------------------------------------------------------------------------------------------------------------
----------------------------------------------------------------------------------------------------------------------------------------------------------------------------------------------------------------------------------------------------------------------------------------
----------------------------------------------------------------------------------------------------------------------------------------------SSSSSSSSSSSSS-----SSSSSSSS----------------------------------------------------------------------------------------------------------------
----------------------------------------------------------------------------------------------------------------------------------------------SS-SSSSSSSSS------------------------------------------------------------------------------------------------------------------------------
-----------------------------------------------------------------------------------------------------------------------------------------------S-SSSSSSSSS------------S-----------------------------------------------------------------------------------------------------------------
------------------------------XXXX---------E---------------------------------------------------------------------S-----------------------------SSSSSSSSSS--S----------SS--S--------------------SSS----------------------------------------------------------X---------------------------
---------------------------------------------------------------------------X-----------------------------------------------------------------E------------------------------------------------------------------------------------------------------------------E-----------------------
------------------------------------------------------------------------------------------------------------------------------------------------------S---------------------------------------------------------------------------------------------------------------------------------
-----E----------E-----------------------------------------------------------------XE------------------------------------------------------------E-----S--------------------------------------------------E----------E-------------------------------------------------------------------
---------------<>-----------------------X----------------XX------------------------S-------------XXX------------SSSQ--------------XX----------E-SSSSSSSS------------------------------------------------<>---------<>----------E------------XX--------------X-------------XXXXXX--------
-----E---------[]-----------------------X----------------XX-------------------------------------XXXX-------------------E---------XXX----------E---------------------------------------------------------[]---------[]---------<>-----------XXX------------------------------------------
----<>---E-----[]-----------------------X---------------XXXX-----------------------------------XXXXX------------------<>--------XXXX-------X-SS--X------------<>----------------------------------------[]---------[]---------[]----------XXXX------------------------------------------
----[]---E-----[]----------------EE-E---X--------EEE-E-EXXXX----------------------------------XXXXXX--------E---------[]-------XXXXX-----XXX-[]------E--------[]----------------------------------------[]---------[]---------[]--------EXXXXX-E------E-EE-E----------------------------
XXXXXXXXXXXXXXXXXXXX--XXXXXXX-XX-XXXXXXXXXXXXXXXXXXXXXXXXXXXXXXXX-----XXXXXXXXXXXXXXXXXXXXX--XXXXXXXXXXXXXXXXXXXXXXXXXXXXXXXXXXXXXXXXXXXXXXXXXXXXXXXXXXXXXXXXXXXXXXXXXXXXXXXXXXXXXXXX--XXXXXX---------XXXXXXXXXXXXXXXXXXXXXXXXXXXXXXXXXXXXXXXXXXXXXXXXXXXXXX-----------X------------XXX-
