----------------------------------------------------------------------------------------------------------------------------------------------------------------------------------------------------------------------------------------------------------------------------------------
----------------------------------------------------------------------------------------------------------------------------------------------------------------------------------------------------------------------------------------------------------------------------------------
----------------------------------------------------------------------------------------------------------------------------------------------------------------------------------------------------------------------------------------------------------------------------------------
----------------------------------------------------------------------------------------------------------------------------------------------------------------------------------------------------------------------------------------------------------------------------------------
-----------------------------------------------------------------------------------------------------------------------------------------------------XXX--------------------------------------------------------------------------------------------------------------------------------
X-----------SSS----------S--S---------------------SSS--------------------------------------QQQQQQ-----------SSSS-------SQQSS-------------------------------------------------------------XX-------------------------S-------------------------------------------------------------------
----------------------------------------------------------------------------------------------------------------------------------------------------------------------------------------XXX---------------------------------------------------------------------------------------------
---------------------------------------------------------------------------------------------------------------------------------------------------------------------------------------XXXX---------------------------------------------------------------------------------------------
XXXXX---------------------------------------------------------------------------------------------------------------------------------------------------------------------------------XXXXX---------------------------------------------------------------------------------------------
-------S?---SSS-------------QQQQ--------------XXX---------------------XXX----------------QQ---QQQ--?------------------SSS--SSSS----------<>----------------Q----------E-----------X--XXXXXX-------------------------X----------E-----E----------E----------------------------------S----
------------------------XXXX-------E------XXXXXXX--------------------XX--------------<>--------------------------------------------------[]-----------E--------------<>-----------X-EXXXXXX------------------------XX---------<>----<>---------<>---------------------------------------
----------------------------------<>--------XXXXX--------------------XX--------------[]--------------------------------------------------[]----------<>--------------[]-----------XXXXXXXXX------------------------XX---------[]----[]---------[]----<------------------X---------------
----------------------------]-----[]-------XXXXXX------------------X------------E-EE-[]---------------EE---------------------------EE-E--[]----------[]--------------[]-----------XXXXXXXXX----------E--E------E-XXXX---------[]EE--[]-----E-E-[]----[------------E-E---X--------EEE-E--
----XXXXXXX----XXXXXXXXXX---XXXXXXXXXXXXXXXXXXXX----XXXXXXXXXXX---XXXXX---XXXXXXXXXXXXXXXXXXXXXXXXXXXXXXXXXX-XXXXXXXXXXXX---XXXXXXXXXXXXXXXXXXXXXXXXXXXXXXXXXXXXXXXXXXXXXXXXXX--XXXXXXXXXXXXXX-XXXXXXXXXXXXXXXXX-XXXXXXXXXXXXXXXXXXXXXXXXXXXXXXXX--XXXXXXXXXXXXXXXXXXXXXXXXXXXXXXXXXXXXX
