----------------------------------------------------------------------------------------------------------------------------------------------------------------------------------------------------------------------------------------------------------------------------------------
----------------------------------------------------------------------------------------------------------------------------------------------------------------------------------------------------------------------------------------------------------------------------------------
--------------------------------------------------------SSSSSSSSSSSSSSSSSSSSSSSSSSSS----------------------------------------------------------SSSSSSSSSSSSSSSSSSSSSSSSSS----------------------------------------------------------------------------------------------------------------
--------------------------------------------------------SSSSSSSSSSSS--------------SS----------------------------------------------------------------------------------------------------------------------------------------------------------------------------------------------------
--------------------------------------------------------SSSSSSSSSS?---------------SS--------------------------------------XX------------------------------------------------------------------------------------------------------------------------------------------------------------
-----------------------------SS--------------------S-----SSSS--SSS---S------------S----------------------------------------------------------------------------------------------------XSS----------S-SSSS-S-----------------------------------XXS--------------------------------------
--------------------------------------------------------------------------------------------------------------------------------------------------------------------------------------XXX-----------------------------------------------------XXX---------------------------------------
--------------------------------------------------------------------------------------------------------------------------------------------------------------------------------------XXX----------------------------------------------------XXXX----E----------------------------------
-------------------------------------------------------------------------------S?---------------------------------------------------------------------------------------------------XXXXXE------------E-------------------------------------XXXXXE--------------------------------------
--------------XXX-----------SSSQ------------------------SSSSS-SSSSS--------E?------X------------X-------------------------------------S--------S----SQ-----------------------------X-XXXX-----------SXSXS--------------X------XX-E---------XXXXXX------------------------XXX------------
-----------------------------------E---------XXX--------SSSSSSSSSSS-------<>X------X-----------XXX------------------------E-----E------------------------------E------------------XXXXXXX----X-------------E---EX---------------<>---E---XXXXXXXX----X------------------XXX-------------
----------------------------------<>--------XXXX--------SSSSSSSSSSS-----<>[]X------X-----------XXX-----------------------<>---------------------------------<>-X-------------------XXXXXX----X------------<>--------X-X---------[]-------XXXXXXXX----X-----[-----------XXXX-------------
----------------------------------[]-------XXXXX--------SSSSSSSSSSS-----[][]X----XXX------E-EX-XX---------E-EE-E-----E---[]-----------------------E---------[--X---------E-EE------XXXXXX----X-----X------[]-------XX-X-X-E-----[]-EE----X-XXXXXX----X-----X----------XXXXX---------E---
XXXXXX----XXXXX--XXXXXXXXXXXXXXXXXXXXXXXXXXXXXXXXXX-XXXXXXXXXXXXXXXXXXXXXXXXXXXXXXXXXXXXXXXXXXXXXXXXXXXXXXXXXXXXXXXXXXXXXXXXXXXXXXXXXXXXXXXXXXXXXXXXXXXXXXXXXXXXXXXXXXXXXXXXXXXXXXXXXXXXXXXX---XXXXXXXX---XXXXXXX--XXXX---X-XXX-XXXXXXXXXXXXXXXXXXX-XXXXXXXXXXXXXX--XXXXXXXX-XXXXXXXXXXX
