----------------------------------------------------------------------------------------------------------------------------------------------------------------------------------------------------------------------------------------------------------------------------------------
----------------------------------------------------------------------------------------------------------------------------------------------------------------------------------------------------------------------------------------------------------------------------------------
SSSSSSSSSSSSSSSSSSSSSSSSSSSS--------------------------------------------------------------------------------------SSSSSSSSSSSSSSSSSSSSSSSSSSSSSSSSSSSSSSSSSSSSSSSSSSSSSS-------------------------------SSSSSSSSSSSSS----SSSSSSSS--------------------------------------------------------
---------------------------------------------------------------------------------------------------------------------------------------------------------------------------E-----------------------S--SSSSSSS-------------SSS-----------------------------------------------------------
-------------------------------------------------------------------------------------------------------------------------------------------------------------------------XXXXXXX-------------E--------SSSSSSSS-----------SSSS-----------------------------------------------------------
---------------------------------------------------XXX---------------------------------------------------------X-SSS---SS-----------------------------------------------?----------------??SSS------SSSSSSSSSS---SSS------SSS----------QQQQQQ---------------X---SSSSSSSSS---------------
----------------------------------------------------------------------------------------------------------------------------------------------------------------------------------------------------------------------------------------------------------------------------------------
---------------------------------------------------------------------------------------------------------------------------------------------------------------------------E--------------------------------------------------------------------------------X---------------------------
----------E--------------------------------------------------------------SSS-----------------------------------------------------------------------------------------------X--------------------------EE-----------------------------------------------E---------------------------E--?-
>S-S----S<>---------E------XX-------------XXXXX-----------------Q-----------------------------------------SS-------SS---SSS--------------------S----SQQ------------------XXXX---------E----XXX---XXX-SSSSSSSS----------E----------E--QQ--SQQQ---------<>----------SSSS-SQQ--------<>--]-
---S-----S]--------<>------X--------------XXXX---------------------------X----X---------------E-----E------------------------------E-----------------------------------X-------X---EXX-----------XXX----SSSSS---------<>---------<>-------------------[]--------------------------[]-[]-
---S-----[]-----<>-[]-----XX------------------------------------------XXXX--------------------E------------------------------------X------------------------<>-XX-----XX-----XXX-----------------XX----SSSSS--------X-X]---------[]-------------------[]--------------------------[]-[--
E-----E--[]-----[]-[]----XXX----------------------------E-----E------XX-[X------------E--E----S-----------------------E--S---------[--------E-----E---------[]-------XXX----------------X---X-X-----------S---------X-[]---------[]----------------E--[]-----------------------EE-[]-[]-
XXXXXXXXXXXXXXXXXXXXXXXXXXXXXXXXXX---XXXXXX----XXX--XXXXXXXXXXXXXXXXXXXXXXXX--XXXXXXXXXXXXXXXXXXXXXXXXXXXXXXXXXXXXXXXXXXXXXXXXXXXXXXXXXXXXXXXXXXXXXXXXXXXXXXXXXX--XXXXXX---------------XXXXXXXXXXXX-XXXX-XXXXXXXXX-XXXXXXXX--XXXXXXXXXXXXXXXXXXXXXXXXXXXXXXXXXXXXXXXX--XXXXXXXXXXXXXXXXX
