----------------------------------------------------------------------------------------------------------------------------------------------------------------------------------------------------------------------------------------------------------------------------------------
----------------------------------------------------------------------------------------------------------------------------------------------------------------------------------------------------X-----------------------------------------------------------------------------------
----------------------------------------------------------------------------------------------------------------------------------------------------------------------------------------------------------------------------------------------------------------------------------------
-----------------------------------------------------------------------X----------------------------------------------------------------------------------------------------------------------------------------------------------------------------------------------------------------
----XX-----------------------------------------------------------------X-----------------------------------------------------------------------EE----------------E----------------------------------------------------------------------------------------------------------------------
----------------------SXXX---------------------------------------------X-S----------------------------XXX----S---------------------------------SS--------------SSSSSSSS---------------------------XX------------------------------------------------------------------------------------
---------------------------------------------<>-----------------------XX-----------------------------------------------------------------------------------------------------------------------------------------------------------------------X----------------------------------------
-------------------------------------------XXX------------------------XX----------------------------------------------------------------------------------------------------------------------------------------------------------------------XX----------------------------------------
-----------------------------------------XXXXX----------------------X-XX---------------XX-----------------------------------------------------EX--------------------------------------------------------------E------------E-----------------XXX----------------------------------------
XQQ---------------EXXX-------------------XXXXX---------------------XX-X--------------------------X-------------------------------------------XXXX--------EE----XXX---------------------------------------E---<>-----E-----<>---E-------------XXX------------X---------------XXXX--------
-------------XXXXXXXX-----------------XXXXXXXX--------------------XXXXXX-----E-------------------------------------------------XXX-----------------E---EXX----------------------------------------------<>---[]----<>-----[]--<>----------XXXXXX--------------------------XX------------
-------------------------------------XXXXXXXXX--------------------XXXXXX----<>-----[-------------------------------------------XXX----------------XX--------X-------------------------------------------[]---[]----[]-----[]--[]---------XXXXXXX----------------------------------------
-------------------------------------XXXXXXXXX------E--E-E--EE--XXXXX-XX----[]-----E-------------------------------------------XXXX-------------------------X-------------------------------------------[]---[]----[]-----[]--[]--------XXXXXXXX--------E-------------------------------
XX-------XXXX------XXX---XXXXXXXXX---XXXXXX--XXXXXXXX-X-XXXXXXXXXXXXXXXXXXXXXXXXXXXXXXX----XXX------------------XXXXX--XXXXXXXXXXXXXXX--XXXXX------XXXX----XXXXXXXX--XXXXXXXXXXXXXXXXXXXXXXXXXXXXXXX-XXXXXXXXXXXXXXXXXXXXXXXXXXXXXXXX-XXXXXXXXXXXXXXXXXXXXXXXX-------XXX----------------
