----------------------------------------------------------------------------------------------------------------------------------------------------------------------------------------------------------------------------------------------------------------------------------------
----------------------------------------------------------------------------------------------------------------------------------------------------------------------------------------------------------------------------------------------------------------------------------------
------------------------------------------------------------------------------------SSSSSSSSSSSSSSSSSSSSSSSSSSSS------------------------------------------------------------------------------------------------------------------------------------------------------------------------
------------------------------------------------------------------------------------SSSSSSSSSSSSSSS------SS---SS------------------------------------------------------------------------------------------------------------------------------------------------------------------------
------------------------------------------------------------------------------------SSSSSSSSSSSSSSS-----SSSS--SS------------------------------------------------------------------------------------------------------------------------------------------------------------------------
----------------------S-SSS------------------------XXX----XXXX-----------------------SSSSSSSSSS--SSS--------------XX----------------------XX------------------------------XX-------------------------------------------------------S-------------------SSSS-----------------------------
----------------------------------------------------------------------------------------------------------------------------------------------------------------------------------------------------------------------------------------------------------------------------------------
-----------------------------------------------------------------------------------------------------------E---------------------------------------------XXXXXXX------------------------XXXX-----------------------XXXXX----------------------------------------------------------------
---X------------------------------------------------------------------------------------E-----------------<>----------------------------------------------------------------------------------------------------------------------------------------------------------------------------
------------XX----------------------------XXXXX---------------------X----------------SSSSSSSSSS--------E--[]-------------------------SSSS-------------------------S-------------------------------------------------------------S?SSS-----------------------------S---------------------
--------------------------------------------------------------------X----------------SSSSSSSSSS-------<>--[]-------------------------------------E----------E----E-------------------------------------------------------E------------------------X--------------------------------E----
--------------------------------------------------------------------X----------------SSSSSSSSSS-------[]--[]------------------------------------------E----<>----------[--------------------------------------------------------------------------X-------------------------------<>----
--------------------------------------------------------------E-E---X--------EE-EE-E-SSSSSSSSSS-------[]--[]------------E---E--------EEE------E-EE----S----[]--------EE[--E-----E-EEE------------E-E--E-EEE-E-EEE-EE------E-EE-E------------------X---------------------------E---[]----
XXXXXXXXXXXXXXXXXXXXXXXXXXXXXX-XX---XXXXXXX--XXXXX----XXXXXXXXXXXXXXXXXXXXXXXXXXXXXXXXXXXXXXXXXXXXXXXXXXXXXXXXXX-----XXXXXXXXXXXXXXXXXXXXXXXXXXXXXXXXXXXXXXXXXXXXXXXXXXXXXXXXXXXXXXXXXXXXXXXXXXXXXXXXXXXXXXXXXXXXXXXXXXXXXXXXXXXXXXXXXXXXXXXXXXXXXXXXXXXXXXXXXXXXXXXXXXXXXXXXXXXXXXXXXXX
