----------------------------------------------------------------------------------------------------------------------------------------------------------------------------------------------------------------------------------------------------------------------------------------
----------------------------------------------------------------------------------------------------------------------------------------------------------------------------------------------------------------------------------------------------------------------------------------
--------------------------------------------------------------------------------------------------------------------------------------------SSSSSSSSSSSSSSSSSSSSSSSSSSSS----------------------------------------------------------------------------------------------------------------
----------------------------------------------------------------------------------------------------------------------------------------------------------------------------------------------------------------------------------------------------------------------------------------
------------------------------------------------------------------------------------------------------------------------------------------------------------------------------------------------------XXXXXX----------------------------------E---------------------------E-------------
-----------------------XXX------------------------SSS------S------------------------------------------------------------------------------------------------------------------------------------XXXX-----------------SSSSSSSSS----------------------------------------------------------
----------------------------------------------------------------------------------------------------------------------------------------------------------------------------------------------------------------------------------------------------------------------------------------
----------------------------------------------------------------------------------------------------------------------------------------------------------------------------------------------------------------------------------------------------------------------------------------
------------------------------------------------------------------------------------------------------------------------------------------------------E---------------------------------------------------------------------------------------------------------------------------------
---------------XXXXSSS------XQQQ--------------EXXX------------------------------------------------QQ----------E--------------XXXX--------------S----S<S--------------------------------------S-SS----XXXX---------X---XXXX-------------------------SSSSSSS-Q----------------------------
-----------------------------------------XXXXXXXX------------------------------------------------------------<>------------XXXX----------------S-----S---------<>------------------------------------------E---EXX------------------------------------------------------X---------------
-----------------------------------------------X--------------------------X----------------------------------[]-----------XXXXX----------------S-----[]-----<>-[]------------------------------------------X--------------------------------------------------X---------X---------------
--------------------------------------------------------------------------X------------------E---------------[]----------XXXXXX---------E---E-----E--S------[]-[]--------------------------------------------------X--------------------E---EE-------E-E------------E---XE-------E-E----
XXX-----XX--XXXXXXXXXXXXXXXXXXX-XX--XXXXX-------------XXXXXXXXXXXXXXXXXXXXXXXXXXXXXXXXXXXXXXXXXXXXXXXXX--XXXXXXXXXXXXX---XXXXX-----X-X--X---XXXXXXXXXXXXXXXXXXXXXXXXXXXXXXXXXXXXXXXXXXXXXXXXXXXXXXXX---------------XXXXXXXXXXXXX-----XXXXXX-XXXXXXXXXXXXXXXXXXXXXXXXXXXXXXXXXXXXXXXXXXXX
