----------------------------------------------------------------------------------------------------------------------------------------------------------------------------------------------------------------------------------------------------------------------------------------
----------------------------------------------------------------------------------------------------------------------------------------------------------------------------------------------------------------------------------------------------------------------------------------
----------------------------------------------------------------------------------------------------------------------------------------------------------------------------------------------------------------------------------------------------------------------------------------
----------------------------------------------------------------------------------------------------------------------------------------------------------------------------------------------------------------------------------------------------------------------------------------
----------------------------------------------------------------------E---------------------------E---------------------------------------------------------------------------------------------------XXXXXXX---------------------------------------------------------------------------
----------------------------------------------------------------------------------------------------------------------SSQQSQ----------------------------?S-----------------------------------------------------------SSSS-------X---S---S?---------S------------------------------------
-----------------------------------------------------------------------------------------XXXX-------------XXXX--------------------------------------------------------------------------------------------------------------------------------------------------------------------------
----------------------------------------------------------------------------------------------------------------------------------------------------------------------------------------------------------------------------------------------------------------------------------------
---------------------------------------------------------------------------------------------------------------------------------------E-----XSSS---------------------E-----------------E-----------------------------------------XX-----------------------------------------X----------
---------------Q-----------------------------------------------------------------------------------XXXXSSS-----Q------SS--QSQ---------<>--E-------------S------------<>----------------<>------------XXXX--------------XXX-----X------------XXX----------XX-----------------XXX---------
----------E---------------E-----------------------------------------X-----------------------------------------------------------------[]-<>--X-----------------------[]------E---------[]------------------E---EXX------------XX-------------------------XX----------------XXXX---------
---------<>--------------<>-----------------------------------------X---------------XXX-----------------------------------------------[]-[---------------------------[]-----<>---------[]-----------------XX---------------------------------------------XX---------------XXXXX-------XX
---------[]--------------[]--------E--------------------------------XE-------E-E-E---------------E-------E----------------------------[]-[--XX-----------------------[]-----[]-----E---[]--------------------------X-----XX-------------------------E-E--XX---------------XXXXX-------XX
XXXXXXXXXXXXXXXXXXXXXXXXXXXXXXXXXXXXXXXX-XXXXXXXXXXXXXXXXXXXXXX-XX--XXXXXXXXXXXXXXXX--------XXX-XXXXXXXXXXXXXXXXXXXXXXXXX--XXXXXXXX-XXXXXXXX---XXXXX-----XXXXXXXXXXXXXXXXXXXXXXXXXXXXXXXXXXX---X-XXXXXX-------------------------XXXXXXXXXXXXX---XXXXXXXXXXXXXXXXXXXX-XXXXXXXXXXXXXXXXXXX
