----------------------------------------------------------------------------------------------------------------------------------------------------------------------------------------------------------------------------------------------------------------------------------------
----------------------------------------------------------------------------------------------------------------------------------------------------------------------------------------------------------------------------------------------------------------------------------------
----------------------------------------------------------------------------------------------------------------------------------------------------------------------------------------------------------------------------------------------------------------------------------------
----------------------------------------------------------------------------------------------------------------------------------------------------------------------------------------------------------------------------------------------------------------------------------------
-------------------------------------------------------------------------------------------------------------------------XXX-----------------------------------------------------------------------------------------------------------------------------------------XXX----------------
----------Q----------------------------------------------------------------------------------------------------------------------------------XXX---------------------------------------------SSSSS-------------------E------------------------------------------------------------------
-------------------------------------------------------------------------X------------------------E-----------------------------------------------------------------------------------------------------------------XXXXXXXXX-----------------------------------------------------------
-----------------------------------------XX-XXXX------------------------XX-----------------------XXXXXXX--------------------------------------------------------------------------------------------------------------------------------------------------------------------------------
-----------------------------------------------------------------------XXX-------------------------------------------S----------E--------------------------------------------------------------------------------------------------------------X----------------------------------------
----E-Q---QQQ--QQ---------------------------------SS------------------XXXX-------------------------------XS----------------E---QQ------------------------------------S--SXXXX-------------XXXX----XX---------------------------Q--------------XX---------------------------Q----------E-
---------------------------------------------------------------------XXXXX--------------------------E----E--------------------------------E------------------------------------E---EX----XXXX-----------------------------------------------XXXX-------------------------------------<>-
--------------------------------------------------------------------XXXXXXX-----------------------------<>-----[-------------------------<>-------------X---------------------<>----------XX--------XXXX-----------------------------------XXXXX-------------------------------------[]-
------------------------------E-EEE-E-E-E-EE------E-EE-E----------XXXXXXXXX----------EE-EE----E----E----[]---E-[---------E---------------[]-------E-E---E--------E-E-EE-------[]-------XXXXXX--------------------------------------------XXXXXXX--------E--E---------E---------------[]-
XXXXXXXXXXXXXXXXXXXXXXXXXXXXXXXXXXXXXXXXXXXXXXXXXXXXXXXXXXXXX---XXXXXXXX-XXXXX-XXXXXXXXXXXXXXXXXXXXXXXXXXXXXXXXXXXXXXXXXXXXXXXXXXXX-XXXXXXXXXXXXXXXXXXXXXXXXXXXXXXXXXXXXXXXXXXXXXXXXXXXXXXXXXXXXXXXX-------XXXX--XXX-----XXXX-XXXXXXXXXXXXXXXXXXXXXXXXXXXXXXXXXXXXXXXXXXXXXXXXX-XXXXXXXX
