----------------------------------------------------------------------------------------------------------------------------------------------------------------------------------------------------------------------------------------------------------------------------------------
----------------------------------------------------------------------------------------------------------------------------------------------------------------------------------------------------------------------------------------------------------------------------------------
SSSSSSSSSSSSSSSSSSSSSS-SS-------------------------------------------------------------------------------------------------------------------------------------------------------------------------------------------------------SSS-S-----SS-SSSSSSSSSSSSSSS----------------------------
----------------------------------------------------------------------------------------------------------------------------------------------------------------------------------------------------------------------------------------------------------------------------------------
------------------------------------------------------------------------------------------------------------------------------------------------------------------------------------------------------------------E-------------------------------------------------------E-------------
----------------X-----------X---SSSSSQSSSS-------------S-----------SS--------------------------------XX---------------------------------------XX----------------------------------------------------------------------------------------------------------------------------------------
----------------X------------------------------------------------------------------------------------XX-----------------------------------------------------------------------------------------------------------------------------------------------------------XX---------------X----
-----------------S----------------------------------------------------------------------------------XXX---------------------------------------------------------------------------------------------------------------------------------------------------------------------------------
----------------XSSS----------------------------------------------------E------------S-------------XXXX-----------------------------------------------------------------------------------------------------------------------------------E---------------------------------------------
<>----------X---X-----X-----------SS?S-SSSS----------X-------E---------<>-------------------------XXXXX----------------------------------S------------------------------------------------------------------------------SS---SSS---------<>---------------------------------XXXSSS-----Q
[]-------E--X---X----XX----E-------------------------XX-----<>---------[]---E------E-------------XXXXXX-------------------E--------------------------------------------------E----------E------------------------------------------------[]---------------------------------------------
[]----------XXXXXX---XX---<>-------------------------X------[]---------[]---------XX-------------XXXXXX-------------------E-------------------------------------------------<>---------<>------------XXX---------------------------------[]--------EX-------XXX-------------------------
[]--E-------XXXXX]---XX---[]-------------------EE-E---------[]---------[]---------XX----------XXXXXXXXX--------------E-EEEE------------E-EE--------------------------EE-----[]---------[]---------EE--------E----E-------E-E-------------[]---------]------X------------EE-------E-E----
XXXXXXXXXXXX--XXXX---XXXXXXXXXXXXXXXXXXXXXXXXXXXXXX--X--XXXXXXXXXXXXXXXXXXXX--XXXXXXXXXXXXXXXXXXXXXXXX----------XXXXXXXXXXXXXXXXXXX-XXXXXXXXXXXXXXXXXXXXXXXXXXXXXXXXXXXXXXXXXXXXXXXXXXXXXXXXXXXXXXXXXXX-XXXXXX--XXXXXXXXXXXXXXXXXXXXXXXXXXXXXXXXXXXXXXXXXXXX-----X--XXX-XXXXXXXXXXXXXXXX
