X---------------------------------------------------------------------------------------------------------------------------------------------------------------------------------------------------------------------------------------------------------------------------------------
---------------------------S------------------------------------------------------------------------------------------------------------------------------------------------------------------------------------------------------------------------------------------------------------
SSSSSSSSSSSSSSSSSSSSSSSSSSSS------------------------------------------------------------------------------------------------------------------------------------------------------------------------------------------------------------------------------------------------------------
SSSSSSSSSSSSSSSS----SSSS-SSS------------------------------------------------------------------------------------------------------------------------------------------------------------------------------------------------------------------------------------------------------------
S-SSSSSSSSSSSSSS----SSSSSSSS------------------------------------------------------------------------------------------------------------------------------------------------------------------------------------------------------------------E-----------------------------------------
---SSSSSSSSSSSSS----S-----SSX---S?--QQSSSSS------------------------------------------------Q--QQQ------------------------------------------------------?SSS---------------------------------------------------------------------E--E--E------E---E------------------Q-QSS--------------S
EE-S-----------------------------------------------------------------------------------------------------------------------------------------------------------------------------------------------------------------------------XXXXXXXX------------XXXXX------------------------------
----------S------------E----E-----------------------------------------------------------------------------------------------------------------------------------------------------------------------------------------------------------------------------------------------------------
----E-----S-----------<>----XXX-----------------------------------------------------------------------------------------------XX-------------XSSSSSSS-----------------E-----------------------------------------------------------------------------------------------------------------
---SSSSSSSSS-------E--[]-----------S?S-SSSSS---------<>--------------------------SSS----E-Q---QQQQ-?QQ----------------------XXXX------------------------SS-----------<>--------------XXX-------------------------XXXXX----------X------------XXXXXXSSS-----Q--E--QQ--SS?----E-----------
--E--S----S-------<>--[]-----------------------------[]-------------------------------------------------------------------XXXXXX-------------X-----------------------[]-------------XXXX---------------------------------------------------------------------<>------------<>------E----
-SSSSSS--SS-------[]--[]-----------------------------[]------------------------------------------------------X-----------XXXXXXX-------------------------------------[]-----------XXXXX--------------------------X--------------XXXX-------------------------[]--X---------[]-----<>----
-S]------ES-------[]--[]-----------------------EE-E--[]--------EE--------------E-----------------------E-----[]---------XXXXXXXX--------E--EXX-----------------------[]----------XXXXXXX--------E--------------X-X----------E----------------E-------E-E-----[]------------[]-EE--[]----
XXXXXXXXXXXXXXXXXXXXXXXXXXXX--XXXXXXXXX-XXXXXXXXXXXXXXX-XXXXXXXXXXXXXXXXXXXXXXXXXXXXXXXXXXXXXXXXXXXXXXXXXXXXXXXXXXXXXXXXXXXXXXXXXXXXXXXXXXXX---XXXXXXXX--XXXXXXXXXXXXXXXXXXXXX---XXXXXX--XXXXXXXXXXXXXXXXXX---XXXX-----XXXXXXXXX------------XXX---XXXXXXXXXXXXXXXXXXXXXXXXXXXXXXXXXXXXXX
