----------------------------------------------------------------------------------------------------------------------------------------------------------------------------------------------------------------------------------------------------------------------------------------
----------------------------------------------------------------------------------------------------------------------------------------------------------------------------------------------------------------------------------------------------------------------------------------
SSSSSSSSSSSSSSSSSSSSSSSSSSSSSSSSSSSSSSSSSSSSSSSSSS-S-----S--SSSSSSSSSS------------------------------------------------------------------------------------------------------------------------------------------------------------------------------------------------------------------
----------------------------------------------------------------------------------------------------------------------------------------------------------------------------------------------------------------------------------------------------------------------------------------
----------------------------------------------------------------------------------------------------------------------------------------------------------------------------------------------------------------------------------------------------------------------------------------
-----------------------------------------------------------------------------------------------------------------SSS---SSS--------------------------------------------------------------X------------------------Q------------------X---------------------------------------------------
-------------------------------------------------------------------------X--------------------------------------------------------------------------------------------------------------X-----------------------------------------------------E-----------------------------XX----------
-------------------------------------------------------------------------XX-------------------------------------------------------------------------------------------------------------XX---------------------------------------------------XXXXXXX-----------------------XXX----------
----------E---------------------------E------------E--------------------XXX------------------------------------------------------------E-----------------------------------------------XXX--------------SSSSS-------------------------------------------------------------XXXX----------
---S----SSS---------E------X---S-S---<>-----------<>------------Q-S-----XXX---X-----------------------------------SSS-----------------<>------------------XXX--------------------------XXX---------------------QQQQQ----------------------------------S-------------------XXXX---------E
--SSS---SSS--------<>------X--E------[]-----------[]--------------------XXX---X---------------------------------------------------X---[]-----------------XXXXX-----------------------XXXXX-----------------------------------------------------------E-------------------XXXXX--------<>
S--S-----SS--------[]------X-S?------[]-----------[]-----------------XXXXXX---X---XX-XXX------------------------------------------X---[]---------------XXXXXXX----------------------XXXXXX-----------------------------------------------------------------[-----------XXXXXXX--------[]
S-SSS-ES-SS--------[]----XXX--S------[]-----------[]----E--E--------XXXXXXX---X---XX----------------------------------------------X---[]--------------XXXXXXXX------E--EEE-E-------XXXXXXX---------------------------------------EE-EEE-E-EEE-EE------E-EE-E---E------XXXXXXXX--------[]
XXXXXXXXXXXXXXXXXXXXXXXXXXXXXXXXXXXXXXXXXXXXXXXXXXXXXXXXXXXXXXXX-XXXXXXXXX---XXXXXXXXXXXXXXXXXXXX--------XX-XXXXXXXXXXXXXXXXXXXXXXXXXXXXXXXXXXXXXXX---XXXXX---XXXXXXX--XXXXXXXXXXXXXXXXXXXXXXX-XXXXXXXXXXXXXX--XXXXXXXXXXXXXXX-XXXXXXXXXXXXXXXXXXXXXXXXXXXXXXXXXXXXX--XXXXXXX--XXXXXX-XX
