----------------------------------------------------------------------------------------------------------------------------------------------------------------------------------------------------------------------------------------------------------------------------------------
--------------------------------------------------------------------------------------------------------------------------------------------------------------------------------------------------------------------------------X-------------------------------------------------------
-----------------------------------------------------------------------------------------------------------------------------------SSSSSSSS---------------------------------------------------------------------------------------------------------------------------------------------
----------------------------------------------------------------------------------------------------------------------------------------------------------------------------------------------------------------------------------------------------------------------------------------
----------------------------------------------------------------------------------------------------------------------------------------------------------------------------------------------------------------------------------------------------------------------------------------
-SSS---SSSS-----------------SSSSSS-SS--------------------------------------------XXX-----------------S--------------------------------------------------------------X--------------------------X-------------------------------------------------S-----------XXX------------------------
----------------------------------------------------------------------------------------------------------------------------------------------------------------------------------------------------------------------------------------------------E-----------------------------------
---------------------------------------------------------------------------------------------------XE------------------------------------------------------------------------------------------------------------------------------------------XX----E----------------------------------
-----------------------------------------------------------------------------------------E---------X----------------------E----------------------------------------------------------------------------------------------------------E---------X----------------------------------------
---S---SSSS-----------------SSSSS--------------X------------------------------SSSS------<>---------------------------S---<>--------------------------------X-------------------------XXXXX-------------------------------------S----<>---------------------E----------------------------
-----------------------------------E----------X-------------------E---------------------[]----------E----E-------->------[]---------E----------------------XXX-----------------------X----------------------------------------------[]----------E----E----<>----------------------------
------------------<>--------------------------X------------------<>---------------------[]---------<>---<>-----[---------[]--------<>------X--------------XXXX-----------------------X----------------------------------------------[]---------<>---<>----[]----------------------------
------------------[---------------------------X------------------[]------------------E--[]-----E---[]---[]-----[---------[]--------[]----XXX--------------XXXX---------------------X-X----------------------E--------------------E--[]-----E---[]---[]----[]--------E-------------------
XXXXXXXXXXXXXXXXXXX---XX-XXXXXXXXXXXXXXXXXXXXXXXXXXXXXXXX-XXXXXXXXXXXXXXXXXX---XXXXXXXXXXXXXXXXXXXXXXXXX-XXXXXXXXXXXXXXXXXXXXXXXXXXXXXXXXXXXXXXXX--XXXXXXXXXXXXXXX---XXXXXXXXX---XXXXX-------X-----------XXXXXXXXXXXXX---XXXXXXXXXXXXXXXXXXX-XXXXXXXXXXXXXXX---XXXXXXXXXXXXXXXX-XXXXXXXX
