----------------------------------------------------------------------------------------------------------------------------------------------------------------------------------------------------------------------------------------------------------------------------------------
-----------------------------------------------------------------------E----SS-----S----------------------S----S------------------------------------------------------------------------------------------------------------------------------------------------------------------------
-----------------------------------------------------------SSSSSSSSS--<>----SS----SSSSSSSSSSSSSSSSSSSSSSSSSSSSSS------------------------------------------------------------------------------------------------------------------------------------------------------------------------
----------------------------------------------------------SSSSSSSSSSSSSS----SS---SSSSSSSSSSSSSSSSSSS----SSSSSSSS------------------------------------------------------------------------------------------------------------------------------------------------------------------------
--------------------------------------------------------]--SSSSSSSS-SSSS----SS--SSSSSSSSSSSSSSSSSSSS----SSSSSSSS------------------------------------------------------------------------------------------------------------------------------------------------------------------------
----------------------------------------------E----X----?-SSSSSSSSSSSSSS----SS----SS-SSSSSSSSSSS-SSS----S-----SS---------------------------------------------------------XXX-----------------------------------------------------------------------------------------------------------X
----------------------------------------------X----------E--------------------------ES-S------------------------------------------------------------------------------------------------------------------------------------------------------------------------------------------------
-------------------X--------------------------X-----------------------------------------------S-----------------------------------------------------------------------------------------------------------------------------------------------------------------------------------------
---------------------------------------------XX-------------E---------------------------E-----S------------?----------------------------------------------------------------------------------------------------------------------------------------------------------------------------
---------------------------EX--------------E-XX------------?SSSSSS---------E-----XX----SSSSSSSSS-------E--<>-----------------XXXX---------------------------------SS-----------------------------S--------------------------------------------XXX---------------------------------SSSS--
-----E----------E---------<>X-------------EXXXXX----------E-SSSS----------->---E-----SSSSSSSSSS-------<>--[]-----------------X------------------------E-----E---------------------------------------------------------------------------------------------------------E-----------------
----<>---------<>----------]X------------XXXXX-------------SSSS-----------[]--<>-----SSSSSSSSSS-------[]--[]----------------XX-----------------------<>----<>----------------------------------------XX--------------------------------------------------------------<>-----------------
----[]----E----[]---------[[----------------------------------------------[]E-[]-XX--SSSSSSSSSS-------[]--[]---------------XXX----------E-------EE---[]----[]-------------E--E-EE-E------------E-EE--------------E---------E-EE----------------------------------E-E-[]-----------------
XXXXXXXXXXXXXXXXXXXXXXXXXXXXXXXXXX---XXXXXX--XXXXXXXXXXXXXXXXXXXXXXXXXXXXXXXXXXXXXXXXXXXXXXXXXXXXXXXXXXXXXXXXXXXXXXXXX---XXXXX----XXXXXXXXXXXXXXXXXXXXXXXXXXXXXX--XXXXXXXXXXXXXXXXXXXXXXXXX-XXXXXXXXX----XXXXX--XXXX----XXXXXXXXXXXXX---XXXXX---------------XXXXXXXXXXXXXXXXXXXXXXXXXXXX
