----------------------------------------------------------------------------------------------------------------------------------------------------------------------------------------------------------------------------------------------------------------------------------------
----------------------------------------------------------------------------------------------------------------------------------------------------------------------------------------------------------------------------------------------------------------------------------------
--------------------------------------------------------------------------------------------------------------------------------------------------------------------------------------------------------------------------------S-SSSSSSSSSSSSSSSS--SS----------------------------------
----------------------------------------------------------------------------------------------------------------------------------------------------------------------------------------------------------------------------------SSSSSSSSSSSSSS----S------S----------------------------
--------------------------------------------------------------------------------------------------------------------------------------------------------------------------------------------------------------------------------]-SSSSSSSSSSSSSS----SS----S----------XXX----------------
---------------X--------------------------------------------------------------------------SSQQSSS-------------------------------------SSSS----------SQSS----------------------------------------X---X---SSSSQQSSSSS------SS--S-SSSSSSSSSSSS--SSS----S-----------------------------------
--------------EX------------------------------------------------------------------------------------------------------------------------------------------------------------------------------------------------------------------------------------------------------------------------
--------------XXXXXX--------------------------------------------------------------------------------------------------------------------------------------------------------------------------------X-----------------------------------------------------------------------------------
------------X-------------------------------E--------------------------------------------------------------E----------------------------------S-----------------------------------------------------X------------------------------E-------------------E--?-----------------------------
---------------------------------E---------<>----------E------------------------------E--SS--SSS----------<>----SSSXS-------------XX---------------S?--SSSSS---------<>---------------XXXX----------------SS?S-S?SS----------X---SSSSSSSSS---------E--<>------------------QQ---------QQ-
-----E-----X---------E-----<----<>---------[]---------<>-----------------------------<>-------------------[]-----------E----------XX---------------------------------[]-----------------------------------------------------XXXX--SSSSSSSS--------<>--[]--------------E-----------------
--------------------<>-----[----[]---------[]----<>---[]-----------------------------[]-------------------[]----------<>--------XXXX---------------------------------[]-----------------------------------------------------------SSSSSSSS------X-[]--[]-------------<>-----------------
-EE-EEE-E-EE--EE----[]-----[-E--[]-----E-E-[]----[]---[]-------------------------EE--[]---------------EE--[]----------[]-------XXXXX---------------------------E-----[]------------------------------------------------EE-E--------SSSSSSS--------[]--[]-------------[]---------------E-
XXXXXXXXXXXXXXXXXXXXXXXXXXXXXXXXXXXXXXXX---XXXXXXXXXXXXXXXXXXXXXXXXXXXXXXXXXXXXXXXXXXXXXXXXXXXXXXXXXXXXXXXXXXXXXXXXXXXXXXXXXXXXXXXXXXXXXXXXXXXXXXXXXXXXXXXXXXXXXXXXXXXXXXXXXX-----XXXXX----XXXX-XXXXXXXXXXXXXXXXXXXXXXXXXXX-----XXXXXXXXXXXXXXXXXXX-XXXXXXXX--XXXXXXXXXXXXXXXXXX--XXXXXX
