----------------------------------------------------------------------------------------------------------------------------------------------------------------------------------------------------------------------------------------------------------------------------------------
----------------------------------------------------------------------------------------------------------------------------------------------------------------------------------------------------X-----------------------------------------------------------------------------------
----------------------------------------------------------------------------------------------------------------------------------------------------------------------------------------------------------------------------------------------------------------------------------------
----------------------------------------------------------------------------------------------------------------------------------------SS----------------------------------------------------------------------------------------------------------------------------------------------
-------------------------------------------------------------------------------------------------------------------------------------E--SSS--------------------------------------------------------------------------------------------------------------------------XXX----------------
----------SSSSS----------------------------------------------------------------XXXXX----------------------------S--------------------------------------------SS---------------------------------------------------------------------------QQ--------------------------------------------
-----------------------------------------------------------------------------------------------------------------------------------------------------------X----E-----------------------------------------------------------------------------------------------------------------------
----------------------------------------------------------------------------------------------------------------------------------------------------------XXX----E----------------------------------------------------------------------------------------------------------------------
-XXXXX-------------------------------------------------------------------------------------------------------------------------------------------E---------X---------------------------------------------E----------E----------------------------------E--------------------------------
------------SSS----------X----------------------------E-------------------------------------------------------E-SXXXX-------------XX------XX----<>---------X----------------------------------SSSSSS----<>---------<>-----------------Q---QQQ--?------<>------------------QQ------------
------------------------XXX--------------------------<>------------------------------------------------------<>--------E---EXX----XX------------[]---------------E-----<------E---E---------------------[]---------[]----X----------------------------[]--E-----------E-----------------
-----------------------------------------------------[]------------------------------------------------------[]-------<>----------XX------------[]---------XX---<>-----[---------<>---------------------[]---------[]----<>---------------------------[]-<-----------<>-----------------
-----------------------------------E-EE--------------[]------------------------------------------------------[]-------[]-------XX-X----------E--[]-----E--EXX---[]-----[-------E-[]-----------------EE--[]-----E-E-[]----[]---------------------------[]-[-----------[]--------------EE-
----XXXXX----XXXXXXXXXXXXX--XXXXXXXXXXXXXXXXXX---XXXXXXX---X----XXXXXXXXXXXXXX---XXX----XXXX------XXXXXXXXXXXXXXXXX--XXXXXXX----------------XXXXXXXXXXXX--XXX-XXXXXXXXXXXXXXXXXXXXXXXXXXXXXXXXXXXXXXXXXXXXXXXXXX-XXXX---XXXXXXXXXXXXXXXXXX-XXXXXXXXXXXXXXXXXXXXXXXXXXXXXXXXXXXXXXXXXXXXX
