----------------------------------------------------------------------------------------------------------------------------------------------------------------------------------------------------------------------------------------------------------------------------------------
----------------------------------------------------------------------------------------------------------------------------------------------------------------------------------------------------------------------------------------------------------------------------------------
----------------------------------------------------------------------------------------------------------------------------------------------------------------------------------------------------------------------------------------------------------------------------------------
----------------------------------------------------------------------------------------------------------------------------------------------------------------------------------------------------------------------------------------------------------------------------------------
----------------------------------------------------------------------------------------------------------------------------------------------------------------------------------------------------------------------------------XXXXXX------------------------------------------------
------------------X-------------------------------------------------------------------------------------------------------------------------------------------XSSSS--------------------X----------------------------------SSSXX------------------SSSS-----------------------XXX---------
-----------------XX---------------------------------------------------------------------------------X----------------------------------------------------------------------------------X-----------------------------------------------------------------------------------XXXX---------
---------------XXXX-------------------------------------------------------------------------------------------------------------------------------------------------------------------XX----------------------------------------------------------------------------------XXXXX---------
--------------XXXXX-------------------------------------------------------------------------------------------------------------------------X-XXXX-----------------------------------XXX---------------------------------------------------------------------------------XXXXXX---------
-------------XXXXXX------------------------------------------------------X---------------------------------SSSSS----------------------SSSSSS------------XXX-------------------------XXXX----------------------------------------XXXXX-------------XXXX----XX----------XX-XXXXX----X-----
-------------XXXXXX---------------------XX------------------------------XXXX----------------------------------------------------------------------------------------XXXX----------XXXXXX-----------<---------------XXX-----------------E---EXXX-----------------------XXXXXXXX----X-----
----------XXXXXXXXX--------------------XXX-----------------------------XXXXX---------X-------------------------------------------------------------------------------------------XXXXXXX-----------[---------------XXXX---------------XX-------------------->--------XXXXXXXXX----X-----
----------XXXXXXXXX-----E------------XXXXX----------E-EE--------------XXXXXX----------------E------------E-E-----------EEEE------------E----------------------------------------XXXXXXXX--------E--[---------------XXXX------------------------X------X-----EE-E-----XXXXXXXXX----------
XXXXXXX---XXXXX--XXXXXXXXXXXXXXXXXXX--XXXX-X-XXXXXXXXXXXXXXXXXXXXXXXXXXXXXXXXXXXXXXX-----XXXXXXXXXXXXXXXXXXXXXXXXXXXXXXXXXXXXXXXXXXXXXXXXXXX------XXX-------XXXXXXXX----XXXXXXXX-XXXXXXX-XXXXXXXX-XXXXXXX--XXXXXXXXXXXXXXX---XXXX--------------XXXXXXXXXXXXXXXXXXXXXXXXXXXXXXXX---------
