----------------------------------------------------------------------------------------------------------------------------------------------------------------------------------------------------------------------------------------------------------------------------------------
----------------------------------------------------------------------------------------------------------------------------------------------------------------------------------------------------------------------------------------------------------------------------------------
---------------------------------------------------------------------------------------------------------------------------<------------------------------------------------------------------------------------------------------------------------------------------------------------
-------------------------------------------------------------------------------------------------------------------------------------------------------------------------------------------------------------E--------------------------------------------------------------------------
-------------------------------------------------------------------------------------------------------------------------------------------------------------------------------------------------------------XXX------------------------------------------------------------------------
-----------------------------------QQQQSS--------------S------------------------------------QQQQQQQ----------SSS-----------XXX----XXX------------------------------------XXX--------------------XXXX-------------QQ-------------SSSS---SS------------------------------------SSSS-------
---------------XXX----------------------------------------------------------------------------------------------------------------------------------------------------------------------------------------------------------------------------------------------------------------------
--------------XXXX----------------------------------------------------------------------------------------------------------------------------------------------------------------------------------------------------------------------------------------------------------------------
-------------XXXXX--------------------------------------------------------------------------------------------------XXX-------------------XX----------------E-------------------------------------------SSSSS---------------------------------------------------------------------------
------------XXXXX-------------E--QQ--SSS---------------------------------------------------S?-QSSSSS-------------X-------------------------------QQ--------<>----------------------------------------------------QQQ---------XE-S?SQS-------------XX--------XXXXX-------------XXXX------
----------XXXXXXXX-----------<>------------------------------------------------------------------------------X---X-----------------------------------------[]---------------------------------------------E------------------<>--------E----------X----E-----------------XXX------------
---------XXXXXXXXX-----------[]--X----------------------------------X--------------------------------------------------------------------------------------[]------------------------------------------------E>--------------[]-------------------X---<>-----------X--------------------
--------XXXXXXXXXX------E--E-[]---------------EE--------------------EX-------E-EE----------------------E---------XX----------------------------------------[]------------------------------------------------[---------------[]----------------X--X---[]-X-----------------X------------
XXXXXXX-XXXXXXXXXXXXXXXXXXXXXXXXXXXXXXXXXXXXXXXXXXXXXXXXX--XXXXXXXXXXXXXXXXXXXXXXXXXXXXXXXXXXXXXXXXXXXXXXXXXXX------------------------------XXXXXXXXXXXXXXXXXXXXX--X-XXXXXXXX--XXXXXXXXXXXXXXXXXXXXXXXXXXXXXXXXXXXXXXXXXXXXXXXXXXXXXXXXXXXXXXXXXXXXXXXXXXXXXXXXXXXXXXXXXX--XXXXXXXXXXXXX
