----------------------------------------------------------------------------------------------------------------------------------------------------------------------------------------------------------------------------------------------------------------------------------------
----------------------------------------------------------------------------------------------------------------------------------------------------------------------------------------------------------------------------------------------------------------------------------------
---SSSSSS-----------SSSSSSSS----------------------------SSSSSSSSSSSSSSSSSSSSSSSSSSSS----------------------------------------------------------------------------------------------------------------------------------------------------------------------------------------------------
---S-SSSS-----------------SS------------------------------------------------------------------------------------------------------------------------------------------------------------------------------------------------------------------------------------------------------------
---S---SSS----------------SS------------------------------------------------------------------------------------------------------------------------------------------------------------------------------------------------------------------------------------------------------------
SSSSSSSSSSS---SS----------SS---------------------------------------------------------------SQQSQ------------------------------------------------------------------------------------------------------------------------------------------------------------E-----E----------E----------
---------------------------------------------------------------------------------------------------------------------------------------------------------------------------------------------------------------------------------------------------------------XXXXXX------------XXXXX--
----------------------------------------------------------------------------------------------------------------------------------------------------------XXXX-X------------------------------------------------------------------------------------------------------------------------
---E----------------------------SSSSS---------------------------------------------------------------------------------------------------------------------------------------------------------------------------------------------------------------------------------------------------
--SSSSSSSS---------E------X------------QQQQQ----------E-SSSS----SQS------X-XX------X------SS---SQQ------------E-------------------------SSSS----------------------S-----------------------------S-SS-------------------------------------------------------E--------------XXXXX---------
----S-------------<>---------------------------------<>-[----------------X-XX-X----X-----------------------E-<>----------------------------------E----------E----E----------------------------------------------------------------------------------------<>----------------------------
---S-X------------[]---------------------------------[]----------------X[]-XX------X----------------------[]-[]---------------------------------<>---------<>---<>-----------------------------------------------------------------------------<>---------[]----------------------------
------------------[]------XX-------------------------[]-E-----E-------X-[]-XX------X----------------------[]-[]--------EE-----------------------[]----EE---[]---[]-----E-----------------------------------EE-E--------------------------------[]---------[]----------------------------
XXXXXXXXXXXXXXXXXXXXXXXXXXXXXXXXXXXXXXXXXXXXXXXXXXXXXXXXXXXXXXXXXXXXXXXXXXXXXXXXXXXXXXXXXXXXX--XXXXXXXXXXXXXXXXXXXXXXXXXXXXXXXXXXXXXXXXXXXXXXXXXXXXXXXXXXXXXXXXXXXXXXXXXXXXXXXXXXXXX-XXXXXXXXXXXXXXX---XXXXXXXXXXXXXXXXXXXXXXXXXXXXXXXXXX-XXXXXXXXXXXXXXXXXX---------X------------------
