----------------------------------------------------------------------------------------------------------------------------------------------------------------------------------------------------------------------------------------------------------------------------------------
----------------------------------------------------------------------------------------------------------------------------------------------------------------------------------------------------------------------------------------------------------------------------------------
------------------------------------------------------------------------------------------------------------------------------------------------------------------------------------------------------------------------------------------------------------SSSSSSSSSSSSSSSSSSSSSSSSSSSS
----------------------------------------------------------------------------------------------------------------------------------------------------------------------------------------------------------------------------------------------------------------------------------------
-----------------------------------------------------------------XXX--------------------------------------------------------------------------------------------------------------------------------------------------------------------------------------------------------------------
S--------------------------------------?SSS----------------------------------------------------------------XX-----------------------------------------SSSSS-----------------------------------------X--------------------------------------------------------S------S-------------------
--------------------------------------------------------------------------------------------------------------------------------------------------------------------------------------------------------E-------------------------------------------------------------------------------
--------------------------------------------------------------------------------------------------------------------------------------------E------------------------------------------------------------------------------------------------X------------------------------------------
-----------------------------XSSSSSSS-----------------E-------------------------------------------------------------------------------------XXSSSSSSS-----------------E----------------------------------------------------------------------X-------------------------------------SS---
SSSQ--------------XXX------------------SSSSS---------<>----------------Q------S--------------------X-----------------------------------------------S?--SSSSS---------<>-----------------------SS----X-------------XXXXXX------------------------------SSSSSSSSSSS--SSSS---------X------X
-------E---------XXXX--------------------------------[]-----------E-----E-------------------------EXXX------------------------------------E--------------------------[]------E----------E----E--------------------------------------------E------------------------------------XX------X
------<>--------XXXXX--------------------------------[]----------<>-------------------------------XXXX-----------------------------------<>--------------------------[]------>---------<>---<>--------------------------------------------E---------------------------------<>-XX------X
------[]-------XXXXXX-------XX-----------------E-----[]------E---[]---------------E----------------X-------------------------------------[]--------------------E-----[]-----E]----E----[]---[]E----E------------------------------E--E-EE-S-----------EE-EE-E-----E---------[]-XX------X
XXXXXXXXXXXXXXXXXXXXXXXXXXXX-XXXXXXXXX--XXXXXXXXXXXXXXXXXXXXXXXXXXXXXXXXXXXXXXXXXXXXXXXXX--XXXXXXXXXXXXX--------XXXXXXXXX--XXXXXXXXXXXXXXXXX---XXXXXX---XXXXXXX--X--XXXXXXXXXXXXXXXXXXXXXXXXXXXXXXXX----------XX----------------XXXXXXXXXXXXXXXXXXXXXXXXXXXXXXXXXXXXXXXXXXXXXXXXXXXXXXXX
