----------------------------------------------------------------------------------------------------------------------------------------------------------------------------------------------------------------------------------------------------------------------------------------
----------------------------------------------------------------------------------------------------------------------------------------------------------------------------------------------------------------------------------------------------------------------------------------
------------>-------------------------------------------SSSSSSSSSSSSSSSSS---SS----------------------------------------------------------------------------------------------------------------------------------------------------------------------------------------------------------
----------------------------------------------------------SS-SSSSSSSSS--------------------------------------------------------------------------------------------------------E---------------------------------------------------------------------------------------------------------
------------]----E-----------------------------------------SSSSSSSSSSS---------------------------------------------XXXXX--------------------------------------------------XXXXXXX-----------------------------------------------------------------------------------------E-------------
-----------XXXX--------------------------------------------SSSSSSSSSS--S------------------------------E---------E-----------------SSSSSSS---------------XE-------------------------------XSSS------------------------------------------QQQQQQ--------------S-----------------E----------
------------------XXXX-----------------------------------E------------------------------E-------------------------------------------------------------------XXXXX-----------------------------------------------------------------------------------------------------------XX-X-XXXX---
------------------------------------------------------------------S---------------------------------------------------------------------------------------------------------------------------------------------------------------------------------------------------------------------
--------------------------XX--------------------------------E-----S------------E--------------------------------------------------------------------------------------E----XXXX---------------------------------------------------------------------------------------------------------
-XX--------------?S-S------S---S-----QQ-------------------E--SSSSSSS----------[>----X-------------XEXXXX--------XXXXX-------------XX-X---------------------------------S-XXXX-------XXX-----XX---X------------------------SS------E--QQ--SQQQ------------------------------------S-----Q
XXX--------------------------------------------E---------SE------SS-----------[]----X-------------XXXX---------------------EXXX--------------E--------------------------------------------------XXXX----------------E------------<>--------------------E--------------------------------
XXX--------------------------------------------X---------SSS-S---SS-------<---[]---------------------------------------X--------------------XXX--------------------------------------------------------------------<>------------[]-------------------<>----XXXX------------------------
XXXX-------------------------------------------[---------[]------ES-------[]--[]------------------------------------------------------------XX-----------------------------------------------XX----------E----E----[]------------[]---------------EE--[]-----------------E-------E-E----
XX--XXXX------XXXXXXXXXXXXXXXXXXXXXXXXXXXXXXXXXXXXXXXXXXXXXXXXXXXXXXXXXXXXXXXXXXXXXXXXXXXX----XXXXX----XXXX-XXXX----------------------------X----XXXXX-----X-----XXXXXXX----------------------------XXXXXXXXXXXXXXXXXXXX---XXXXXXXXXXXXXXXXXXXXXXXXXXXXXXXXX-----X--XXX-XXXXXXXXXXXXXXXX
