----------------------------------------------------------------------------------------------------------------------------------------------------------------------------------------------------------------------------------------------------------------------------------------
----------------------------------------------------------------------------------------------------------------------------------------------------------------------------------------------------------------------------------------------------------------------------------------
----------------------------------------------------------------------------------------------------------------------------------------------------------------------------------------------------------------------------------------------------------------------------------------
----------------------------------------------------------------------------------------------------------------------------------------------------------------------------------------------------------------------------------------------------------------------------------------
----------------------------------------------------------------------------------------------------------------------------------------------------------------------------------------------------------------------------------------------------------------------------------------
--------------------------------------------------------Q----------------------------S---------------------------------------------SSSSSSS--S----------------------SS-------------------------------------------------------------------------------------------------------------------
----------------------------------------------------------------------------------------------------------------------------------------------------------------------------------------------------------------------------------------------------------------------------------------
----------------------------------------------------------------------------------------------------------------------------------------------------------------------------------------------------------------------------------------------------------------------------------------
------------------------------------------------------------------------------------------------------X------------XX-------------------------------------------------------------------------------------------------------------------------------------------------------------------
--------------------------------------------------------------------XX--------------------------------X---------------------XXX-------------Q-----------------XX------------------------------SS-------------------<>----------------------------------------------------------------SSS
------------X-------------------------------------------------------XX----------------------------EXXXX---------------------------------------------------EXXXXX-------------E----------E----E---------------------[]---------------------------E---------E-----------------------------
------------X------------------------------------------------------XXX-----------------------------XXXX-------------------------------------X----------------X-X------------<>---------<>--------------------------[]--------------------------<>--------<>-----------------------------
--------E---X--------EEE-----------E-EE---------------E-------------XX-------EEEEE-E---------------XXXX---------------------------------------------------------------------[]----E----[]-----E---------E------E---[]--------------------------[]--------[]--------EE-------------------
X-XXXXXXXXXXXXXXXXXXXXXXXXXXXXXXXXXXXXXXXXXXXXX-XXXXXXXXX-XXXXX-XXXXXX----XXXXXXXXXXXXXXXXXXXXXXXXXXXX----------X------XXXX-----------------XXXXX---XXXXXX-----X----XXXXXXXXXXXXXXXXXXXXXXXXXXXXXXXXXXXXXXXXXXXXXXXXXXXX-----X-XXXXXXXXXX--XXXXXXXXXXXXXXXXXXXXXXXXXXXXXXXXXXXXXXXXXXXXX
