----------------------------------------------------------------------------------------------------------------------------------------------------------------------------------------------------------------------------------------------------------------------------------------
----------------------------------------------------------------------------------------------------------------------------------------------------------------------------------------------------------------------------------------------------------------------------------------
----------------------------------------------------------------------------------------------------------------------------------------------------------------------------------------------------------------------------------------------------------------------------------------
----------------------------------------------------------------------------------------------------------------------------------------------------------<>----------------------------------------------------------------------------------------------------------------------------
----------------------------------------------------------------------------------------------------------------------------------------------------X-----[]---------------XXXXX--------------------------------------------------------------------------------------------------------
----------------------------------------------X-------------------------------------------------S-------------------------------------------X---S??-E?-------??SSS-----------------------SSSS--------------Q--QQQ--------------S----------------------------SSS--------------------SS---
-----------------X---------------------------XX-----------------------------------------------------------------------------------------------------------------------------------------------------------------------------------------------------------------------------------------
---------------XXX--------------------------XXX------------------------------------------------------------------------------------------------E----------------------------------------------------------------------------------------------------------------------------------------
--------------XXXX----------SS-------------XXXX------------------------------------------E----------E---------------------------------------X-XX----------------------------------------------------------------------------------------------------------------------------------------
-------------XXXXX----------E------------XXXXXX------------------------------S----------<>---------<>----------E----------------------------------------XXX----------X---XXX-------------XXXXX----------E-Q---QQQQ-QQQ---------------E----------E----------E----------------------------
------------EXXXXX----------X------------XXXXXX-----------------------------------------[]---------[]---------<>----------------------------------------------------XXXX-------------XX---------------------------------------------<>---------<>---------<>---------------X--X---------
-----------XXXXXXX----------------------XXXXXXX-----------------------------------------[]---------[]----<>---[]-----------------------------------------------------X-------------------------------------------------------X------[]---------[]---------[]------------------X---------
----------XXXXXXXX--------------------XXXXXXXXX---------------------EE-------E-E--------[]---------[]----[]---[]------------------------------------------------E-E----------------------------------------------------------X------[]---------[]---------[]---------------X--X---------
XXXXX--XXXXXXXXXXXXXXX--XXXXXXXXXX--XXXXXXX--XXXXX--XXXX-----X--XXXXXXXXXXXXXXXXXXXX-XXXXXXXXXXXXXXXXXXX-XXXXXXXXXXXXXXXX---XXXXXXXXXXXXXXXX------XXXXX-----XXXXXXXXXXX-X---------X-----------------XXXXXXXXXXXXXXXXXXXXX--XXXXXXXXXXXXXXXXXXX-XXXXXXXXXXXXXXXXX---XXXXXXXXXXXXX-----X-X
