----------------------------------------------------------------------------------------------------------------------------------------------------------------------------------------------------------------------------------------------------------------------------------------
----------------------------------------------------------------------------------------------------------------------------------------------------------------------------------------------------------------------------------------------------------------------------------------
--------------------------------------------------------------------------------------------------------------------------------------------SS-------------SSSSSSSSSSSSS----------------------------------------------------------------------------------------------------------------
----------------------------------------------------------------------------------------------------------------------------------------------------------------------------------------------------------------------------------------------------------------------------------------
----------------------------------------------------------------------------------------------------------------------------------------------------------------------------------------------------------------------------------------------------------------------------------------
-------------------------------------------X-S----------------------EQS------------------------------X---------------------------------------------------------------------------------------------------------------------------------------------------------SSSSSSSS-----------------
----------------XXXX----------------------XX-------------------------------------------------------XXXX-------------------------------------------------------------------------------------------------------------------------------------------XX------------------------------------
------------------------------------------XX------------------------------------------------------XXXX----------------------------------------------------------------------------------------------------------------------------------------------------------------------------------
----------------------------------------X-XX--------------SSSSSSS-----------------E--------------XXXXX--------------------------E---------------------------XSSS----------------------------------------------------------------------------------------------E-------------------------
-----------------SS-S------S-----------X--X-------------------------S?S----------QQ--------------XXXXX---------------QQ----?---<>-----------<>--------------X---------------------------E------------------------X----------------------------------SS--S-SS-------SS----SS----------X--
-E-------------------------------------XXXXX-----E------------E------------------X------------X-XXXXXX---------E---------------[]---E-------[]-------E-----------XX--------------------<>----------------------XXX-------------------------------------------------------------------X--
XXXX-----------------------------------X--XX----<>-------------------------------------------XXXXXXXXX---------[---------------[]-----------[]------------XXE----XX----X---------------[]---------------------XXXX--------------XX---------------------------------------------------X--
-----------------------------E--E---XXXXX-EX----[]-----EXX-----E-E---------------------------XXXXXXXXX------E--X---------------[]-E---------[]--E--------XX------XX----X----E------E---[]-------------------EXXXXX-E--------E---XX----------------------------------------------E-E-----
-----XXXX----XXXXXXXXXXXXXXXXXXXXXXXXXXXXXXXXXXXXXXXXXXXXXXXXXXXXXXXXXXXXXXXXXXXXXXXXXXXXXX--XXXXXX--X-----XX---XXXXXXXXXXXXXXXXXXXXX--X-X-XXXXXXXXXXXXXXXXXXXX--XXXXXXXXXXXXXXXXXXXXXXXXXXX-----XXXXXXXXXXXXXXXXX-XXXXX-----------XXXXXXXX-XXXXXXXXXXXXXXXXXXXXXXXXXXXXXXXXXXXXXXXXXXXX
