----------------------------------------------------------------------------------------------------------------------------------------------------------------------------------------------------------------------------------------------------------------------------------------
--------------------------------------------------------------------------------------------------------S-------------------------------------------------------------------------------------------------------------------------------------------------------------------------------
-------------------------------SSSSSSS-S--------SS----SS------------------------------------------SS----SS------------------------------------------------------------------------------------------------------------------------------------------------------------------------------
-------------------------------S---SS----------------SSS---------------------------------SSSSS--SSSS----SS---S-S-----------------------------EEE--E-------------------------------------------------------------------------------------------------------------------------------------
-------------------------------SS--SS-----------SS---SSS------------------------------------------SS----SS---SS------------------------------XXXXXXXX------------E----------XX----------------------------------------------------------------------------------------------------------
----------------------------SSSSSSSSSS---SSS-----------S-------------------------------SSSSSSSSSSSSS----SSSSSSSSS-----------------S----S----?----------------SSSSSS-----S---------------------SSS-------------------------------Q-------------------------------------------SSS---------
-------------------------------------------------------------------------------------E--------------------------------------------X-------------------------------------------------------------------------------------------------X-------------------------------------------E-------
----------------------------------------------------------------------------------------------------------------------------------X-----------------------------------------------------------------------------------------------------------------------------------------------------
------------------------------EE--------------------------------------------------------------------------------SS---------------XX-----------------------------------------------------------------------------------------------------------------------------------------XE----------
------------------------S----SSSSSSSS----------E------X--------------------------QQ-----SSSSSS----------------X-QQQ-------------XXXX---------XXXX-------------XXXX----XXQQQQ--------------XXX------------------------------------------------XXXXXX----------E---E---------XX-----------
--------------------------------SSSSS---------<>---E----------E-------------------------------------------------X-------------EXXXXXX--------------X---EXXX-----------XX-------E-----XXXXXXXX-----------------------E---------E-------------X---------------<>--<>---X--X--XX----X------
-------------------------------SSSSS--------X-X]--<>------------------------------------------------------------]-------------XXXXXX--------------XX--------------------------<>----------XX---------------------------------<>-------------XX--------------[]--[]------XXXXX----XX-----
----------------------------------S---------X-[]E-[]-XX--------E-EE---------------E-------------------EEE-------]-------------XXXXXX-----------------------XX---XXX-----------[]-------X---------------------EE--------------[]-------------XX-------E-EE---[]--[]-----EXXXXX----X------
XXXXX--XXX----XXXXXXXXXXXXXXXXXX-XXXXXXXXX-XXXX-XXX--XX-XXXXXXXXXXXXXXXXXXXXXXXXXXXXXXXXXXXXXXXXXXXXXXXXXXXXXXXXXXXXXX-XXXXXXXX---------X-XXX---------------------------XXX----XXXXXX---------------XXXXXXXXXXXXXXXXXXX--XXXXXXXX---XXX--XXXXX---XXXXXXXXXXXXXXXXXXXXXXX--XXX---XXXXXXXX
