----------------------------------------------------------------------------------------------------------------------------------------------------------------------------------------------------------------------------------------------------------------------------------------
----------------------------------------------------------------------------------------------------------------------------------------------------------------------------------------------------------------------------------------------------------------------------------------
-----SSSSSSSSSSSSSSSSSSSSSSS----------------------------------------------------------------S-SS-SSSSSSSSSSSS------------------------------------------------------------------------------------------S-SSSSSSSSSSSS-------------------------------------------------------------------
-------------------------------------E--------------------------------------------------------------------------------------------------------------------------------------------------------------------------------------------------------------------------------------------------
-------------------------------------XXX------------------------------------------------------------------------------------------------------------------------------------------------------------------------------------------------------------------------------------------------
-S--------------------------------------EQQ----------------------------------------------------------------------------Q--QQQ--------------S-------QQQQQ-------------------SSSSSSS-----S----SSSSSSSS-SSS---SS-------------------------------------------------------------------------XX
------------------------------------------------------------------------XX------------------------------------------------------------------------------------------------------------------------------------------------------------------------------------------------E-------------
-----------------------------------S-----------------------------------XXX------------------------------------------------------------------------------------------------------------------------------------------------------------------------------------------------XXXXXX--------
------------------------------SSSSSSS---------------------------------XXXX---------------------------SSS------------------------------------------------------------------E-------------------------------------------------------------------------------------------------------------
--------Q--------X----------------------S?SQ---------QQ--------------XXXXX------------------QQ----------------------EQQ---QQQ--?Q-----------------S----QQ-------------E----?S--SS----EX-------------SSSSS--SSS--------------------------------XXXXX--------------------------------S----
-----------------X-X---------------------------------[------------X-EXXXXX-------------------------------------------------------------------------------------------<>------------------------------------------------X---E-----------------------------------------------------E------
---------------XXXXX----------------------------------------------XXXXXXXX--------------------------<>-X-------X-----------------------------------------------------[]---------------------------------------------X-XX--->---X------------------------------------------------<-------
------E-------XXXXXX-----------------E----------------E-----------XXXXXXXX---------X------E-------X-[]---------X------------------EE------------------------------E--[]-----------------------------------E-----------[]---]-XXX-----------------------------EE-EEE-E-EEE-EE-----]E-E--E
XXXXXXXXXXXXXXXXXXX---------XXXXXXXXXXXXXXXXXXXX-XXXXXXXXXXXXX---XXXXXX--------XX--XXXXXXXXXXXXXXXXXXXXX--XXXXXXXXXXXXXXXXXXXXXXXXXXXXXXXXXXXXXXXXXXXXXXXX-XX-----XXXXXXX-X---XXXXXXX---XXXXXXX--X--XXXXXXXXXXXXXXXXXXXXXXXXXXXXXXXXXX----XXXX-----XXXXXXXXXXXXXXXXXXXXXXXXXXXXXXXXXXXXX
