----------------------------------------------------------------------------------------------------------------------------------------------------------------------------------------------------------------------------------------------------------------------------------------
----------------------------------------------------------------------------------------------------------------------------------------------------------------------------------------------------------------------------------------------------------------------------------------
----------------------------------------------------------------------------------------------------------------------------------------------------------------------------------------------------------------------------------------------------------------------------------------
---------------------------S-----------------------------------------------------------------E------------------------------------------------------------------------------------------------------------------------------------------------------------------------------------------
---EE---------------------SS-----------------------------------------------------------------XXX----------------------------------------------------------------------------------------------------------------------------------------------------------------------------------------
--SSSSSSS------S-??S--------X---SSSSSSSSS--------------------------------------------------------QQ-------------------------------XX------------------------------------------------?S--------------SSSSSSSSSSS----S--------------XXX---------------------------------------------------
----------------------------X-------------------------------------------------------------------------------------------------------------------------------------------------------------XX--------------------------------------------------------------------------------------------
----------------------------X--------------------------------------------------------------S--------------------------------------------------------------------------------------------------------------------------------------------------X-XXXX-----------------------XX--X--------
--EE------------------------X----------------------E--?----------------------------------SSSS----------------------XX-------------------------SSSSSSS-----------------------S---------------------E------------------------E------------------------------------------------------------
-XS?SSSS------E----X-----XX------SSSSS-S?SS-------<>-[]----------------------------------------EQQQQ-Q--------E----------------------------------------SSSSS----------E--X-----------------------QQS----S--SS-------------<>------------------------------------------------------------
-----SSS---EX-------------------------------------[]-[]------------------------------------------------------<>------------------------------------------------------<>--X-----------------------E------------------------[]-------------------------------------E----------E----E-----<
-----SSS--------X--------XX-----------------------[]-[]------------------------------------------------------[]------------------------------------------------------[]-XXX-----------------------------------------------[]------------------------------------<>---------<>---<>-----[
----------------X---E-E--XX--------------------EE-[]-[]--------------------------------------E---------E-----[]------------------------------------------------------[]-XXX----E-E----------------------------------------[]------E--EE-E-E-E----------E-EE-----[]---------[]---[]-----[
XXX--XXXX-X----------XX-XXX-XXXXXXXXXXXXXXXXXXXXXXXXXXXXXXXXXXXXXXXX--XXXXXXXXXXXXXXXXXXXXXXXXXXXXXXXXXXXXXXXXXXXXXX-XXXX------XXXXXXXX--X--XXXXXXXXXXXXXXXXXXXXXXXXXXXXXXXXXXXXXXXXXXXXXXX--XXXXXXXXXXXXXXXXXXXXXXXXXXXXXXXXXXXXXXXXXXXXXXXXXXXXXX-XXXXXXXXXXXXXXXXX-XXXXXXXXXXXXXXXXXX
