----------------------------------------------------------------------------------------------------------------------------------------------------------------------------------------------------------------------------------------------------------------------------------------
----------------------------------------------------------------------------------------------------------------------------------------------------------------------------------------------------------------------------------------------------------------------------------------
------------------------------------------------------------------------------------SSSSSSSSSSSSSSSSSSSSSSSSSSSS------------------------------------------------------------------------------------------------------------------------------------------------------------------------
------------------------------------------------------------------------------------------------------------------------------------------------------------------------XEEE--E------------------------------------X--------------------------------------------------------------------
------------------------------------------------------------------------------------------------------------------------------------------------------------------------<XXXXXXXX----------------------------------X--------------------------------------------------------------------
-------------------S----SS------------Q-------------------------------------------------------------------------S---------------------SSS------------QSS-S-----X--------?----------------SSSSSSSS------------------X-----------------------------------------------------------------XXX
------------------------------------------------------------------------------------------------------------------------------------------------------------------------------------------------------------------XX--------------------------------------------------------------------
-----------------------------------------------------------------------------------------------------------------------------------------------------------------------------------------------------------------XXX-------------------------------X------------------------------------
---X-----------------------------------------------E--------------------------------E---------E------SSS---E---------------------------------XXXXX--------------------E-----------------------------------------XXXX--------------------------------------------------------------------
--XXX-----------------------------Q---------E-----<>-------------------------------->--S-----<>-----------<>----XQQQ--------------XXXX------------------SS-----------<>-XXXXX------------XXXXX-----------------XXXX---------------------------------------------------------------SSS---
-------------------------------------------<>-----[]--E--------------------------------------[]-----------[]---X-------E-----XXXXXXXX--------------------------------[]------------EXXX-----------------------XXXXXX-----E----------------------E---------------------------E-----------
-------------------------------------------[]-----[]--------------------------------SS-------[]--------XX-[]--<>------X>----------XX---------------------------------[]-------XX-----------------------------XXXXXXX---------------------------<>--------------------------<>-----------
-------------------------------------------[]-----[]----------------E---------------S--------[]--E--------[]--[]------[]-------X---X---------------------------------[]------------------------------E------XXXXXXXX--------E--E--E-EE----E----[]--------EEE-----E----E----[]-----E-----
XXX---XXX------XXXXXXXXXXX--XXXXXXXXXXXXXXXXXXX-XXXXXXXXXXXXXXXXXXXXXXXX-----XX-XXXXXXXXXXXXXXXXXXXXXXXXXXXXXXXXXXXXXXXXXXXXX--XXXXXXXX-XXXXXXXXXXXXX-------XXXXXXXXXXX-----------------------------XXXXXXXXXXXXXXXXXXXXXXXXXXXXXXXXXXXXXXXXXXXXXXXXXXXXXXXXXXXXXXXXXXXXXXXXXXXXXXXXXXXX
