----------------------------------------------------------------------------------------------------------------------------------------------------------------------------------------------------------------------------------------------------------------------------------------
----------------------------------------------------------------------------------------------------------------------------------------------------------------------------------------------------------------------------------------------------------------------------------------
----------------------------------------------------------------------------------------------------------------------------------------------------------------------------------------------------SSSSSSSSSS------SSSSSSSSSSSS--------------------------------------------------------
---------------------------------------------------------------------------------------------------------------------------------------------------------------------------------------------------------------------------------------------------------------------------X------------
--------------------------------------XX----------------------------------------------------------------------------X------------------------------------------------------------------------------------------------------------------------------------------------------X------------
----------QQ------------SSSS-------------------------------------------------------------------------SSSSSSSS----------------------S--SSS--------------------------------XXXX----------------------------------------------------------------------------------------------X------------
--------------------------------------------------------------------------------------------------------------------------------------------------------------------------------------------------------------------------------------------------------------------------XX------------
-------------------------------------------------------------------------------------------------------------------------------------------------------------------------------------------------------------------------------------------------------------------------XXX------------
-------------------------------------------------------------E----------E--------------------------------------------------------------------------------------------------------------------------------------------SS-------------------------------------------------XXXX------------
------Q---QQ----Q-------------------------------------------<>---------<>------------XXXX-------------XXXX------XXXXX-------------XXXX----X-----------------------S------------------------------S----------QQ----------------------------------X----------------------XXXX-------------
--------------------------------------E---------------E-----[]---------[]---E--------------E----XX---------------------E---EXXX----X------------------E-----E-------------------------------------------------------------------------------X-------------------------XXXXXX-----E-----<
-------------------------------------<>--------------<>-----[]---------[]------------------X--------------------------X>----------XX-----------------<>----<>-------------------------------------------------------<>-X--------------------XX-----------------------XXXXXXX----<>-----[
------------------E------------------[]--------------[]-----[]---------[]--------------------------X------------------[]-------X--X-------------EE---[]----[]--------E-------EEEE---E----------E-EE-E-----E------EX-[]----------------------XX-------E-EE----E--E-E-XXXXXXXX----[]--E--[
XXXXXXXXXXXXXXXXXXXXXXXXXXXXXXXXXXXXXXXXXXXXXXX---XXXXXX-XXXXXXXXXXXXXXXXXXXXX-X-XXXX------XXXXX---XXXXXXXX--XXXXXX------XXXX--XXXXXXXXXXXXXXXXXXXXXXXXXXXXXXXXXXXXXXXXXXXXXXXXXXXXXXXXXX---XXXXXXXXXXXXXXXXXXXXXXXXXX-XXXXXXXXXX---XXX-XXXXXX-XXXXXXXXXXXXXXXXXXXXXXXXXXXXXXXXXXXXXXXXX
