----------------------------------------------------------------------------------------------------------------------------------------------------------------------------------------------------------------------------------------------------------------------------------------
----------------------------------------------------------------------------------------------------------------------------------------------------------------------------------------------------------------------------------------------------------------------------------------
----------------------------------------------------------------------------------------------------------------------------------------------------------------------------------------------------------------------------------------------------------------------------------------
---------------------------------------------------------------------------------------------------X------------------------------------------------------------------------------------------------------------------------------------------------------------------------------------
---------------------------------------------------------------------------------------------------X------------------------------------------------------------------------------------------------------------------------------------------------------------------------------------
---------------------------------------------------------------------------------------------------X-X-------------------------------------XQ----------------------XX-------------------------XXXXX-----------------------------------------?SS-----------------------------------------
--------------------------------------------------------------------------------------------------XXXX-----------------------------------------XXX-----------------X-X----------------------------------------------------------------------------XX------------------------------------
-----------------------------------------XX-XXXX-------------------------------------------------XXXXX----------------------------------------------------------------------------------------------------------------------------------------------------------------------------------
------------------------------------------------------------------------------------------------XXXXXX----------------------------------------------------------------------------------------------------------------------------------------------------XX------SSS-------------------
---------------------------S----------------------SS-------------------------------------------XXXXXX--------------------------<>------S----X------------XXXXX---------------------------------------------------------------QQ--X------------------------SS-------------QQQ----------E-
--------------------------------------E-----E---------------------------E---------------------XXXXXXX----X-----<---------------[]-------------------------------------------------------------------------E---E------------------X---------------------------------------------------<>-
--X-----------------------------------E----->--------------------------<>--------------------XXXXXXXX----X-----[---------------[]------------------------X---------------------------------------------------<>-----------------XX---------------------------------------------------[]-
-------------E---------E------E-EE----S----[]-----E--E-E--------------------------E-EE-E----XXXXXXXXXX---X--E--[---------------[]------------------------X-------------------------------------------------E-[]--------------EE-XXX----E---------------------------E-E---------------[]-
XXX-XXXXXX--XXXX----XXXXXXXXXXXXXXXXXXXXXXXXXXXXXXXXXXXXXXXXXXXXXXXXXXXXXX----XXXXXXXXXXXXXXXXXXXXXXXXXXXXXXXXXXXXXXXXXXX-XXXXXXXXXXX----XXXXXXXXX---XXXX---------------------XXX------XXXXXXXXX--XXXXXXXXXXXXXXXXXXXXX-XXXXXXXX---XXXXXXXXX-XXXXXXXXXXXXXXXXXXXXXXXX--XXXXXXXXXXXXXXXXX
