----------------------------------------------------------------------------------------------------------------------------------------------------------------------------------------------------------------------------------------------------------------------------------------
X---------------------------------------------------------------------------------------------------------------------------------------------------------------------------------------------------------------------------------------------------------------------------------------
--------------------------------------------------------------------------------------------------------------------------------------------------------------------------------------------------------------------------------SSSSSSSSSSSSSSSSSSSSSSSSSSSS----------------------------
----------------------------------------------------------------------------------------------------------------------------------------------------------------------------------------------------------------------------------------------------------------------------------------
----------------------------------------------------------------------------------------------------------------------------------------------------------------------------------------------------------------------------------------------------------------------------------------
X----------SS----------------XXXX-----------------------X---------------------XXXX--------------------------------------------------------------------------------------------------------SS-----S---------------------------------S----S-----------------------------------------------
------------------------------------------------------------E---------------------------------------------------------------------------------------------------------------------------------------------------------------------------------------------------------------------------
-----------------------------------------------------------------------------------------------------------------------------------------------------------XXXXX------------------------------------------------------------------------------------------------------------------------
-----E----------E--------------------------------------------------------------------------------------------------------------------------------------------------------------------------------------SS---------------------E-----------E---------------------------------------------
-----E---------<>---------------------------------------X-----------------EX---------------------------------------------------------------------------------------------XX---------------S--S-------------------------------<>---SSS--SSSS------------------------------------------SQS
----<>---------[]---------------------------------------X-------------EXXXXX--------------------X-----------------------------------------------------------E----E-----------------------------------X-----------------------[]----S----SSS--------<>-----------------------------------
----[]---------[]---X<>----X----------------------------X---------------------------------------X----------------------------------------------------------<>----------[-----------------------------------------------------[]----S-----SS--------[]-----------------------------------
----[]-------E-[]---][]----X--------E---E-------------------------------------------------------X----------E----------------------------------E-EE----E----E]--------E-E-----------------------------------------------------[]-------ES-SS--------[]--------------EEEE------------E--E-
--XXXXXXXXXX-XXXX---XXXXXXXX-----XXXXXXXXXXXX----XXXXXXXXXX-----XXXXX-------------------XXXXXXXXXX-------XX-XXXXXXXXXXXXXX---XXXXXXXXXXXXXXXXXXXXXXXXXXXXXXXXXXXXXXXXXXXXXXXXXXX-----XXXXXXXXXXXXXXX---XXXXX-------X-----XXXXXXXXXXXXXXXXXXXXXXXXXXXXXXXXXXXXXXXXXXXXXXXXXXXXXXXXXXXXXXX
