----------------------------------------------------------------------------------------------------------------------------------------------------------------------------------------------------------------------------------------------------------------------------------------
--------------------------------------------------------------------------------------------------------------------------------------------------------------------------------------------------------------------------------------------------------------------------------S-------
----------------------------SSSSSSSSSSSSSSSSSSSSSSSSSSSS--------------------------------------------------------SSSSSSSSSSSSSSSSSSSSSSSSSSSS------------------------------------------------------------------------------------------------------------------------------------SS-----S
--------------------------------------------------------------------------------------------------------------------------------------------------------------------------------------------------------------------------------------------------------------------------------SS---SSS
-------------------------------------------------------------------------------------------------------------------------------------------------------------------------XXXXX-----------------------------------------------------------XXX-------------------EE---------------SS---SSS
--------------------------XX-SSS---SSS----------------S--SSS--SSSSSS-------------------------------X-------------S--------------------------------------------------XXXXS----------------SSSSSSS--------------------------------------------QQQ-------------SSSSSSSSSS----SS-----------S
--------------------------------------------------------------------------------------------------XXX---------------------------------------------------------------------------------------------------E-------------------------------------------------------------------------------
-------------------------------------------------------------------------------------------------XXXX-----------------------------------------------------------------------------------------------------------------------------------------------------------------------------------
--------------------------------------E----------------------------------------E----------------XXXXXX-------------------------------------------------------------------------------------------------------------------------------S------------------------EE------------------------
--------------QQ-------SSS----SSS--SSSS----------------------SSSSSS-----------<>---------------XXXXXX-----------SSSS----S-S---------X-------------------------------S---XXXXX-------------XXXX----XX--------------XXXX--------------E-----QQQQQQQQ------------S?SSSSS-----E-----------X-
-------------------------------SS---SSS--------<-------X----------------------[]--------------XXXXXXX----------------------------X-XX------------------------------------------E---EXX----------------------------------------------------------------------------SS--------------------
-------------------------------SS--SSSS--------[]-----------------------------[]-------------XXXXXXXX---------------------------<X-XX-----------------------------------------<>---------------------------------------------------------------------------------SS---------X-X-------X-
---------E---------------------SS-ESSSS--------[]-------------------------E---[]-----E-E----XXXXXXXXXX------E--EE-----E-------X-[]-XX-----------------------------------------[]-------XX-----------------------------------------------------------------------------------X---XXX---X-
XXXXXXXXXXXXXXXXXXXXXXXXXXXXXXXXXXXXXXXXXXXXXXXXXXXXXXXXXXXXXXXXXXXXXXXXXXX-XXXXXXXXXXXXXXXXXXXXXXXXXXXXXXXXXXXXXXXXXXXXXXXXXXXXXXXX---XXXXXX-XXXXXXXXXXXXXXXXXXXXXXXXXXX------XXXXX---XXXXXXXX-XXXXXXX-------XX----------------XXXXXXXXXXXXXXXXXXXXXXXXXXXXXXXX-XXXXXXX----------------
