----------------------------------------------------------------------------------------------------------------------------------------------------------------------------------------------------------------------------------------------------------------------------------------
----------------------------------------------------------------------------------------------------------------------------------------------------------------------------------------------------------------------------------------------------------------------------------------
SSSSSSSSSSSSSSSSSSSSSSSSSSSS-------------------SSSSSSSSS---SSSSSSSSS--SS----SS----------------------------------------------------------------------------------------------------------------------------------------------------------------------------------------------------------
----------------------------------------------------------SSSSSSSSSSSSSS----S------S----------------------------------------------------------------------------------------------------------------------------------------------------------------------------------------------------
-----------------------------------------------------------SSSSSSS----SS-----S----SS----------------------------------------------------------------------------------------------------------------------------------------------------------------------------------------------------
--------S-----------------------------------------------S-SSSSSSSSS--SSS----S-----------------------SSS----------SSSSSSSSSS--SSS--------SSSS----------------------------------SSSSSS----------------SSSSSSSSSS-----S---S--------SS--------------------------?-SS-------------SSS--------
----------------------------------------------------------------------------------------------------------------------------------------------------------------------------------------------------------------------------------------------------------------------------------------
----------------------------------------------------------------------------------------------------------------------------------------------------------------------------------------------------------------------------------------------------------------------------------------
--------------------------------------E---------------------E------------------E--?-----------------XE------------------------------------------------------XE---------------------------------E------EE-----------------------------------------X------------EX------------------------
SSSSS---S----------------------------<>--------------------?SSSSSS---------E--<>----<E---E----------X--------------SSSSSSS-------------------E--------------X-------------E--SS--SSS----------<>------SSS--------------X----------------Q-------XX------------XXX--------XX----------XX-
-------S-----------XX----------------[]---------E-----------SSSS----------<>--[]----<>--<>---X-----XX----X-----E----------------------------<>-------E-----XX----X-------<>-------------------[]-----------E---------------E--------------------XX---------E-------E----X------------XX-
------<>--------XXXXX----------------[]--------<>----------SSSS-----------[]--[]----[]--[]------XXXXX----XX---<>------------------<>--------[]----------XXXXX----XX------[]-------------------[]----------------------X---<>------------------XXXXX-------XX-------X--------X--------XX-
------[]--------[X-XX----------------[]--------[]-------------------------[]E-[]----[]--[]------XXXXX----XX---[]------------------[]E-------[]----------XXXXX----X-------[]---------------E---[]----------------------X-E-[]-X----------------XXXXX-------XX--------------------XXX--XX-
XXXXXXXXXXXXXXXXXXXXXXXXXXXXXXXXXXXXXXXXXXXXXXXXXXXXXXXXXXXXXXXXX-XXXX-XXXXXXXXXXXXXXXXXXXXXXXXX---XX---XXXXXXXXXXXXXXXXXXXXXXXXXXXXXXXXXXXXXXXXXXXXXXXXXXXXXX-XXXXXXXXXXXXXXXXXXXXXXXXXXXXXXXXXXXXXXXXXXXXXXXXXXX-XXXXXXXXXXXXXXXXXXXXX-XXXXXXXXX----XXXXXXX-----XX-----------------XX-
