----------------------------------------------------------------------------------------------------------------------------------------------------------------------------------------------------------------------------------------------------------------------------------------
----------------------------------------------------------------------------------------------------------------------------------------------------------------------------------------------------------------------------------------------------------------------------------------
SS------------------------------------------------------------------------------------------------------------------------------------------SSSSSSSSSSSSSSSSSSSSSSSSSSSS-----------------------------------------------------------SSSS-------------------------------------------------
-----------------------------------------------------------------------X-----------------------------------------------------------------------------------------------------------------------------------------------------------SSSSSSSSSSSS-----S------S---------------X------------
-----------------------------------------------------------------------X-----------------------------------------------------------------------------------------------------------------------------------------------------------SSSSSSSS----------S----S----------------X------------
--------SSS-------------------SSSSSSSSS---SS-----------S---------------X-S---------------------------------------XXX-------------------------S--------------------------------------S------------------------------------------X---SSSSSSSSSSSSS-----------S---------------X-S----------
----------------------------------------------------------------------XX--------------------------------------------------------------------------------------------------------------------------------------------------------EE----------------------------------------XX------------
---------------------------------------------------------------------XXX---------------------------XXXXX-----------------------------------------------------------------------------------------------------------------------------------------------------------------XXX------------
----------E------------E--------------------------------------------XXXX-----------------------------------------------------------------------------------------------------E----------E-------------------------------------------E-----------------------------------XXXXXE----------
--E--SS--SS-----------<>-------?SSSSS------------------------------XXXXX-----------E--------------------------------------------------S--S--SSSS----S-----------X-----------<>---------<>--------------------------QQ------SS-------SSSSSSSS---------------------------XXXXXX-----------
-<>------SS-----------[]---------------------------E--------------XXXXXX-----E----<>-------------------------------------------------------------------------X-XX-----------[]---------[]-----------------------------------------E--------------------E--------------XXXXXXX----E-----<
-[]------SS-----------[]--------------------------<>-------------XXXXXXX----<>----[]---------------------------[--------------------------------------------XXXXX-----------[]---------[]----<>-------------------------------------------------------<>-------------XXXXXXX-----X-----[
-[]------ES--------E--[]----------------------E-E-[]-X---E-EE---XXXXXXXX----[]----[]-EE-----E-EEE-EE--------E-E[-----E-EE-E-E----------E-E--------E-------XXXX-XX-----------[]---------[]----[-----X---------E-------------------------------------EE-[]-X---E-EE---XXXXXXXXX----X-----[
XXXXXXXXXXXXXXXXXXXXXXXXXXXXXXXXXXXXXXXXXXXXXXXXXXXXXXXXXXXXXXXXXXXX-XXXXXXXXXXXXXXXXXXXXXXXX-XXXXXXXXXXXXXXXXXXXXXXXXXXXXXXXXXXXXXXXXXXXXXXXXXXXXXXXXXXXXXXXXXXXXXXXXXX--XXXXXXXXXXXXXXXXXX--XXXXXXXXXXXXXXXXXXXXXXXXXXX-XXXXXXXXXXXXXXXXXXXXXXXXXXXXXXXXXXXXXXX-XXXXXXXXXXXXXXXXXXX-XX
