X---------------------------------------------------------------------------------------------------------------------------------------------------------------------------------------------------------------------------------------------------------------------------------------
----------------------S----S------------------------------------------------------------------------------------------------------------------------------------------------------------------------------------------------------------------------------------------------------------
SSSSSSSSSSSSSSSSSSSSSSSSSSSSSSSSSSSSSSSSSSSSSSSSSSSSSSSS----------------------------SSSSSSSSSSSSSSSSSSSSSSSSSSSS------------------------------------------------------------------------------------SSSSSSSSSSSSSSS-SSSSSSSSSSSS--------------------------------------------------------
SSSSSSSSSSSSSSSS----SSSSSSSS--------------------------------------------------------S-S----SS---------------------------------------------------------------------------------------------------------SS--SSSSSSS-----------------------------------------------------------------------
SSSSSSSSSSSSSSS-----SSSSSSSS--------------------------------------------------------S-S----SSS?-----------------------------------------------------------------------------------------------------------SSSSSSS-----------------------------------------------------------------------
SSSSSSSSSSS--SSS----S-----SSSSS----SS--------------------------QQQQQQ--------SSSSSSSSSSSS--SS----S---------SS-----XXXX-----------------------XXX------------------------------------------X----------S-S-SSSSSSSS----------------------------------------------------------X------------
-S-S--------------------------------------------------------------------------------------------------------------------------------------------------------------------------------------X---------X---------------------------------------------------------------------XX------------
----------S------------------------------------------------------------------------------------------------------------------------------------------------------------------------------XX-------------------S-----------------------------------------------------------XX------------
----?------------------??--------------------------SS------------------------------------------------------SS----------------------------------------------------------------------------XX-------------E-----S------------E--------------------------------------------XXXX------------
-SSSSSSSSSSS-------E--<>---XSSSSS--SS----------XX------X------SS--QQQQ--------------SSSSS--SS----------EX-------------------------------------------------------------------------------XXX-----------E--SSSSSSS----------[]--------------------------------------------XXXX-----------E
XSSSSSSSSSS-------<>--[]-----------SS--------X-XX------X-----------------------------------SSS--------<XX-------------------X---------------------------------------------------------EXXXX----------<E------SS-----------[]--------------------XX--------------------XXXXXX----------<>
SSSSSSSSSSS-------[]--[]----------<S--------<XXXX------X-------------------------------S--SSS-------XXXXX-------------------X---------------------------------------------------------XXXXX----------[]--X---SS-----------[]-------------------XXX-------------------XXXXXXX----------[]
SSSSSSSSSSS-------[]--[]---X]--E--[]-------XXX-XX------X------------------E------------S--SSS-------XX[XX------------EE-E---X---------EE-E-E--------E---E-----------------------------XXXXX----------[]------ES-------EE--[]------------------XXXX-----------E-E----XXXXXXXX----------[]
XXXXXXXXXXXXXXXXXXXXXXXXXXXXXXXXXXXXXXXXXXXXXXXX--XXXXXXXXXXXXXXXXXXXXXXXXXXXXXX-X-XXXXXXXXXXXXXXXXXXXXXX-X--XXXX-XXXXXXXXXXXXXXXXXXXXXXXXXXXX---XXXXXXXXXXXX-------XXXXXXXXXXXXXXXXXXX-------------XXXXXXXXXXXXXXXXXXXXXXXXXXXXXXXXXXXXXXXXXXXXXXXXX-XXXXXXXXXXXXXXXXXXXXXXXXXX-XXXX-XX
