----------------------------------------------------------------------------------------------------------------------------------------------------------------------------------------------------------------------------------------------------------------------------------------
--------------------------------------------------------------------------------------------------------------------------------------------S-------------------------------------------------------------------------------------------------------------------------------------------
--------------------------------------------------------------------------------------------------------------------------------------------SSSSSSSSSSSSSSSSSSSSSSSSSSSS----------------------------------------------------------------------------------------------------------------
-----------------------------------------------------------------E----------------------------------------------------------------------------------------------------------------------------------------------------------------------------------------------------------------------
-----------------------------------------------------------------XXX--------------------------------------------------------------------------------------------------------------------------------------------------------------------------------------------------------------------
----------------------------------------------------------------------Q-----------------------------------------------------------X-----------------------------------------------------------------------SSSSSSS-----------SSSS------------------E-----------XX------------------------
---------------------------------------------------------------------------------------------------------------------------------XX--------------------------------------------------------------------------------------------------------------<>-------------------------------------
--------------------------------------------------------------------------------------------------------------------------------XXX--------------------------S------------------------------------------------------------------------------------]-------------------------------------
-------------------------------------------------------------------------------------------------------------------------------XXXX---------E---------E------SSS------------------------------------------------------------------------------------------------------------------------
--------------XXX----------------------------SSSSS--------------------QQ---------SS-------------------------------------------XXXXX--------->>---S---<>-----------------------------------X-----------E--SS--SSS----------------X-------------XXXXX-------------------------------S--S--
--------------XXXX--------------------------------------------E---E----------------------------------------------------------XXXXXX---------[]-------[]---------?-X----X--------------EXXXX----------<>--------------------------------------XXXXXX-------------------------------------
-------------XX--------------------------------------------------<>------------------------------------X---------------------XXXXXX---------SS-------[]-----E--<XXX---XX-----------------------------[]--X-----------------------------------XXXXX--------------------------------------
-----------------------------------------------------------------[]------------------------------------X------------------XXXXXXXXX---------S]-------[]--E-----[]X]--XXX-----------------------------[]------E--------EE------------------XXXX----------------E--E-EE-E-E----------E-E--
XXXXXX---XXXXX--------------XXX-XX--XXX---XXXXXXXXXXXXXXXXXXXXXXXXXXXXXXXXXX--XXXXXXXXXXXXXXXXXXXXXXXXXXXXXXXXXXXXXXXXXXXXXXXXXXXXXX--------XXXXXXXXXXXXXXXXXXXXXXXXXXXXXXXXXXX--XXXXXXX-XXXXXXXXXXXXXXXXXXXXXXXXXXXXXXXXXXXXXXXXXXXXX---XXXXXX---XXXXX-XXXXXXXXXXXXXXXXXXXXXXX-XXXXXXXX
