----------------------------------------------------------------------------------------------------------------------------------------------------------------------------------------------------------------------------------------------------------------------------------------
----------------------------X-----------------------------------------------------------------------------------------------------------------------------------------------------------------------------------------------------------------------------------------------------------
--------------------------------------------------------SSSSSSSSSSSSSSSSSSSSSSSSSSSS------------------------------------------------------------------------------------------------------------------------------------------------------------------------SSSSSSSSSSSSSSSSSSSSSSSSSSSS
------------------------------------------------------------------------------------------------------------------------------------------------------------------------------------------------------------------------------------------------------------SSSSSSSSSSSSSSS------S----SS
------------------------------------------------------------------------------------------------------------------------------------------------------------------------------------------------------------------------------------------------------------SSSSSSSSSSSSSSS-----SS----SS
----------------------------------------S----------------SS-----S------------------------------Q--------------------------------------------------------EQS--------------XXX---------------------------S----S--------SSS------------------------------------SSSSSSSSSSS--SSS------------
------------------------------------------------E---------------------------------------------------------------------------------------------------------------------------------------------------------------------------------------------------------------------------------------
---------------------------------E---------------------------------------------------------------------------------------------------------------------------------------------------X--------------------------------------------------------------------------------------------------
---------------------------------E----------E--------------------------------------------E----------E----------------------------------------XSSSSSSS-----------------E--------------X--------------------------------------------------------------------------E------------------E----
--------------XXXX--------------<>---------<>----------ESSSSS---SQS---------------------<>-----E---<>--------------------------X------------------------S?SS---------<>-----------------------SSSSSS---XX----------------------------------------------------SSSSSSSSSS--------E--<>----
--------------------------------[]---------[]----X----<>-------------------XX-----------[]---------[]---------E------------------------------------------------------[---------------------------------------------------------------E----------E-------------SSSSSSSSS-------<>--[]----
--------------------------------[]---------[]---<<>---[]----------------<>-XX-----------[]---------[]--------<>--------------X-----------------------------------------------------------------------------------------------XX-----<>---E-----<>------------SSSSSSSSSS-------[]--[]----
----------------------------EE--[]-------E-[]---[[]---[]------E---------[]-XX-----------[]---------[]--------[]------------EEX----------E------------E--------------------E--E-EE-E-E--------E-E--------------------------E--X------[]---E-----[]------------SSSSSSSSSS-------[]--[]----
X---XX---XXXXX-------XXXXXXX-XXXXXXXXXXX---XXXXXXXXXXXXXXXXXXXXXXXXXXXXXXXXXXXXXXXXXXXXXXXXXXXXXXXXXXX-----X-XXXXXXXXXX-XXXXXXXXXXXXXXXXXXXX--XXXXXXXXXXXXXXXXXXXXXXXXXXXXXXXXXXXXXXXXXXXXXXXXXXXXXXXXX---XXXXXX----X-----X--XX-XXXXXXXXXXXXXXXXXXXXXXXXXXXXXXXXXXXXXXXXXXXXX----XXXXXXX
