----------------------------------------------------------------------------------------------------------------------------------------------------------------------------------------------------------------------------------------------------------------------------------------
----------------------------------------------------------------------------------------------------------------------------------------------------------------------------------------------------------------------------------------------------------------------------------------
----------------------------------------------------------------------------------------------------------------------------------------------------------------------------------------------------------------------------------------------------------------------------------------
----------------------------------------------------------------------------------------------------------------------------------------------------------------------------------------------------------------------------------------------------------------------------------------
----------------------------------------------------------------------------------------------------------------------------------------------------------------------------------------------------------------------------------------------------------------------------------------
--------------------------XX-------------E---E--------------------Q---------------------------QSS--------------S------SSSSSS--------------SS-----------------------XXX----------------Q---------SSXXXXXXX-------------------------------------------------------------------------------
--------------------------------------------XXXXXXXXX-----------------------------------------------------------------------------------------------------------------------------------------------------------------------------------------------------------------------------------
----------------XX----------------------------------------------------------------------------------------------------------------------------------------------------------------------------------------------------------------------------------------------------------------------
-----------------------------------------------------------------------------------------------------------------------------------------------------------------------------S----------------------------------------------------------------------------------------------------------
-----------------------S------------------------SS--S-SQ-----------QQQ------------E---E--QQ--SS?----E----------------SS--SSS------------------------------XXXXX--------------------QQQQQQ------SS--------------------------------------------XXXX---------------------------------------
-----------------------------E---------------------------------------------------<>--<>------------<>------------->--------------------------------------------------------------------------------------------------------------------------X------------------------------E---------E-
----------------------------XXXX-------------------------------------------------[]--[]--X---------[]------------[]---------------------------------------------------------------------------------------------X---------------------------XX-----------------------------<>---------E-
--E-----E-EEE-EE------E-E---X------------E-------E-------------------------------[]--[]------------[]-EE---------[]---------------EE------------------------------------------------------E-----------------E---E------------EE------------XXX----------E------------------[]---------E-
XXXXXXXXXXXXXXXXXXXXXXXXXXXX-----XXXXX--XXXXXXXXXXXXXXXXXXXXXXXXXXXXXXXXX--------XXXXXXXXXXXXXXXXXXXXXXXXXXXXXXXXXXXXXXXXXXXXXXXXXXXXXXXXXXXXX-XX-----XXXXX---XXXXX-XXXXXXXXXXXXXXXXXXXXXXXXXXXX-XXXXXXXXXXXXXXXXXXX-----XXXXXXXXXXXXX---XXXXX-----XXXXXXXXXXXXXXXXXXXXXXXXXXXXXXXXXXXXX
