----------------------------------------------------------------------------------------------------------------------------------------------------------------------------------------------------------------------------------------------------------------------------------------
----------------------------------------------------------------------------------------------------------------------------------------------------------------------------------------------------------------------------------------------------------------------------------------
------------------------------------------------------------------------------------------------------------------------------------------------------------------------SSSSSSSSSSSSSSSSSSSSSSSSSS--------------------------------------------------------------------------------------
----------------------------------------------------------------------------------------------------------------------------------------------------------------------------------------------------------------------------------------------------------------------------------------
----------------------------------------------------------------------------------------------------------------------------------------------------------------------------------------------------------------------------------------------------------------------------------------
------------------S---XXX------------------------------------------------XX-------------------------------------------------------------------------------------------------------------X------------XXX-------------------------------QQSSS-----------------------------S-----X--------
-------------------------------------------------------------------------XX-------------------------------------------------------------------------------------------------------------X-----------------------------------------------------------------------------------------------
------------------X-----------------------------------------------------XXX-----------------------------------------------------XXXX----------------------------------------------------XX----------------------------------------------------------------------------------------------
S-----------------X-------------------------------------SS-------------XXXX-------------------------------------------------------------------------------------------------------------XX-S-----------------------------------------------------------------XXXXX--------------------E-
X----------------XEX----------------------------------S-X------------XXXXXX---------Q-----------------XX----------------------------------------------------------------<>---------XXX--X-----X---------------------------SSSSSS-----SQ---S-----------<-----------------XX-----------<--
X-------------EXXXXX------------------------------------X------------XXXXXXX----------------------EXXX-------------------------------------------------XXX--------------[]-------X--XXX-X----XX----E---------------------------------------------------E-----------------------------[]-
]-------------X-XX--------------------------------------]-----------XXXXXXX----------------------------------------------------------------------------XXX--------------[]-------X--XXXXXX---XX---<>--------------------------------------------------[]-----------------------------X]-
]----------------------------------E--------------------]---------XXXXXXXXX---------------------------------------E---E-E-EEE-E-------E-EE-E--------EXXXX-EE--------EE-E[]--E-------XXXXXX---XX---[]-----EEEE---E--------E-E----------------------E---[]--------------------------------
XXXXXX--XXXXXXX----X-----XXXXXXXXXXXXXXX-XXXXXXXXXXXXXXXXXXXXXX--XXXXXX-XXXX----XXXXXXXX----XXXXXXX---------XXXXXXXXXXXXXXXXXXXXXXXXXXXXXXXXXXXXXXXXXXXXXXXXXXXXXXXXXXXXXXXXXXXXXXXX---XX---XXXXXXXXX--XXXXXXXXXXXXXXXXXXXXXXXXXXXXXXXXXXXXXXXXXXXXXXXXXXXXX----XXXXX-------XXXXXXXXXXX-
