----------------------------------------------------------------------------------------------------------------------------------------------------------------------------------------------------------------------------------------------------------------------------------------
----------------------------------------------------------------------------------------------------------------------------------------------------------------------------------------------------------------------------------------------------------------------------------------
----------------------------------------------------------------------------------------------------------------------------------------------------------------------------------------------------------------------------------------------------------------------------------------
----------------------------------------------------------------------------------------------------------------------------------------------------------------------------------------------------------------------------------------------------------------------------------------
----------------------------------------------------------------------------------------------------------------------------------------------------------------------------------------------------------------------------------------------------------------------------------------
------------SSS---------------------------------------------------------------------------------------------------XX------------------------------------------------XXX--------------------------------SSSSSSSS---SS----------SSX---S???SSS------??S--------S-----------------S----S----
------------------------------------------------------------------------------------------------------------------------------------------------------------------------------------------------------------------------------------------------------------------------------X---------
-------------------------------------------XX---------------------------------------------------------------------------------------------------------------------------------------------------------------------------------------------------------------------------------X---------
-XSSS---------------------E---------------XXXX--------------------------X----------------------------------------------------------------------------------------------------E----------E---------------------------------------X-X--------------------------S---------------XX---------
------------SS-----------Q---------------XXXX---------------------------X----------E---------------------------------------------------------------------XXX----------------<>---------<>----------E---SSSSSSSS------------------------SS---XXX----------XX-QQQ-------------XXXX--------
-------------------------E------------X-XXXXXX-------------------------XX---------<>----------------E-----------------------X---------------------------XXXX----------------[]---------[]---------<>--E--------------------------------------------------XX-[--------------XXXXXX-------
--------------------------------------XXXXXXXX------------------------XXX---------[]---------------<>-----------------------X--------------------------XXXXX----------------[]---------[]---------[]------------------<>---------------------------------XX-]--------------XXXXXX-------
-X-----------------------------------XXXXXXXXX-----------E-EE------E-XXXX---------[]----E----------[]-------------------E---X----------E-EE-----------XXXXXX--------E-------[]---------[]---------[]------------------[]---------------------------EE-E--XX-]-------------XXXXXXX-------
XXXXXXXXXX---XXXXXXXXXXXXX--XXXXXX--XXXXXXXXXXXXXX--XXXXXXXXXXXXXXXX-XXXXXXXXXXXXXXXXXXXXXXXXXXXXXXXXXXXXXXXXXXXXXXXXXXXXXXXXXXX--XXXXXXXXXXXXXXXX--XXXXXXX--XXXXXX-XXXXXXXXXXXXXXXXXXXXXXXXXXXXXXXXXXXXXXXXXXXXXXXXXXXXXXXXXXXX------XX-----X-XXXXXXXXXXXXXXXXXXXXXXXXXXXXXXXXX----XXXX
