----------------------------X-----------------------------------------------------------------------------------------------------------------------------------------------------------------------------------------------------------------------------------------------------------
----------------------------------------------------------------------------------------------------------------------------------------------------------------------------------------------------------------------------------------------------------------------------------------
----------------------------SSSSSSSSSSSSSSSSSSSSSSSSSSSS--------------------------------------------------------------------------------------------------------------------------------------------------------------------------------------------------------------------------------
----------------------------S------S----------------------------------------------------------------------------------------------------------------------------------------------------------------------------------------------------------------------------------------------------
----------------------------S------SSS?-------------------------------------------------------------------------------------------------------------------------------------------------------------------------------------------------------------------------------------------------
----------------------------[S--------------------------SSS--------------------S--------------------------------------------------E------------------------------------------------------SSSS--------XX------------------------------------------------XXXX-------------------E---------
------X--------------------------------------------------------------------------------------------------------------------------<>-----------------------------------------------------------------------------------------------------------------------------------------------------
--------------------------------------------------------------------------------------------------------------------------------XXX-----------------------XX----------------------------------------------------------------------------------------------------------------------------
---------------------------------------------------S---------------------------------------------------------------------------XXXX----------------------XXX-----------------------------------E----------------------------------------------------------------------------------------
--------------XXXXXX--------SSSSS--SSSS---------E------XSQQQ--------------XXX----------------------------SSSSSSS--------------XXXXX----------------------XXX------------XXXXX-------------XX--<>--X------------------------------------------XXXX-------------------------XXXX----------
----------------------------[--S---SSSS--------XX-X----X-------E---------XXXX------------------------------------------------XXXXXX--------E----------XXXXXX-------------------E---EXX--------[]---------------------------------------------XX---------------------------XXXX----------
----------------------------S]-S---SSSS-----<>-XX-----XX------<>---------XXXX----------------------------------------------XXXXXXXX-------<>---------XXXXXXXX-----------------XX--------------[]-[-----------------------------------------XXXX--------------------------XXXXX----------
---------------------E-E----S--SS-ESSS------[]-XX----XXX------[]-------XXXXXX------------E-EE-E------------E-E------------XXXXXXXXX-----E-[]---------XXXXXXXX-------E--E---------------X------[]-[----------------------------------------XXXX----------E-----------------XXXX----------
XXX-XXX-----XXX---XXXXXXXXXXXXXXXXXXXXXXXXXXXXXXXXXXXXXXXXXXXXXXXXXXX--X------------XXXXXXXXXXXXXXXXXXXXXXXXXXXXXXXXXXX---XXXXX--XXXXXXXX-XXXXXXX----XXXXX-------X--X---XXXXXXXX---X---XXXXXXXXXXXXX---XXXXXXXXXX-XXXX------XXXXXXXXXX---XXXXXX--XXXXXXXXXXXXXXXXX---XXXXX----------X---
