----------------------------------------------------------------------------------------------------------------------------------------------------------------------------------------------------------------------------------------------------------------------------------------
------------------------------------------------------------------------------------X-------------------------------------------------------X-------------------------------------------------------------------------------------------------------------------------------------------
------------------------------------------------------------------------------------SSSSSSSSSSSSSSSSSSSSSSSSSSSS------------------------------------------------------------------------------------------------------------------------------------------------------------------------
----------------------------------------------------------------------------------------------------------------------------------------------------------------------------------------------------------------------------------------------------------------------------------------
----------------------------------------------------------------------------------------------------------------------------------------------------------------------------------------------------------------------------------------------------------------------------------------
--------------------------X--XXX----------------------------------------------------------------------------------XX----------------------------------------SSS------------------------X--------------------------------------------------------------------------SSQQSSS---------------
----------------------------------------------------------------------------------------------------------------------------------------------------------------E---------------------EX------------------------------------------------------------------------------------------------
---------------X-------------------------------------------------------------------------------------------------------------------------------------------------E--------------------XXXXXX--------------------------------------------------------------------------------------------
--------------XX------------------------------------------------------------------------------E------SSS----------------------------------------------------E-----------------------X-------------------------------E--------------------------------------------------------------E----
------------XXX--------------------------------------------------Q------E-----------<>---S---<>-----------X---------------------------------->---E---------<>----------E---------------------------------E---------<>----------E------------------------------E--SS--SSS----------<>----
----------XXXXXX------------------------X------------------------------<>-----------[]--<>---[]----------XX----E----------------------------[]--<>---E-----[]----X----<>-----E-----X---------E-----<----<>---------[]---------<>-----------------------------<>-------------------[]----
---------XXXXXXX------------------------X------------------------------[]-----------[]-------[]---X-E--E-XX---<>----------------------------[]--[]---------[]----<>---[]--------------------<>-----[----[]---------[]----<>---[]-----------------------------[]-------------------[]----
--------XXXXXXXX------E-E-----------E---X--------E-E-------------------[]-----------[]--E----[]--XX------XX---[]--E---E-E-E-E---------E-----[]--[]-----E-E-[]----[]---[]-EE-EEE-E-EE--EE----[]-----[-E--[]-----E-E-[]----[]---[]-------------------------EE--[]---------------EE--[]----
XXXXXXXXXXXXXXXXXXXXXXXXXXXXXXXXXXXXXXXXXXXXXX--XXX-XXXXXXXXXXXXXXXXXXXXXXXXXXXXXXXXXXXXXXXXXXXXXXXXXXX--XXXXXXXXXXXXXXXXXXXXXXXXXXXXXXXXXXXXXXXXXXXXXXX---XX---XXXXXXXXXXXXXXXXXXXXXXXXXXXXXXXXXXXXXXXXXXXXXXXX---XXXXXXXXXXXXXXXXXXXXXXXXXXXXXXXXXXXXXXXXXXXXXXXXXXXXXXXXXXXXXXXXXXXXX
