----------------------------------------------------------------------------------------------------------------------------------------------------------------------------------------------------------------------------------------------------------------------------------------
----------------------------------------------------------------------------------------------------------------------------------------------------------------------------------------------------------------------------------------------------------------------------------------
----------------------------------------------------------------------------------------------------------------------------------------------------------------------------------------------------------------------------------------------------------------------------------------
----------------------------------------------------------------------------------------------------------------------------------------------------------------------------------------------------------------------------------------------------------------------------------------
----------------------------------------------------------XEE---------------------------------------------------------------------------------------------------------------------------------------------------------------------------------------------------------------------------
-----------------------------------------------------SXX?--S-------------??SS--------------------------------------------------------------------------------------------------------S--------SSS-----------QQSSSSS--------------XXX-----------------------X------------------------XXXX
----------------------------------------------------------------------------------------------------------------------------------------------------------------------------------------------------------------------------------------------------------------------------------------
----------------------------------------------------------------------------------------------------------------------------------------------------------------------------------------------------------------------------------------------------------------------------------------
----------------------------------------------------------EX---------------------------------------------------------E----------E--------------------------------------------------------------SS---------------------------------------------------------------------------------------
----------------------------------------------------S----XXXXS--------E----------XX---------------------------------<>---------<>------------------------XXX------------SSSS?-------------XXX--------------S?--SSSSS---------X------------------------SSSS----------------------SSSSSS--
----------E-----E---------E------------------------------------E---EXX-----------XX---------------------------------[]---------[]---------------------XXXXXX-------------------E---------XXX---------------------------------X----------------------------------------------------------
-------------------------<>----------------------------------XXX--------X--------XX-------------X-------------------[]---------[]---------------------XXXXXX------------------<>--------XXXX--------------------------------------------------------------------------------------------
---------E]--------------[]---------------------------------------------X---XXX--XX---------E---X--------E----------[]-----E---[]--------------------XXXXXXX--------E--E------[]-------XXXXXX-------------------------------------E--E-EE-E-E----------E-----------E-EE-----------------
XXXXXXXXXXXXXXXXXXX-XXXXXXXXX-XXXXXXXXXXXXXXXXXXXXXXXXXXX-----XX-----------------XX-XXXXXXXXXXXXXXXXXXXXXXXXXXXXXXXXXXXXX-XXXXXXX-XXXXXXXXXXXXXXXX--XXXXXXXX-XXXXXXXXXXXXXXX-XXXXXXXXXXXXXXXXXXXXXXX--XXXXXXXX-XXXXXXXXXXXXXXX--XXXXXXXXXXXXXXXXXXXXXXXXXXXX---XXXXXXXXXXXXXXXXXXXXXXXXX
