----------------------------------------------------------------------------------------------------------------------------------------------------------------------------------------------------------------------------------------------------------------------------------------
----------------------------------------------------------------------------------------------------------------------------------------------------------------------------------------------------------------------------------------------------------------------------------------
----------------------------------------------------------------------------------------------------------------------------------------------------------<>----------------------------------------------------------------------------------------------------------------------------
-----------------------------------------------------------------------------------------------------------------------------------------------SS---------[]----------------------------------------------------------------------------------------------------------------------------
-----------------------------------------------------------------------------------------------------------------------------------------------EE----------]-----E--S-------------------------------------------------------------------------------------------------------------------
-----------------------X-------------------------------------------------------SS-----------------------------------------------------------S-SSSSSSSS---SSS---SSSSSSSSS----SS-SSS-----------SS-SSSS-------------------------------------------------------------SSSSQSSQ--------------S
-------------------------------------------------------------------------------------------------------------------------------X--------------------------------------------------------------------------------------------------------------------------------------------------------
------------------------------------------------------------------------------------------------------------------------------XX---------------------------------------------------------------------------------XX----X----------------------------------------------------------------
--------------------------------------------E--------------------------------------------------------------------------------XXX--------------EE----------------------------------------------------------------------------------------------------------------------------------------
--------------XXX---------------<>-----E---<>-----------SSSS------------------------------------------XX---------------------XXX--------------S?SSSSS----EE--------------------SS---?SS-----------------------------------------------------------------S---------SSSSSSQ---------------
--------------XX-X--------------[]---------[]------E----------------------XX----------------------EXXXX-------------------XXXXXX----------------SSSS----------------------------------------------------------E-----E--------------------------------------------------------------E----
--------------------------------[]---------[]-----<>--------------------XXXX--------------------------X-------------------XXXXXX-----------------SSS--------X-X----------------------------------------------<>-------------------------------------------------------------------<>----
--------------------------------[]---------[]-----[]-------------------XXXXX-------------------------------------E-E----XXXXXXXX--------E--E------------------X-E---------------------------------------EE---[]--------------EE------------------------------------------------EE-[]-X--
XXXXXX---XXXXXX---------XXXXXXXXXXXXXXXXXXXXXXXXXXXXXXXXXXXXXXXXXXXXXXXXXXXXXXXXXXXXXXXXXX--XXXXXXXXXXXXXXXXXXXXXXXXXXXXXXXXXXXXXXXXXX-XXXXXXXX---XXXXXXX---XXXXXXX--XXXXXXXXXXXXXXXXXXXXXXXXXXXXXXXXXXXXXXXXXXXXXXXXXX--XXXXXXX------XXXXXX-XXXXX----XXXXXXXXXXXXXXXXXXXXXXXXXXXXXXXXXX
