X---------------------------------------------------------------------------------------------------------------------------------------------------------------------------------------------------------------------------------------------------------------------------------------
----------------------S-----------------------------------------------------------------------------------------------------------------------------------------------------------------------------------------------------------------------------------------------------------------
SSSSSSSSSSSSSSSSSSSSSSSSSSSS---------------------------------------------------------------------------------------SSSSSSSSSSSSS--------------SSSSSSSSSS--------------------------------------------------------------------------------------------------------------------------------
SSSSSSSSSSSSSSSS-----SSSS--S--------------------------------------------------------------------------------------SSSSSSSS--------------------S---SSSSS---------------------------------------------------------------------------------------------------------------------------------
SSSSSSSSSSSSSSS------SSSS------------XXX---------------------------------------------------------------------------SSSSSSS-------------------------SSSS---------------------------------------------------------------------------------------------------------------------------------
SSSSSSSSSSS--SSS------SSSSSS----------------------------------------------------------------SSS-----------------SSSSSSSSSSS--SSS-------------SSSSSSSSSS---SS------------X-------QQSSSSS-------------X---S??-E?-------SSS--------------SQQQQQ-------------------------------------------X
---S------------------------------------------------------------------------------------------------------------------------------------------------------------------------------------------------------------------------------------------------------------------------------------
------------------------------------------------------------------------------------------------------------------------------------------------------------------------E---------------------------------------------------------------------------------------------------------------
----E------------------SS--------S----------E----------------------------------E---------------------------E-------E-----------------------------------------------E----XXX-------------------------X-XX--------------------------------------------------------------------------------
-SSSSSSSSSS--------E-----------------------<>---------------------------E-----<>---E-----SS--QS-----------<>-----SSSSSSSS----------E--<>-------SSSSSSSS--------E--<>-----------S?S-SSSSS---------X--------------XXX----------<>-------Q---QQQQ-------------------------------------S----
--SSSSSSSSS-------<>-----------------------[]--------->----------------<>-----[]--<>----------------------[]--------SSSSSS--------<>--[]------E-----SS--------<>--[]-----------------------------XXX-------------------------[]------------------------E--------------E-----------------
-SSSSSSSSSS-------[]-----------------------[]--------<]----------------[]-----[]--------------------------[]-------SSSSSS-------X-[]--[]------SS-----S--------[]--[]-----------------------------XX--------------------------X]-----------------------<>-X------------------------------
SSSSSSSSSSS-------[]-----------------E-----[]--------[]----------------[]-----[]----------------------E---[]----------SSS-------X-[]--[]-------------S--------[]--[]-----------------------EE----XX---------------------XXX--XX--------------------EE-[]-[-----------EE-----------------
XXXXXXXXXXXXXXXXXXXXXXX--XXXXXXXXXXXXXXXXXXXXXXXXXXXXXXXXXXXXXXXX-XX-X-XXXXXXXXXXXXXXXXXXXXXXXXXXXXXXXX-XXXXXXXXXXXXXXXXXXXXXXXXXXX--XXXXXXXXXXXXXXXXXXXXXXXXXXXXXXXXXXX--XXXXXXX---XXXXXXXXXXXXXXX-X-----XX-----------------XX-XXXXXXXXXXXXXXXXXXXXXXXXXXXXXXXXXXXXXXXXXXXXXXX-----XXXX
