----------------------------------------------------------------------------------------------------------------------------------------------------------------------------------------------------------------------------------------------------------------------------------------
----------------------------------------------------------------------------------------------------------------------------------------------------------------------------------------------------------------------------------------------------------------------------------------
----------------------------------------------------------------------------------------------------------------------------------------------------------------------------------------------------------------------------------------------------------------------------------------
----------------------------------------------------------------------------------------------------------------------------------------------------------------------------------------------------------------------------------------------------------------------------------------
----------------------------------------------------------------------------------------------------------------------------------------------------------------------------------------------------------------------------------------------------------------------------------------
------------------XX-------------------------------------------------------------------SSSSSSSS-----------------------------------SS-------------------SS----------------------------------------------------------E--------------------------------------------------------XXX---------
--------------------------------------------------------------------------XX--------------------------------------------------------------------------------------------------------------------------------------E--------------------------------------------------------XXXX---------
------------------------------------------------------------------------------------------------------------------------------------------------------------------------------------------------------------------XXXXXX---------------------------------------------------XXXX---------
---XXX--------------------------------------------------------------------------------E---------------------------XXX-------------------------------------------------------------------------------------------X---------------------------------------------------------XXXXX---------
-----------------------------------------X----------------------------------SS--S-SS-------SS----SS----------X--------------XXX---------------E--QQ--S?-----E--------------------------------------------------XX------------------------------X----------------------X--XXXXXX---------
---------------------------------------XXX-------------------------------------------------------------------X-------------------------------<>------------<>---E-----------------------E----------------------XXX-------E------------------XX------------------------X-EXXXXXX---------
--------------------------------------XXXX--------------XX---------------------------------------------------X-------------------------------[]--X---------[]--------------------------<>---------------------XSS-------<>-----[-----------XXX-------------->---------XXXXXXXXX-------XX
------------------------------------EXXXXX-E--------E---XX----------------------------------------------E-E----------------------------------[]------------[]-EE------------EE----E----[]------------EE-EEE-XXXXX-EE----[]--EE-[-----------XXX----------E---EE-E------XXXXXXXXX-------XX
----------------XXXXXXXXXX--XXXXXXXXXXXXXX-XXXXX-----------XXXXXXXX-XXXXXXXXXXXXXXXXXXXXXXXXXXXXXXXXXXXXXXXXXXXXXXX---XXXX-X--XXXXXXXXXXXXXXXXXXXXXXXXXXXXXXXXXXXXXXXXXXXXXXXXXXXXXXXXXXXXXX--XXXXXXXXXXXXXXXXXXXXXXXXXXXXXXXXXXXXXXXXX---XXXXX---XXXXXXXXXXXXXXXXXXXXXXXXXXX------X----
