----------------------------------------------------------------------------------------------------------------------------------------------------------------------------------------------------------------------------------------------------------------------------------------
----------------------------------------------------------------------------------------------------------------------------------------------------------------------------------------------------------------------------------------------------------------------------------------
---------------------------------------------------------------------------------------SSSSSS-------------------SSSSSSSSSSSSSSSSSSSSSSSSSS------------------------------SSSSSSSSSSSSSSSSSSSSSSSSSSSS------------------------------------------------------------------------------------
--------------------------------------------------------------------------------------SSSSSSSSSSS--------------------------------------------------------------------------------------------------------------------------------------------------------------E------------------------
---------------------------------------------------------------------------------------SSSSSSSS-S------------------------------------------------------------------------------------------------------------------------------------------------------------XXXXX----------------------
--XX------------------------S--SSSSSSSS---SS---SSS-----S------------------------------SSSSSSSSSSSSSS----S------S----------------------------X--SSSSSSSSSS-SS-----------S---------------------------------------SS---------------Q---------------------------S----------------SSS--------
------------------------------------------------------------------------------------EE----------------------------------------------------------------------------------------------------------------------------------------------XX--------------------------------------------------
---------------------------------------------------------------------------------------------------------------------------------S----------X-------------------------------------------------------------------------------------------------------------------------------------------
------------------------------E---------------------------------------------------------E------------------E--------------------XSSS--------X-------------------------------------E---------------------------------E-------------------------------------------------------------------
-----------------------S-------?SSSSS----ES----------X---------------------------------?SSSSSSSS----------<>----<>-------E------------X----------SSSSS--?SS------------------S---<>----------------------E---------<>------------------------XXXXXXX--------XXXXX-------------XXXX----X-
---------------------------------------------------E-X--------------------------------E---------------<>--[]----[]-------E-----------XX----E--------------------------X----------[]---------E------X----<>---------[]---E------------------------------------------E---EXXX-------------
--------------------------------------------------<>-X------------------X--X-------------X------------[]--[]----[]----------XXX-<>---XX---<>-------------------------XX-S--------[]--------<>->---XX----[]---------[]---------------------------------------------XX-----------------XX-
--------E---E-----------------------------------E-[]-X------------------------------------------------[]--[]----[]----------XXX-[]---XX---[]--------------------X-X-----S--------[]--------[]-E---XX----[]---------[]------------------------E-------E--E---------[]-------XX---XXX--XX-
XXXXXXXXXXXXXXXXXXXXXXXXXXXXXXXXXXXXXXXXXXXXXXXXXXXXXXXXXXXXXXXXXXXXXXXXXXXXXXXXXXXXXXXXXXXXXXXXXXXXXXXXXXXXXXXXXXXXXXXXXXXX--XXX---XXXXXXXXXXXXXXXXXXXXXX--XXX-XXX--X--XXXXXXXXXXXXXXXXXXXXXXXXXXXX--XXXXXXXXXXXXXXXXXXXXXXXXXX---------XXXXXX---XXXXXXXXXXXX----------------------XXX-
