----------------------------------------------------------------------------------------------------------------------------------------------------------------------------------------------------------------------------------------------------------------------------------------
X---------------------------------------------------------------------------------------------------------------------------------------------------------------------------------------------------------------------------------------------------------------------------------------
------------------------------------------------------------------SSSSSSSSSSSSSSSSSS------------------------------------------------------------------------------------------------------------------------------------------------------------------------SSSSSSSSSSSSSSSSSSSSSSSSSSSS
----------------------------------------------------------------------------------------------------------------------------------------------------------------------------------------------------------------------------------------------------------------------------------------
----------------------------------------------------------------------------------------------------------------------------------------------------------------------------------------------------------------------------------------------------------------------------------------
----------------SSS-----------------------------------------------------XXX-----------------------------------------------------------------------------------X-----------X----------------------------------------------------------------------------XX-------------------------------
---------------X----E--------------------------------------------------XXXX----------------------------------------------------------------------------------XX-------------------------------------------------------------------------------------------------------------------------
---------------------E---------------------XXX-------------------------XXXX--------------------------------------------------------------------------------XXXX-------------------------------------------------------------------------------------------------------------------------
----------------XE--->------------------------------------------------XXXXX-------------------------------------------------------------------------------XXXXX-----------------------------------------------E-------------------------------------------------------------------------
<>---E------XE-XX-----------------------------------------------Q-XX-XXXXXX---X-------------------------------------------------------SS------------------XXXXX---------------------X--------------------S---<>-----E-------------------------XXX--------------S----SQS-----------------
[]--<>---X--X-XXX----X-----E---------------------E------>---------X-EXXXXXX---X-------------------------------------------E-----E------------------------XXXXXX--------------------XXX-----------------------------<>---E------------------------------------------------------X--------
[]--[]------XXXXX----XX---<>---------------X----<>-----[]--------XXXXXXXXXX---X------------------------------------------<>-----------------------------XXXXXXX--------------------XXX-----------------------[-----[]--<>---------------------------------------------------<>-XX-------
[]--[]------XXXXX----X----[]-EE-EE----EE--EE----[]-----[EE-E-------XXXXXXXX---X--------------E-----------------------E---[]---------------------------XXXXXXXXX---------------E-EXXXX---------E-EE-E---------E-----[]--[]----X-X----------------------------E-----E---------[]-X--------
XXXXXXXXXXXX---XX---XXXXXXXXXXXXXXXXXXXXXXXXXXXXXXXXXXXXXXXXXXXXXXXXXXXXXXXX---XX--XXXXXXXXXXXXXXXXXXXXXXXXXXXXXXXXXXXXXXXXXXXXXXXXXXXXXXXXXXXXXXX-XXXXXXXXXXXXX----XXXXXXXXXXXXXXXXXXXXXXXXXXXXXXXXXXXXXXXXXXXXXXXXXXXXXXXXXXXXXXXXXX--XXXXXX-----X-----XXXXXXXXXXXXXXXXXXXXXXXXXXXXXXX
