----------------------------------------------------------------------------------------------------------------------------------------------------------------------------------------------------------------------------------------------------------------------------------------
---------------E----------------------------------------X-------------------------------------------------------------------------------------------------------------------------------------------------------------------------------------------------------------------------------
--------------<>----------------------------------------SSS-----------------------------------------------------------------------------------------------------------------------------------------------------------------------------------------------------------------------------
--------------[]------------------------------------------------------------------------------------------------------------------------------------------------------------------------------------------------------------------------------------------------------------------------
---EE---------[]-----------------------------------------------------------------------------------------------------------------------------------------------------------------------------------------------------------------------------------------------------XXX----------------
X--SSS??SSS------??SS-------X-------QQSQSQS-------------X----------------------------------------------------XXX----------------XX-------------------------XSSS-----------------------------------------------QQQQQ---------------------------------------------------------------------
-------------------------------------------------------------------------------------------------------------------------------XXX-------------------------X----E-----------------------------------------------------------------------------------------------------------------------
----------------------------E------S------------------------------------------------------------------------------------------XXXX-------------------------XX----E----------------------------------------------------------------------------------------------------------------------
X-XX----------------------?-XXS----SS-----------------E-----------E------------E---------------------------------------------XXXXX------------------------XXXE---------------E----------E-----------------SS--------------------------------------------------------S-------------------
---?XS-SS---XXX----------<>--------S?-QSSSSS---------<>------E---<>-----E-----<>---E-----------------------------E------Q-XXXXXXXX----E------E--<>-----X---XX---------------<>---------<>----------------------SSQQQ---------<E-------Q---------E-------------------------QQ---------SS-
-----------------------E-[]--------------------------[]-----<>---[]----<>---E-[]--<>----------------------------<>-------XXXXXXXXX---XX-----<>--[]-----XX-XXX----X-----E----[]---------[]------------------------------------[]----------------<>-----------------E---E-----------------
----------------------<>-[]--------------------------[]-----[]---[]----[]--<><[]--[]----------------------------[]-------XXXXXXXXX---XX-----[]--[]--------XXX----X----<>----[]---------[]------------------------------------[]----------------[]--------------------<>-----------------
--------------------E-[]-[]--------------------E-----[]-----[]---[]--E-[]--[][[]--[]----------E-----------------[]-E-----X-XXXXXXX---XX----X[]--[]-----E-XXXX----X----[]----[]---E-----[]-E----------------------------E-----[]----------------[]--------------------[]-----------------
XXX--XXXX-----------XXXXXXXX--XXXXXXXXXXXXXXXXXXXXXXXXXX-XXXXXXXXXXXXXXXXXXXXXXXXXXXXXXXXXXXXXXXXXXXXXXXXXX-XXXXXXXXXXXXXXXXXXXXXX--XXXXXXXXXXXXXXXXXXXX--XXX----XXXX-XX-XXXXXXXXXXXXXXXXXXX-----XXXXXXXXXXXXX-XXXXXXXXXXXXXXXXXXXXXXXXXXXXXXXXXXXXXXXXXXXXXXXXXXXXXXXXXXXXXXXXXXXXXXXXX
