----------------------------------------------------------------------------------------------------------------------------------------------------------------------------------------------------------------------------------------------------------------------------------------
----------------------------------------------------------------------------------------------------------------X-----------------------------------------------------------------------------------------------------------------------------------------------------------------------
----------------------------SSSSSSSSSSSSSSSSSSSSSSSSSSSS--------------------------------------------------------------------------------------------------------------------------------------------------------------------------------------------------------------------------------
----------------------------------------------------------------------------------------------------------------------------------------------------------------------------------------------------------------------------------------------------------------------------------------
----------------------------------------------------------------------------------------------------------------------------------------------------------------------------------------------------------------------------------------------------------------------------------------
-----SSSSSSSSS-------S--SSSS---------------------------------------------------------XXX------------------------X----------SS----------------XXXX-----------------------X---------------------XXXX--------------------------------------------------------------------------------------
----------------------------------------------------------------------------------------------------------------------------------------------------------------------------E-----------------------------------------------------------------------------------------------------------
X--------------------------------------------------------------------------------------------------------------------------------------------------------------------------------------------------------------------------------------------------------------------------XXXXX--------
--------------------------------------E------------------------------------------------------------------------------E----------E-------------------------------------------------------------------------------------------------------------------------------------------------------
-----SSSSSSSQQ-----------------S-----<>----------------X-------------------------------------------------------------E---------<>---------------------------------------X-----------------EX--------------------------------------------------------------------------------------------
-----------------------------SES-----[]--------<>------X------------------------------------------------------------<>---------[]---------------------------------------X-------------EXXXXX--------------------X-----------------------------------------------------------E----E------
----------------------------SS?S-----[]--------[]------X---------------XXX------------------------------------------[]---------[]---X<>----X----------------------------X---------------------------------------X----------------------------------------------------------<>----------[
-------------------EE-------S-S------[]--------[]------X--------------X-XX----------------------E------------EE-----[]-------E-[]---][]----X--------E---E-------------------------------------------------------X----------E----------------------------------E-EE----E----E]--------E-E
XXXXXXXXXXXXXXXXXXXXXXXXXXXXXXXXXXXXXXXXXXXXXXXXXXXXXXXXXXXXXXXXXXXXXXXXXXXXXXXXXXXX---XXXXXX--XXXXXXXXXXXXXXXXX--XXXXXXXXXX-XXXX---XXXXXXXX-----XXXXXXXXXXXX----XXXXXXXXXX-----XXXXX-------------------XXXXXXXXXX-------XX-XXXXXXXXXXXXXX---XXXXXXXXXXXXXXXXXXXXXXXXXXXXXXXXXXXXXXXXXXX
