----------------------------------------------------------------------------------------------------------------------------------------------------------------------------------------------------------------------------------------------------------------------------------------
------------------------------------------------------------------------------------------------------------------------------------------------------------------------X---------------------------------------------------------------------------------------------------------------
------------------------------------------------------------------------------------SSSSSSSSSSSS-SSSSSSSSSSSSS--SSSSSSSSSSSSSSSSSSSSSSSSSSSS----------------------------SSSSSSSSSSSSSSSSSSSSSSSSSSSS------------------------------------------------------------------------------------
----------------------------------------------------------------------------------------------------------------------------------------------------------------------------------------------------------------------------------------------------------------------------------------
----------------------------------------------------------------------------------------------------------------------------------------------------------------------------------------------------------------------------------------------------------------------------------------
Q------------------------------------------------------------------------E-----------------------------------------------------------------------------------------------------------------------------------------------------------SSSQQQQ--------------------------------------------
---XXX-------------------X----------------------------------------------XXXXXX------------------------------------------------------------------------------------------------------------------------------------------------------------------------------------XX-------------XXXX---
----------------------------------------------------------------------------------------------------------------------------------------------------------XXX---------------------------------------------------------------------------------------------------------------------------
-----------------------------------------------------------------------------------------------------SSS------------------E-------------------------------------------------------E------SSS--------------------------------------------------------------------------------------------
-------------XXXXX----------------------------------------------------------------SS--------QQ---------------------S-----<>--------------------------------------------->----S---<>-----E---------------------------------------------SSS-QSQQ------------E----------------XXXX---------
------------XX------------------------E-----E------------E------------------------------------------------X--------------[]--------<-------X-----E---------------E---------------[]---------?-X----X--------------------------E------------------------E-<>---XX------------------------
------------XX-----------------------<>-----------------XXXX------------------------<>------------X-<>-E--X--------------[]--------[]------X----<>---------<>---<>-----[<>-------[]-----E--<><>---XX-------------------------<>-----------------------[]-[]-----------------------------
------------XX-------E--E--------E---[]-----------------XX--------------------------[]-----------XX-[]----X-----------E--[]--------[]--------E--[]-----E--E[]---[]-----[[]--E----[]--E-----[][]---XX-------------------------[]--------------------E--[]-[]-----------------------------
--------XXXXXX----XXXXX-XXXXXXXXXXXXXXXXXXXXXXX---XXXXXXXXX--XXXXXX---XX-------XXXXXXXXXXXXXXXXXXXXXX--XXXXXXXXXXXXXXXXXXXXXXXXXXXXX--XX-XXXXXXXXXXXXXXXXXXXXXXXXXXXXXXXXXXXXXXXXXXXXXXXXX-XXXXXXXXXXXXXXXXXX-XXXXXXXXXXXXXXXXXXXXXXXXXXXX-XXXXXXXXXXXXXXXXX----------------------------
