----------------------------------------------------------------------------------------------------------------------------------------------------------------------------------------------------------------------------------------------------------------------------------------
---------------E----S------S----------------------------------------------------------------------------------------------------------------------------------------------------------------------------------------------------X-------------------------------------------------------
----SSS-------<>----SS-----S--------------------------------------------------------------------------------------------------------------------------------------------SSSSSSSSSSSSSSSSSSSSSSSSSSSS----------------------------SSSSSSSSSSSSSSSSSSSSSSSSSSSS----------------------------
----SSSSSSSSSSS]----SS---SSS------------------------------------------------------------------------------------------------------------------------------------------------------------------------------------------------------------------------------------------------------------
-----SSSSS--S-SS----SS----SS------------------------------------------------------------------------------------------------------------------------------------------------------------------------------------------------------------------------------------------------------------
---SSSSSSSSSSSSS----SS-----S------SQQQQQQ---------------------------SS------------------------QQQQQ---------SSSS-------QQQQQ-----------------------SSSSS-----------------SSS----S--------------------XXX----------------------XX--------------------------------------------------------
EE--------------------------------------------------------------------------------------------------------------------------------------------------------------------------------------------------------------------------------------------------------------------------------------
X---------------------------------------------------------------------------------------------------------------------------------------------------------------------------------------------------------------------------------------------------------------------------------------
X----------------------E---------------------------E-----XXXXX--------------------E-----------------E-------------------------------------------------E------------E--------------E------------SS-------------------------------E---------E-------SS------------------------------------
----SSSSSSSS-S--------<>-X----E--SSSSSSSQ---------<>----------------SS-----------<>-----<QQ---QQQ--<>-----------------S---QQQ--------------------SS--SS-----------<>-------SS--SSSS--------------------------------------SSSSSSQ>----S---<>---------------------------------------------
----------------------[]-X---<>-------------------[]-----------------------------[]--<>------------[]----------------------------------E-----<>-------S-----------[]-------S----SSS--------<>--------------------------------------------[]---------?------X----------------------------
-----X----------------[]-X---[]-------------------[]-----------------------------[]--[]--X---------[]---------------------------------<>-<---[]-------S-----------[]-------S---SSSS--------[]-------------------X---------------SS-------[]-----E--<><>---XX----------------------------
-------------------EE-[]-X---[]----------------E--[]----XX-----------------------[]--[]------------[]-EE---------------------------E--[]-[---[]------E--------E---[]----E--SS-ESSSS--------[]------------EEEE---E--------EEE----S]-------[]--E-----[][]--XXX----------------------------
XXXXXXXXXXXXXXXXXXXXXXXXXXXXXXXXXXXXXXXXXXXXXXXXXXXXXXXX-XXXXXXX-----XXXXXXXXXXXXXXXXXXXXXXXXXXXXXXXXXXXXX-XXXXXXXXXXXXXXXXXXXXXXXXXXXXXXXXXXXXXXXXXXXXXXXXXXXXXXXXXXXXXXXXXXXXXXXXXXXXXXXXX-----XXXX---XXXXXXXXXXXXXXXXXXXXXXXXXXXXXXXXXXXXXXXXXXXXXXXXXXXXXXXXXXX---XXXXXXX--XXXXXXXXX
