--------------------------------------------------------------------------------------------------------------------------------------------------------------------------------------------------------------------------------X-------------------------------------------------------
----------------------------------------------------------------------------------------------------------------------------------------------------------------------------------------------------------------------------------------------------------------------------------------
----------------------------------------------------------------------------------------------------------------------------------------------------------------------------------------------------SSSSSSSSSSSSSSSSSSSSSSSSSSSSSSSSSSSSSSSSSSSSSSSSSSSSSSSS----------------------------
--------------------------------------------------------------------------------------------------------------------------------------------------------------------------------------------------------------------------------SSSSSSSSSSSSSSS--------S--SS----------------------------
--------------------------------------------------------------------------------------------------------------------------------------------------------------------------------------------------------------------------------SSSSSSSSSSSSSS------------S----------XXX----------------
--SSSSSSSS---SSS------SSSSSS-------------------------------------------------------------SSSSSSSS-----------SSSS-------------------------------------------------------------------------------------S-----SS--------------------SSSSSSSSSS--S------------SS----------------------------
------------------------------------------------------------------------XXXX----------------------------------------------------------------------------------------------------------------------------------------------------ES-S----------------------------------------------------
------------------------------------------------------------------------------------------------------------------------------XX----------------------------------------------------------------------------------------------------------S---------------------------------------------
---E------------------------------------------------------------------------------E------------------------------------------XXXX---------------------------E--------------------------------------------------------------E--------E-----S------------SS--------S----------E-----------
--SSSSSSSS---------E-------------------------------------X------------------------SS-----SSSSSSS-----------------------------XXX-----------------E---------<>----------ESQQQ--------------XXX-------SSSSS--SS----------XX-<>---X---SSSSSSSSS--------E------X----E------E--QQQ---------E-
-------S----------<>------------------E---------------E--X----------------------------------------------------------------XXXXXXX---------------<>---------[]------E--<>-------E---------XXXX--------------S---------X-XX-[]---X-SSSSS--SSS--------<>------X--------------------------E-
-----X------------[]-----------------<>--------------<>-XXX--------------------------------------------------------------XXXXXXXX---------------[]---------[]-----<>--[]------<>--------XXXXX-------------<>--------XXXXX-[]---XSS?SSSSSSSS--------[]------X-------------------------[]-
------------------[]-----------------[]--------------[]-XX--------------------------------------------EE----------------XXXXXXXXXX------E-------[]---------[]-----[]--[]------[]-------XXXXXX------X]-----[]-------XXXXXX-[]--XXSSSSSSSSSSS--------[]------X---------E---------E-----[]-
XXXXXXXXXXXXXXXXXXXXXXXXXXXXXXXXXXXXXXXXXXXXX-------XXXX-----XXXXXX---XX------XXXXXXXXXXXXXXXXXXXXXXXXXXXXXXXXXXXXXXXXXXXXXXXXXXXXXXXXXXXXXXXXXXXXXXXXXXXXXXXX----XXXXXXXXXXXXXXXXXXXXXXXXXXXXXXXXXXXXXXXXXXXXXXXXXXXXXXXXXXXXXXXXXXXXXXXXXXXXXXXXXXXXXXXXXXXXXXXXXXXXXXXXXXXXXXXXXXXXXX
