----------------------------------------------------------------------------------------------------------------------------------------------------------------------------------------------------------------------------------------------------------------------------------------
----------------------------------------------------------------------------------------------------------------------------------------------------------------------------------------------------------------------------------------------------------------------------------------
--------------------------------------------------------SSSSSSSSSSSSSSSSSSSSSSSSSSSS----------------------------------------------------------------------------------------------------------------------------------------------------------------------------------------------------
--------------------------------------------------------SSSSSSSSSSSSSSS-----------SS----------------------------------------------------------------------------------------------------------------------------------------------------------------------------------------------------
--------------------------------------------------------SSSSSSSSSSSSSSS-----------SS---------------------------------------------------------XXXXXXX--------------------------------------------------------------E---------------------------------------------------------------------
--------------------------XX-----------------------------SSSSSSSSSS--SSS----------SS----------------------S-SS------------------------SSS---------------------SS--SSS---------------------------------------------------------------------------------------------------?S--------------
---------------------------------------------------------S-----------------------------------------------------------------------------------------------------------------------------------XXXXX------XXXX-------------XXXXX------------------------------------------------XX--------
------------------------------------------------------------------S---------------------------------------------------------------------------------------------------------------------------------------------------------------------------------------------------------------------
------------------------------------------------------------E-----S------------SS----XXXX---------------------------------------------------------------------------------------------------------------------------------------------------------------------------------------------E-
--------------------SSSSSSSQ-------------------------------SSSSSSSSS-------E-------X------------SSS-------------QQQ-------------------------XXXX--------------XXXX----X----------------XXX------------------------XXXXX----------------------------------SSS-X-----------------------QQS
----------------------------------------X----------------SSSSSSSSSS-------->-------X------------------------------------------EXXXXX---------------E---EXXXXX--X---------------------------------------------------------------------------------------------X--------------------------
---------------------------------------XXX---------------SSSSSSSSSS-------[]]------X---------------------------------------------XX---------------X>-----------X----------XX--------------------------------------------------------------------------------XX--------------------------
-------EE-E----------E-E------------EXXXX---------E-E---SSSSSSSSSSS-------[]]----XXX--------------------------------------------------------------[]-------X---------------------------------------------------------------------------E--------------------XXX----E-E------------------
X-XXXXXXXXXXXXXXXXXXXXXXXXXX--XXXXXXXXXXXXXXXXXXXXXXXXXXXXXXXXXXXXXXXXXXXXXXXXXXXXXX---XXXXXXXXXXXXXXXXXXXXX----XXXXXXXXXXXXXXXX-X-------XXXXXX------XXX---X-XXXXXX--XXX---------XX-----------------XX---X------XX-------XX-X-XXXXXXXXXXXXXX-XXXXXXXXXXXXXXX-XXXXXXXXXX-XXXXXXX-XXXXXXXX
