----------------------------------------------------------------------------------------------------------------------------------------------------------------------------------------------------------------------------------------------------------------------------------------
----------------------------------------------------------------------------------------------------------------------------------------------------------------------------------------------------------------------------------------------------------------------------------------
---------------------------------SSSSSSSSSSSSSSSSSSSSSSS--------------------------------------------------------------------------------------------------------------------------------------------------------------------------------------------------------------------------------
----------------------------------------------------------------------------------------------------------------------------------------------------------------------------------------------------------------------------------------------------------------------------------------
----------------------------------------------------------------------------------------------------------------------------------------------------------------------------------------------------------------------------------------------------------------------------------------
-XXX------------------------SSS----------------------------------------X-----------------------------------------------------------------------SSSSSSSS------------SSSSSE-----E---------------------------SSSSSS------------SSSS----------------------------X-------QQSSSS--------------
----------------------------------------------------------------------XX---------------------------------------------------------------------------------------------------XXXXXX-------------------------------------------------------------------------------------------------------
----------------------------------------------------------------------XX----------------------------------------------------------------------------------------------------------------------------------------------------------------------------------------------------------------
--------------------------------------------------------------------XXXX-------------------------------------------------------------------------------------------------------------------------------------------------------------------------------------XX-------------------------
----------------------SSSSSSSSSSS-------------XXX------X-----------X--XX------------------------X--------------------------------------------------SS-------------------X-------------XXXXXSS------------SSS-SS---------------------------------E------------------S?--SSSSS---------<>-
-----------------------------------E---------XXXX------X----------XXXXXX-----E-----------------XXX---------------------------------------------------------------------------------------------------------------------------------------------<>------------------------------------[]-
----------------------------------<>--------XXXXX------X----------XXXXXX-----X-----------------XXX---------------------------------------------------------------------------------------------------------------------------------------------[]------------------------------------[]-
-----EEEE---E--------E-E----------[]-------XXXXXX----XXX-E-EE---XXXXXXXX-----X--------------EX-XXX-------EE-EE-E------------EE---------E----------------------E------------------------------E------------------------EE-----------------------[]------------------------------E-----[]-
XXXXXXXXXXXXXXXXXXXXXXXXXXXXXXXXXXXXXXXXXXXXXXXXXXXXXXXXXXXXXXXXXXXXXXXXX-XXXXXXXXXXXXXXXXXXXXXXXXXXXXXXXXXXXXXXXXXXXXXXXXXXXXXXX----X--XXXXXXXXXXXXXXXXXXXXXXXXXXXXXXXX------------XXX---XXXXXXXXXXXXXXXXXXXXXXXXXXXXXXXXXXXXXXXXXXXXXXXXXXXXXXXXXX--XXXXXXXXXXXXXXXXXXXXXXXXXXXXXXXXX-
