----------------------------------------------------------------------------------------------------------------------------------------------------------------------------------------------------------------------------------------------------------------------------------------
----------------------------------------------------------------------------------------------------------------------------------------------------------------------------------------------------------------------------------------------------------------------------------------
------------------------------------------------------------------------------------------------------------------------------------------------------------------------SSSSSSSSSSSSSSSSSSSSSSSSSSSS-------------------------------------------------------------SSSSSSSSSSSSSSSSSSSSSSS
--------------------------------------------------------------------------------------------------------------------------------------------------------------------------SSSSSSSSS-----------------------------------------------------------------------------------------------------
------------------------------XXXXXX----------------------------------E---------------------------E--------------------------------------------------XXX------------------SSSSSSSSS---------------S-------------------------------------------------------------------------------------
------------------------XXXX-----------------SSSSSSSSS------------------------------------------------------------------------------------------------------------------SSSSSSSSSSS--SSS----------SS----------------------------------------?SS-----------------------------------------
----------------------------------------------------------------------------------------------------------------------------------------------------------------------------------------------------------------------------------------------------------------------------------------
----------------------------------------------------------------------------------------------------------------------------------------------------------------------------------------------------------------------------------------------------------------------------------------
--------------------------------------------------------------------------------------------------------------------------------------------------S------------------------E------------------------------------------------------------------------------XX------------------X---------
---------------------S-SS----XXXX---------X---XXXX-------------------------SSSSSSS-Q-----------------------------------------------------S----------------QQ----------E--SSSSSSSSSS--------E---------------------------------SS--X-------------------------SSS---------------XX---------
-----------------------------------E---EXX------------------------------------------------------X--------------------------------------------------------------------<>---SSSSSSSS--------<>------------------E------------------X------------------------------------------XXXX--------
-----------------------------------X--------------------------------------------------X---------X--------------------------------------------------------------------[]---SSSSSSSS--------[]-----------------<>-----------------XX-----------------------------------------XXXXX--------
-------------------------------------------X--------------------E---EE-------E-E------------E---XE-------E-E------E--E-EE-E-E----------E-EE----------E---------------[]----SSSSSSS--------[]------XX-------E-[]-----------------XXX----E--------------------]-----E-------XXXXXX--------
XXXXXXXXXXXXXXXXXXXXXXXXXXXX---------------XXXXXXXXXXXXX-----XXXXXX-XXXXXXXXXXXXXXXXXXXXXXXXXXXXXXXXXXXXXXXXXXXXXXXXXXXXXXXXXXXXXXXXXXXXXXXXXXXXXXXXXXXXXXXXXXX-XXXXXXXXXXXXXXXXXXXXXXXXX--------XX---XXXXXXXXXXXXXXXXX---XXXXXX---XXXXXXXX-XXXXXXXXXXXXXXXXXXXXXXXXXXXXXXXXXXXX---XXXXX
