----------------------------------------------------------------------------------------------------------------------------------------------------------------------------------------------------------------------------------------------------------------------------------------
----------------------------------------------------------------------------------------------------------------------------------------------------------------------------------------------------------------------------------------------------------------------------------------
------------------------------------------------------------------------------------------------------------------------------------------------------------------------------------------------------------------------------------------------------------SSSSSSSSSSSSSSSSSSSSSSSSSSSS
----------------------------------------------------------------------------------------------------------------------------------------------------------------------------------------------------------------------------------------------------------------------------------------
----------------------------------------------------------------------------------------------------------------------------------------------------------------------------------------------------------------------------------------------------------------------------------------
---------------------------X----------------S-----------------------------X------------------------------------------------------------XXX------------------------SSS------S------------------------------------------------------------------------------------------------------------
-------------------------------------------------------------------------XX-------------------------------------------------------------------------------------------------------------------------------------------------------------------------------------------------------------
--------------------------------------------X----------------------------XX-------------------------------------------------------------------------------------------------------------------------------------------------------------------------------------------------------------
-------------------------------------------XX-----------SS--------------XXX-------------------------------------------------------------------------------------------------------------------------------------------------------------------------------------------E-----------------
---------------Q-------S-----E-------------XX-----------XQ--------------XXXX---------------------------------------------------XXXXSSS------XQQQ--------------EXXX------------------------------------------------QQ----------E--------------XXXX--------------S----S<S-----------------
----------------------------<>-------X----XXX----X------X-------------XXXXXXX-X---------------------E----------------------------------------------------XXXXXXXX------------------------------------------------------------<>------------XXXX----------------S-----S---------<>-------
----------------------------[]------------XXX----X------]-------------XXXXXX-----------------------<>----------------------------------------------------------X--------------------------X----------------------------------[]-----------XXXXX----------------S-----[]-----<>-[]-------
---------E------------------[]-EE------E-XXXX----X------]-------------XXXXXX------------EE----E----[]----------E--------------------------------------------------------------------------X------------------E---------------[]----------XXXXXX---------E---E-----E--S------[]-[]-------
XXXXXXXXXXXXXXXXXXXXXXXXXXXXXXXXXXXXXXXXXXXXXXXX---XXXXXXXXXXXXX-XXXXXXX-X-X----X---XXXXXXXXXXXXXXXXXXXXXXXXXXXXXXX-----XX--XXXXXXXXXXXXXXXXXXX-XX--XXXXX-------------XXXXXXXXXXXXXXXXXXXXXXXXXXXXXXXXXXXXXXXXXXXXXXXXX--XXXXXXXXXXXXX---XXXXX-----X-X--X---XXXXXXXXXXXXXXXXXXXXXXXXXXXX
