----------------------------------------------------------------------------------------------------------------------------------------------------------------------------------------------------------------------------------------------------------------------------------------
--------------------------------------------------------------------------------------------------------------------------------------------------------------------------------------------------------------------------------------------------------------------------------SS-----S
--------------------------------------------------------------------------------------------------------------------------------------------------------------------------------------------------------------------------------------------------------------SSSSSSSSSSSSSSSS--SSSS-SSS
-----------------------------------------------------------------------------------------------------------------------------------------------------------------------------------------------------------------------------------------------X--------------SSSSSSSSSSSSSS----SSSSSSSS
-----------------------------------------------------------------------------------------------------------------------------------------------------------------------------------------------------------------------------------------------X------------]-SSSSSSSSSSSSSS----SSSSSSSS
--XX-------------------------------------------------------S-------------------SSSS------------------------------------------------------------------------------------------------------------------XXXXX-------------------------------------X-S-----------SSSSSSSSSSSSSSS----SS----SS
------------------------------------------------------------------------------------------------------------------------------------------------------------XXXX------------------------------------------------------------------------------XX------------ES--------------------------
----------------XXXX-----------------------XXXXX--------------------------------------------------------------------------------------------------------------------------------------XX-----------------------------------------------------XXXX----E----------------------------------
-------------------------------------------------------------------------------------------------------------------------------------------------------------------------------------XXX----------------------------------------------------XXXXXE--<>----------E------------------E----
--------------------------------------------------------S?SSS-----------------------------S-----------------------------------------------Q--------------------------SSS-------------XXX-----------------------------------------E---------XXXXXX--------------?SSSSSSSS-------E--<>----
-------------------------------------------------E------------------------X--------------------------------E----------E---E--------------->---------------------------------------XXXXXX------------------------X---------------<>---E----XXXXXXX----X-----<--E-SSSS----------<>--[]----
--------------------------------------------------------------------------X-------------------------------<>-------------<>--------------[]-XXX----------------------------------XXXXXXX------------------------X---------------[]--<>-----XXXXXX---<>-----[-SSSSSSS----------[]--[]----
--E-----E-EEE------------E-E--E-EEE-E-EEE-EE------E-EE-E------------------X---------------------------E---[]-------------[]--------------[]-XX------E---------------------------XXXXXXXX--------E-----E--EE-E---X---------EE-E-E[]--[]---X-XXXXXX---[]-----[---------E--------[]E-[]----
XXXXXXXXXXXXXXXXXXXXXXXXXXXXXXXXXXXXXXXXXXXXXXXXXXXXXXXXXXXXXXXXXXXXXXXXXXXXXXXXXXXXXXXXXXXXXXXXXXXXXXXXXXXXXXXXXXXXXXXXXXXXXXXXXX----XXXXXXXXXXXXXXXXX-XXXXXXXXXXXXXXXXXXXXXXXXXXXXXXXXXXXXXXXXXXXXX-XXXXXXXXXXXXXXXX--XXXXXXXXXXXXXXXXXXXX--XXXXXXXXXXXXXXXXXXXXXXXXXXXXXXXXXXXXXXXXXX
