----------------------------------------------------------------------------------------------------------------------------------------------------------------------------------------------------------------------------------------------------------------------------------------
----------------------------------------------------------------------------------------------------------------------------------------------------------------------------------------------------------------------------------------------------------------------------------------
----------------------------------------------------------------------------------------------------------------------------------------------------------------------------------------------------------------------------------------------------------------------------------------
---------------X----------------------------------------------------------------------------------------------------------------------------XE------------------------------------------------------------------------------------------------------------------------------------------
---------------X---------------------------------------------------------------------------------------------------------------------------->XXXXXX-------------------------------------------------------------------------------------------------------------------------------------
---------------X------------------------------------------------------------------------------------------------SSSSS--SS--------------SSS--S-----------------------------XX------------------------------------------------------------------------------XX-------------------------XXX
--------------XX------------------------------------------------------------------------------------------------------------------------------------------------------------------------------------------------------------------------------------------------------------------------
-------------XXX------------------------------------------------------------------------------------------------------------------------------------------------------------------------------------------------------------------------------------------------------------------------
------------XXXX------------------------------------------------------------------------------------------------------------------------------------------------------------------------------------------------------------------------------------------------------------------------
-----------XXXXX---------------------------X----------------------------E----------------E----------E-------------SSS-----------------------XQQQ--------------EXXX----XX----------------------SSSSSS--------------------------------------------------SS-------------------Q-------SS---
----------XXXXXX-----E---------------------X---------------------------<>------E--E-----<>---------<>---E-------------------------X----------------E-----XXXXXXXX----------------------------------------------------------E--E------E----------E----E----------------------------------
---------XXXXXXX-----X--------------------XX---------------------------[]-----<>--------[]---------[]---------XX----------------X-X---------------<>----------XXX-----XX-XX---------X-------------------------------------<>-<-----------------<>---------------------------------------
-E-EE---XXXXXXXX-----X--E--------------E--XX---------------------------[]-----[]--------[]---------[]---------XX------------------X---------------[]-------X---XX------X-----EEEE---X--------EEE--------------------------[]--]-----EE----E----[]-----E--------------E------------------
XXXXXXXXXXXXXXXXXXXXXXXXXXXXXXXXXXXXXXXXXXXXXXXXXX--XXXXXXXXXXXXXXXXXXXXXXXXXXXXXXXXXXXXXXXXXXXXXXXXXXXXXXXXXXXXXXXX--XXXXXXXXXXXXXXX----XXXXXX--XXXXXXX----------------XXXXXXXXXXXXXXXXXXXXXXXXXXXXXXXXXXXXX--XXXXXXXXXXXXXXXXXXXXXXXXXXXXXXXXXXXXXXXXXXXXXXXXXXXXXXXXXXXXXXXXXXXXXXXXX
