----------------------------------------------------------------------------------------------------------------------------------------------------------------------------------------------------------------------------------------------------------------------------------------
----------------------------------------------------------------------------------------------------------------------------------------------------------------------------------------------------------------------------------------------------------------------------------------
-------------------------------------------SSSSSSSSSSSS-SSSSSSSSSSSSSSSSSSSSSS-SS-------------------------------------------------------------------------------------------------------------------------------------------------------------------------------------------------------
----------------------------------------------------------------------------------------------------------------------------------------------------------------------------------------------------------------------------------------------------------------------------------------
--------------------------------------------------------------------------------------------------------------------------------------------------------------------------------------------------------------------------------------------------------------------------E-------------
-----------------------------SSS----S-----------------------------------X-----------X---SSSSSQSSSS-------------S-----------SS--------------------------------XX---------------------------------------XX--------------------------------------------------------------------------------
------------------------------------------------------------------------X------------------------------------------------------------------------------------XX-------------------------------------------------------------------------------------------------------------------------
-------------------------------------------------------------------------S----------------------------------------------------------------------------------XXX-------------------------------------------------------------------------------------------------------------------------
------------------------------------------------------------------------XSSS----------------------------------------------------E------------S-------------XXXX-------------------------------------------------------------------------------------------------------------------------
-------------------------QQ---SSS---S-------------------<>----------X---X-----X-----------SS?S-SSSS----------X-------E---------<>-------------------------XXXXX----------------------------------S------------------------------------------------------------------------------SS---SSS
------E---E------------------------------------E--------[]-------E--X---X----XX----E-------------------------XX-----<>---------[]---E------E-------------XXXXXX-------------------E--------------------------------------------------E----------E---------------------------------------
---------<>---------------------------------X-XX--------[]----------XXXXXX---XX---<>-------------------------X------[]---------[]---------XX-------------XXXXXX-------------------E-------------------------------------------------<>---------<>------------XXX------------------------
-------E-[]--------------EE--------------------X--------[]--E-------XXXXX]---XX---[]-------------------EE-E---------[]---------[]---------XX----------XXXXXXXXX--------------E-EEEE------------E-EE--------------------------EE-----[]---------[]---------EE--------E----E-------E-E----
XXXXXXXXXXXXXXXXXXXXXXXXXXXXXXXXXXXXXXXXXXXXXXXXXXXXXXXXXXXXXXXXXXXX--XXXX---XXXXXXXXXXXXXXXXXXXXXXXXXXXXXX--X--XXXXXXXXXXXXXXXXXXXX--XXXXXXXXXXXXXXXXXXXXXXXX----------XXXXXXXXXXXXXXXXXXX-XXXXXXXXXXXXXXXXXXXXXXXXXXXXXXXXXXXXXXXXXXXXXXXXXXXXXXXXXXXXXXXXXXX-XXXXXX--XXXXXXXXXXXXXXXX
