----------------------------------------------------------------------------------------------------------------------------------------------------------------------------------------------------------------------------------------------------------------------------------------
------------E---------------------------------------------------------------------------------------------------------------------------------------------------------------------------------------------------------------------------------------------------------------------------
-----------<>---------------------------------------------------------------------------------------------------------------------------------------------------------------------------------------------------------------------------------------------------------------------------
-----------[]---------------------------------------------------------<>-----------------------------------------------------------------------------E----------------------------------------------------------------------------------------------------------------------------------
-----------[]----E----------------------------------------------X-----[]---------------XXXXX---------------------------------------------------------XX---------------------------------------------------------------------------------------------------------------------------------
-----------XXX---XXX------------------------------------X---S??-E?-------??SSS-----------------------SSSS--------------Q--QQQ--------------S------------EQQ------------------X---------------------------------SS--------------------------------S---------------------SS---------------
------XX-------------X------------------------------------------------------------------------------------------------------------------------------------------------------------------------------------------------------------------------------------------------------------------
--X--------------------------------------------------------E----------------------------------------------------------------------------------------------------------------------------------------------------------------------------------XXX---------------------------------------
--------------------------XX----------------------------X-XX----------------------------------------------------------------------------------SSSSSSS-----------------E----------------------------------E----------E------E-------------------X-----------------E----------E-----------
-XXX-------------S--------------------------------------------------XXX----------X---XXX-------------XXXXX----------E-Q---QQQQ-QQQ----------------------S?SS---------QQ-------------X-------------------<>----??---<>-----<>------------------------------------<>---------<>----------E
-XXX----------------------------------------------------------------------------XXXX-------------XX--------------------------------------------------------------------------------XXX------------------[]---------[]-----[]--E------E---------------E----------[]---------[]---E-----<>
-XXX-----------------------------------------------------------------------------X-------------------------------------------------------X-----------------------------------------XXX------------------[]---------[]-----[]--------<>---------X----<>----------[]---------[]----<>---[]
-XXX------------------------------------------------------------------------E-E----------------------------------------------------------X-----------E------------------------E-EX-XXX-------EE-EE-E----[]---------[]-----[]-----E--[]-----E--EX----[]-----E----[]---------[]----[]---[]
X-X-------------------------XXXXXXXXX---XXXXXXXXXXXXXXXX------XXXXX-----XXXXXXXXXXX-X---------X-----------------XXXXXXXXXXXXXXXXXXXXX--XXXXXXXXXXXXXXXXXXXXXXXXXXXXXXXXXXXXXXXXXXXXXXXXXXXXXXXXXXXXX-XXXXXXXXXXXXXXXXXXXXXXXXXXXXXXXXXXXXXXXXXXXXXXXXXXXXXXX--XXXXXXXXXXXXXXXXXXXXXXXXXX
