----------------------------------------------------------------------------------------------------------------------------------------------------------------------------------------------------------------------------------------------------------------------------------------
X---------------------------------------------------------------------------------------------------------------------------------------------------------------------------------------------------------------------------------------------------------------------------------------
SSSS---------------SSSSSSSSS--------------------------------------------------------SSSSSSSSSSSSSSSSSSSSSSSSSSSS--------------------------------------------------------SSSSSSSSSSSSSSSSSSSSSSSSSSSS------------------------------------------------------------------------------------
------------------------------------------------------------------------------------------------------------------------------------------------------------------------S-S----SSS------------------------------------------------------------------------------------------------------
------------------------------------------------------------------------------------------------------------------------------------------------------------------------SSS----SSS?-----------------------------------------------------------------------------------------------------
----------------------------SSSSS-SSSS---------------------------------E-------------------------------------------------------X-----------------------------E----------SSSSS--SS-------------------------------------------------------------------------------------------------------
----------------------------------------------------------------------E-------------------------------------------------------XX------------------XXX-----------XXXXX-------------------------------------------------------------------------------------------------------------------
----------------------------------------------------------------------XXXXXX--------------------------------------------------XX-------------------------------------------------------------------------------------------------------------XX-----------------------------------------
----------E------------E--------------------------------------------X-------------------------E-----------------------------XXXX---------------------------------------------------------------SS---------------------------------------------------------------------------XS----------
-----S---<>-----E-----<>-------------------------------------------XX--------------->--S----SQS---------E------------------XXXXX----------------------------XSSSS------QSSSSS--SSSS--------EX------X--------------------------------------------------S--S------------------------------
---------[]----<>---E-[]---X---------------------------------------XXX-------E-------------------------<X-----------------XXXXXX-----------<--X--------------------------------SSS---------XX------X--------------------------------------E---------------------------------X-----------
S--------[]----[]--<>-[]--<X--------------------------------------XSS-------<>-----[----------------<>-XX----------------XXXXXXX-----------[XXXX---------------------------S--SSS-------<>XXX------X-------------------------------------<>-------------------------------XXXX----------
---------[]----[]--[]-[]--X]-----------------------------EE-EEE-XXXXS-EE----[]--EE-[E-----E---------[]-XX--------E-E----XXXXXXXX--------E--[----------------------------E--SS-SSS-------[]-XX----XXX-------E-------------------------E-E-[]------------E-EE-EE-----------XXXXX----------
-XXXXXXXXXXXXXXXXXXXXXXXXXXXXXXXXXXXXXXXXX--X--------XX-XXXXXXXXXXXXXXXXXXXXXXXXXXXXXXXXXXXXXXXXXXXXXXXXXXXXXXXXXXXXXXXXXXXXXXXXXXXXXXXXX-XX------------------XXXXXXXXXXXXXXXXXXXXXXXXXXXXXXXXXXXXXX---XXXXXXXXXXXXXXXXXXXXXXXXXXXXXXXXXXXXXXXXXXXXXXXXXXXXXXXXXXXXXXXXXXXXXXXXXXXXXXXXX
