----------------------------------------------------------------------------------------------------------------------------------------------------------------------------------------------------------------------------------------------------------------------------------------
----------------------------------------------------------------------------------------------------------------------------------------------------------------------------------------------------------------------------------------------------------------------------------------
-------------------------------------------------------------------------------------------------------------------SSSSSSSSSSS----------------------------------------------------------------------SSSSSSSSSSSSSSSSSSSSSSSSSSSS--------------------------------------------------------
----------------------------------------------------------------------------------------------------------------------------------------------------------------------------------------------------------------------------------------------------------------------------------------
-----------------------------------------------------------------------------------------------------------------------SS---------------------------------------------------------------------------------------------------------------------------------------------------------------
SSS-------------------SSS----------------------------------------------X----------------------------------------SSSSSSSSSS------------------------------SS------------------------------X-----------------------------------------------------------------------------------XX----------
----------------------------------------------------------------------XX---------------------------------------------------------------------------------------------------------------XXX---------------------------------------------------------------------------------XXX----------
----------------------------------------------------------------------XX---------------------------------------------------------------------------------------------------------------XXX---------------------------------------------------------------------------------XXX----------
--------------------------------------------------------------------XXXX-----------------E----------E--------------E-------------------E-----XXXXX--------------------E---------------XXXX--------------------E------SS--------------------------------------------------XXXXX----------
SSSQS-------------XX-----------------------------------------------XXXXX----------------<>---------<>------------SSSS--SS---------XE--<>----------------SS-----------X-------------X-XXXXX-------------S-----<>----------------------------QQ-------------------------XX-XXXXX---------E
-------E----------XX----------------------------------------------XXXXXX-----E----------[]---------[]----X-----E----S--SSS--------<>--[]-----------------------------[X-----------X-EXXXXX-------------------[]-------------------------------------------E-----------X-EXXXXX--------<>
------<>--------XXXX---------------------------------------------XXXXXXX----->----------[]---------[]----<>---<>---S--SSS-------X-[]--[]-----------------------------X-----------X-XXXXXXX-------------------[]--------EX--------------------------------<>----------XXXXXXXXX--------[]
------[]-------XX-XX--------------------E----------E-E---E-E----XXXXXXXX-----]--E--EEE--[]-----E-E-[]----[]---[]------SSS-------X-[]--[]-----------------------E--------EE-E-------XXXXXXX----------E-----E--[]--------[---------------------------------[]-EE-E-------XXXXXXX----X---[]
XXXXXXXXXXXXX--XXXX-------XXXXXXXXX-XXXXXX-----XXXXXXXXXXXXXX-XXXXXXXXXXXXXXXXXXXXXXXXXXXXXXXXXX---XX---XXXXXXXXXXXXXXXXXXXXXXXXXXXXXXXXXXXX-XXXXXXX----XXXXXXXXXXXXXXX-XXXXXXXXXXXXXXXXXXXX---XXXXXXXXXXXXXXXXXXXXXXXXXXXXXXXXXXXXXXXXXXXXXXXXXXXXXXXXXXXXXXXXXXXXX--XXXXXXXX--XXXXX-XX
