----------------------------------------------------------------------------------------------------------------------------------------------------------------------------------------------------------------------------------------------------------------------------------------
--------------------------------------------------------------------------------------------------------------------------------------------X-------------------------------------------------------------------------------------------------------------------------------------------
----------------------------SSSSSSSSSSSSSSSSSSSSSSSSSSSSSSSSSSSSSSSSSSSSSSSSSSSSSSSS----------------------------------------------------------------------------------------------------------------------------------------------------------------------------------------------------
---------------------------------------------------------SSS-SSSSSSSS----------------------------------------------------------------------------------------------------------------------------------------------------------------------------------------EEE--E--------------------S
----------------------------------------------------------SS-SSSSSSSS----------------------------------------------------------------------------------------------------------------------------------------------------------------------------------------XXXXXXXX------------E---SSS
----------------------------SSS----------------------------S--SSSSSSS-----------------------------------------------------------------SSSS-----------------------------------------------XX--------------------------------------XXX------------------------?---------------X??SSS------
---------------------------------------------------------E-------------------------------------------------------------------------------------------------------------------------------XX------------------------X--------------------------------------------------------------------
-----------------------------S------------------------------------S------------E------------------XXXX----------------------------------------------------------------------------------XXX-----------------------XX-------------------------------------------E------------------------
------------------------------------------------------------E-----S------------>-----------------XXXXX------------------------------------------------E-----------------SS-------------XXXX----------------------XXX--------------------------------------------------------------------
-------------------------QQ-SSSS----S-----------X------X--E--SSSSSSS----------[]-----------------XXXX-----------SQQQX--------------X-------------E---<>-----E------>--------------S-----XXX---X-----------------XXXX-----------------------------------------XXXX---------X---XXXX---XX-
-----------------------------------S---------X-XX------X-SE------SS-----------[]--------------XXXXXXXX-----------------E------------------------<>---[]----<>---E-[]------------------XXXXX---X---------------XXXXXX-----------------------------------------------X---EXX-----------XXX
----------------------------------<>--------XXXXX-----XX-S]S-S---SS--------X--[]-------------XXXXXXXXX----------------------------X-------------[]---[]----[]-----[]--XX]------------XXXXXX--------X---------XXXXXXX-----------[----------------------------------XX-----------------XX-
-------E-E----------------E-]-----[]-------XXX-XX----XXX-[]------SS-------E[--[]-------------XXXXXXXXX------E------------------X--X-------------[]---[]----[]-----[]--XX]-----------XXXXXXX--------X--------XXXXXXXX--------E--[--------E-E-E----------E-EE----------------XX---XXX--XX-
XXXXXXXXXXXXXXXXXXXXXXXXXXXXXXXXXXXXXXXXXXXXX-----------XXXXXXXXXXXXXXXXXXXXXXXXXXXXXXXXX---XXXXXXXXXXXXXX--XXXXXXXX--XXXXXXXXXXXXXXXXXXXXXXXXXXXXXXXXXXXXXXXXX---XXXXXXXXXXXXXXXXXXXXXXXXX---XXX--XXXXXXXXX-XXXXX---XXX-X-XX---XXXXXXXXXXXXXXXXXXXXXXXXXXXXX-------------------XXX--XX-
