----------------------------------------------------------------------------------------------------------------------------------------------------------------------------------------------------------------------------------------------------------------------------------------
--------------------------------------------------------X-------------------------------------------------------------------------------------------------------------------------------------------------------------------------------------------------------------------------------
--------------------------------------------------SSSSS---------------------------------------------------------------------------------------------------------------------------------------------------------------------------------------------------------------------------------
----------------------------------------------------------------------------------------------------------------------------------------------------------------------------------------------------------------------------------------------------------------------------------------
-------------------------------------------------------------------------------------------------------------------------------------------------------------------------------------------------------------------------------------------X--------------------------------------------
------------------------------------------------------S-----------------SSS-------------------------------------X---S---QQSSSSS------------------SSSSSSSS----------------------QQQQQ-----------------------------S---------------------------------------------S------------------------
------------------XX--------------------------------------------------------E-----------------------------------------------------------------------------------------------------------------------------------------------------------------------------------------------------------
------------------------------------------------------------------------X----E----------------------------------]-----------------------------------------------------------------------------------------------------------------------------------------------------------------------
--------------------------------------E----------------------E----------XE--<>----------------------------------XXX------------------------------------------------E---------------------------E-----XSSS---------------------E------E----------E----------------------------------E----
---------------------------S-----SS--SS------------------E--<>---------XX----------------------------------------------S?S-SSSSS---------X-------SSSSSSS----------<>----------Q---QQQ---------<>---------------SSSS----------<>----------------<>---------------------------------<>----
-----------------------------<>-----------------E-------<>--[]---X--X-XXX----X--------------------------------E--------------------------XXX-<>-------------------[]--------------------------[]--E--------------------------[]----------------[]---------E-----------------------[]----
-----------------------------[]----------------<>-------[]--[]--------XXX---<>X------------------------------<>--------------------------XX--[]-------------------[]--------------------------[]-<---------------------------[]----------------[]--------<>-----------------------[]----
------------------------------]------E---------[]-------[]--[]-----E-XXXX---[]-------------------------------[]--------------------EE----X---[]---------------E---[]--------------------------[]-----------------------E-----[]-----EE---E-----[]--------[]-----------------------[]----
-----XXXXXXX--XXX----XXXXXXXXXXXXXXXXXXXXXXXXXXXXXXXXXXXXXXXXXXXXXXX--XXX---XXXXXXXXXXXXXXXXXXXXXXXXXXX-XXXXXXXX---XXXXXX---XXXXXXXXXXXXXXX-XXXXXXXXXXXXXXXXXXXXXXXXXXXXXXXXXXXXXXXXXXXXX---XXXXXXXXXXXXXXXXXX--XXXXXXXXXXXXXXXXXXXXXXXXXXXXXXXXXXX---XXXXXXXXXXXXXXX-XXXXXXXXXXXXXXXXXX
