----------------------------------------------------------------------------------------------------------------------------------------------------------------------------------------------------------------------------------------------------------------------------------------
----------------------------------------------------------------------------------------------------------------------------------------------------------------------------------------------------------------------------------------------------------------------------------------
--------------------------------------------------------------------------------------------------------------------------------------------SSSSSSSSSSSSSSSSSSSSSSSSSSSS----------------------------------------------------------------------------------------------------------------
----------------------------------------------------------------------------------------------------------------------------------------------------------------------------------------------------------------------------------------------------------------------------------------
------------------------------------------------------------------------------------------------------------------------------E---------------------------------------------------------------------------------------------------------------------------------------------------------
-------------------------------S---------------------------------------------------------------------------SS--------------------------------------------------------------------------------------------------------------------------------------------------S---SS-------------------
----------------------------------------------------------------------------------------------------------------------------------------------------------------------------------------------------------------------------------------------------------------------------------------
----------------------------------------------------------------------------------------------------------------------------------------------------------------------------------------------------------------------------------------------------------------------------------------
-------------------------------------------------------------E----------E-----------------------------------------------------------------------------E------SSS---------------------------------------------------------------------E----------E---------------------------------------
---------------X---------------------QQ---------------------<>---------<>-----------------------------X-------------------------------------<>-------<>-----------X------------------------------SS---------------------------E----------------<>-------------SSS-----------------------
------------------------------------------------------------[]---------[]----E--------------------EXXXX-------------------------------------[]-------[]-----------X----E-----------------------------------------------------<>------E---------[]----------------------------------E----
------------------------------------------------------------[]---------[]---<>--------------------XXXXX----------XX-------------------------[]-------[]---X-E--E--X---XX-----------------------------------------------------[]-----<>---------[]---------------------------------<>----
---------------------------------------------------------E--[]-----E-E-[]---[]--------------------XXXXX-----------------E---EE-------E-E----[]-------[]--XX-------X---XX--------------------------E--------E-----------------[]-----[]---E-----[]---------------------------------[]-X--
---X----XX-XXXX---XXXXXXXXXXXXXXXXXXXXXXXXXXXXX---------XXXXXXXXXXXXXXXXX-XXXXXXXXXXXXXXX--XXXXXXXXXXXXXX----XXXXXX-XXXXXXXXXXXXX---XXXXXXXXXXXXXXXXXXXX-XXXXX-XXXXXXXXX---XXXXXX----XXX-----XXXXXXXXXXXXXXXX-----XX-----XXXXXXXXXXXXXXXXXXXXXXXXXXX--XXXXXXXXXXXXXXXXXXXXXXXXXXXXXXXXXX
