----------------------------------------------------------------------------------------------------------------------------------------------------------------------------------------------------------------------------------------------------------------------------------------
--------------------------------------------------------------------------------------------------------------------------------------------------------------------------------------------S------SX-----------------------------------------------------------------------------------
----------------------------------------------------------------------------------------------------------------------------------------------------------------------------SSS-------S-----SS-----S------------------------------------------------------------------------------------
----------------------------------------------------------------------------------------------------------------------------------------------------------------------------SSSSSSSSSSSS----SS----SS------------------------------------------------------------------------------------
-----------------------------------------------------------------------------------------------------------------------------------------------------------------------------SSSSS----SS----SS----SS------------------------------------------------------------------------------------
----------------------------------------------------SSS-------------------------------------------------------------------------X------------------------------------------SSSSSSSSSSSSS----SS-----S-------------------------------------------------------------------S----------------
--------------------------------------------------------------------------------------------------------------------------------XX--------------------------------------XE--------------------------------------------------------------------------------------------------------------
-------------------------------------------------------------------------------------------------------------------------------XXX--------------------------------------X----------------------------------------XX----X---------------------XX-XXXX------------------------------------
------------------------------------------------------------------------------------------------------------------------------XXXX-------------------------------------------------------------E----------------------------------------------------------------------------------------
---------------X--------------------------------------------------------------------------------------------------------------XXXX------------------------------------------SSSSSSSS----------<>-X------------------------SS-------------------------SSS---------QQ---??---<>-----------
-------------------------------------------X-----------------------XXX-------------------------------------------------------XXXXX--------------------E-----E---------E-----------------------[]---------E----E-----E----E----------------E-----E--------------------------[]-----------
-------------------------------------------X-----------------------XXX-------------------------XXX--------------------------XXXXXX-------------------->--------------<>-----------------------[]--------<>----E----<>---------------------E--------------------------------[]-----------
-------------------------------------------X--------------------EXXXXXXE--------E--E----------XXXX-E-------------E-E-------XXXXXXX-------------------E]--------------[]--------------------EE-[]-X------[]----S----[]-----E--E-E--E-EE----S-----------E--E-E---------------[]-E---------
XXXXXX--XXXXXX----------XXXXXXXXX--XXXXXXXXXXXXXXX---XXXXXXXXXXXXXXXXXXXXXXXXXXXXXXXXXXXXXXXXXXXXXXXXXXXXX--XXXXXXXXXXXXXXXXXXXXXXXXXX-XXXXXXXXXXXXXXXXXXXXXXXX-XXXXXXXXXXXXXXXXXXXXXXXXXXXXXXXXXXXXXXXXXXXXXXXXXXXXXXXXXXXXXXXXXXXXXXXXXXXXXXXXXXXXXXXXXXXXXXXXXXXXXXXXXXXXXXXXX--X-XXX
