----------------------------------------------------------------------------------------------------------------------------------------------------------------------------------------------------------------------------------------------------------------------------------------
---------------------------S-------------------------------------------------------------------------------------------------------------------------------E----S------S----------------------------------------------------------------------------------------------------------------
SSSSSSSSSSSSSSSSSSSSSSSSSSSS----------------------------SSSSSSSSSSSSSSSSSSSSSSSSSSSS----------------------------------------------------------------------<>----SS----SS----------------------------------------------------------------------------------------------------------------
--SSSSSSSSSSSSSS----SSSSSSSS---------------------------------------------------------------------------------------------------------------------S--SS---S[]----SS---SSS--------------------------------------------------------------------------------------------------<>------------
SSSSSSSSSSSSSSSS----SSSSSSSS------------------------------------------------------------------------------------------------------------------------------[]----SS---SSS-X-XXXX-------------------------------------------------------------------------------------------[]------------
-SSSSSSSSSSSSSSS----S-----SS-----------------------XXXX-------------------------------------------------------------------------------------X--SSSSSSSSSSSSS----SSS-SSSSS---------------------SSSS----------------------------------------------------------X---S?--E?SSSSS----SSSS-----
ES------------------------------------------------------------------------------------------------------------------------------------------XE------------------------------------------------------------------------------------------------------------------------------------------
-------------------------------------------------------------------------S---------------------------------------------------XX-XXXX--------X---------------------------------------------------------------------------------------------------------------]---------------------------
----E------------------E------------------------------------------------XSSS----------------------------------------------------------------X-----------------------------------------------------------------E------------E--------------------------------XXXX------------------------
---SSSSSSSSS-------E--<>------------------XXX-----------<>------SQS------X----X------------------XXX----------------------------------S---------SSSSSSSSQS-----------XXXXXXXX-------------XX-X---------------<>-----------<>---------E----------E----------E-------S?---XSX----------X--
--E-SSSSS---------<>--[]--------------------------------[]---------------]----X----E-----------XXXX-----------------------------E----E-----------------------------------------E---EXXXXX---------------------------------[]--------<>---------<>------E--<>------------------------XXXX
-SSSSSSSSSS-------[]--[]--------------------------------[]------------X-[]-X--X---XX-----------XXX-----------------------------<>---------------------------------------------XX------------------------------------------[]--------[]---------[]-----<>--[]-------------------------X--
----S----E--------[]E-[]--------------------------------[]----E------XX-[]----X---XX---------XXXXX----------E-----E-EE----E----[]-----E--E-E-------------------EE-E--------------------X---------------------E------------[]--------[]-----E---[]-----[]--[]--------------------X-E-----
XXXXXXXXXXXXXXXXXXXXXXXXXXXXXXXXXX---XXXXXX--XXXXXXXXXXXXXXXXXXXXXXXXXXXXX---XXXX-XXXXXXXXX-XXXXXX---XXXXX--X---XXXXXXXXXXXXXXXXXXXXXXXXXXXXXXXXXXXXXXXXXXXXXXXXXXXXXXXXXXX-----XXXX----------------XXXXXXXXXXXXXXXXXXXXXXXXXXXXXXXXXXXXXXXX-XXXXXXXXXXXXXXX-----XXXXXX-----XXXXX-------
