----------------------------------------------------------------------------------------------------------------------------------------------------------------------------------------------------------------------------------------------------------------------------------------
----------------------------------------------------------------------------------------------------------------------------------------------------------------------------------------------------------------------------------------------------------------------------------------
--SSSSSSSSSSSSSS------------------------------------------------------------------------------------------------------------------------------------------------------------------------------------------------------------------------------------------------------------------------
--SSSSSSSSSSS-S-------------------------------------------------------------------------------------------------------------------------------------------------------------------------------------------------------------------------------------------------------------------------
---SSSSSSSSSS-----------------XXXXXXX--------------------------------------------------XXXXX-----------------------------XXX----------------------------------------------------------------------------------------------------------------------------------------------E-------------
SSSSSSSSSSSSSSSS----S------S-----------------SSSSSSSSS------------------------------E----------------SSS----------------------------------------------------------------------------------XX--------X-------S?-------SSS----------------------------------------------------------------
----------------------------------------------------------------------------------------------------------------------------------------------------------------------------------------------------------------------------------------------------------------------------------------
-----------------------------------------------------------------------------------------------------------------------------------------------------------------------------------------------------------------------------------------------XXX--------------------------------------
----E------------------E-------XX----------------------------------------------E------------------------------------------------------------------------------------------XXXXX-----------------------XXX---------------------E---------------------------------------------------------
---?SSSSSSS--------E--<>-----XXXX-------XXX------X--------------Q-------------<>----XXXX-------------XXXXX---------------------QQ---------------------------------------------------XX-----------X--------------XXX----------<>--------------------------------------------------------S
--E-------------------[]----------------X--------------------------------X----[]---------------E-XX-------------------------------------------------------------------E-------------------------XXXX-------------------------[]----------------------E----------------------------------
--S--X------------[---[]--------------------X---------------------------XXX---[]-----------X------------------X------------------------------------------------------<>------------------------------------------------------[]----------------X----<--------XXX------------------------
------------------[---[]--------------------X-----------------E---------XXX---[]-------------------------XX--------------E-------------------------------------------[]---------------------------------------------------E--[]--E--EE----EE--EE-----]------------------EE-------E-E--E-
XXXXXXXXXXXXXX-XXXX-XXXXXXXX--------XXX-----------------XXXXXXXX--XXXXXXXXXXXXXXXXXX----------------------------XXXXXXXXXXXXXXXXXXXX---XXXXXXXXXXXXXXXXX---XXX-XXXXXXXXX------XX--------XXXXXXXXXX--------XX-------------XX-XXX-XXXXXXXXXXXXXXXXXXXXXX-XXXXXXXX-XXXXXX--XXXXX-XXXXXXXXXX
