----------------------------------------------------------------------------------------------------------------------------------------------------------------------------------------------------------------------------------------------------------------------------------------
----------------------------------------------------------------------------------------------------------------------------------------------------------------------------------------------------------------------------------------------------------------------------------------
SSSSSSSSSSSSSSSSSSSSSSSSSSSS------------------------------------------------------------------------------------------------------------------------------------------------------------------------SSSSSSSSSSSSSSSSSSSSSSSSSSSS--------------------------------------------------------
----------------------------------------------------------------------------------------------------------------------------------------------------------------------------------------------------SSSSSSSSSSSSSSS------SS---SS--------------------------------------------------------
----------------------------------------------------------------------------------------------------------------------------------------------------------------------------------------------------SSSSSSSSSSSSSSS-----SSSS--SS--------------------------------------------------------
------------------------------------------------------------------------------------------------EQ?-----------------------------------S-SSS------------------------XXX----XXXX-----------------------SSSSSSSSSS--SSS--------------XX----------------------XX----------------------------
----------------------------------------------------------------------------------------------------------------------------------------------------------------------------------------------------------------------------------------------------------------------------------------
---------------------------------------------------------------------------------------------------------------------------------------------------------------------------------------------------------------------------E---------------------------------------------XXXXXXX--------
-----------------------------------------------------------------------X----------------SSSSS----------------------X------------------------------------------------------------------------------------E-----------------<>------------------------------------------------------------
SSSS----SQS--------------------------------X----------------------------------------------------S?S---------S?SS------------XX----------------------------XXXXX---------------------X----------------SSSSSSSSSS--------E--[]-------------------------SSSS-------------------------S-----
-----------------X-XX------------------------------------------------XXX------------------E-----------------------------------------------------------------------------------------X----------------SSSSSSSSSS-------<>--[]-------------------------------------E----------E----E------
----------------<>-XX--------------------XXX-----------------------XXXXX------------------------------------------------------------------------------------------------------------X----------------SSSSSSSSSS-------[]--[]------------------------------------------E----<>----------[
E-----E-------X-[]-XX------------------EEXXX----------------------XXXXXX--------E--E-------E-E--------------------------------------------------------------------------------E-E---X--------EE-EE-E-SSSSSSSSSS-------[]--[]------------E---E--------EEE------E-EE----S----[]--------EE[
XXXXXXXXXXXXXXXXXXXX---XXXXXXXXXX--XXXXXXXXXXXXX--------XXXXXXXXXXXXXXXXXXXXXXXXXXXXXXXXXXXXXXXXXXXXXXXXXXXXXXXXXXXXXXXXXXXXXXXXXXXXXXXXXXXXXX-XX---XXXXXXX--XXXXX----XXXXXXXXXXXXXXXXXXXXXXXXXXXXXXXXXXXXXXXXXXXXXXXXXXXXXXXXXX-----XXXXXXXXXXXXXXXXXXXXXXXXXXXXXXXXXXXXXXXXXXXXXXXXXXX
