----------------------------------------------------------------------------------------------------------------------------------------------------------------------------------------------------------------------------------------------------------------------------------------
----------------------------------------------------------------------------------------------------------------------------------------------------------------------------------------------------------------------------------------------------------------------------------------
----------------------------------------------------------------------------------------------------------------------------------------------------------------------------------------------------SSSSSSSSSSSSSSSSSSSSSSSSSSSS--------------------------------------------------------
----------------------------------------------------------------------------------------------------------------------------------------------------------------------------------------------------------------------------------------------------------------------------------------
----------------------------------------------------------------------------------------------------------------------------------------------------------------------------------------------------------------------------------------------------------------------------------------
-------QQQQQQQQ-----------------------------------------Q-----------------E--------------------------------------------------------S----SS------------Q-------------------------------------------------------------------------S---------------------SSS------------QSS-S-----X--------
------------------------------------------------------------E---------------------------------------------------------------------------------------------------------------------------------------------------------------------------------------------------------------------------
E------S--------------------------------------------------------------------------------------------------------------------------------------------------------------------------------------------------------------------------------------------------------------------------------
-------S------------------E------E----------E-----------------------------------------------------------------E----X-----------------------------------------------E--------------------------------E---------E------SSS---E---------------------------------XXXXX--------------------E-
----------QSSQQQ-Q-------<>-----E------E---<>-----------X------------XXXXX-----------X-----------------------QQ---XXX-----------------------------Q---------E-----<>-------------------------------->--S-----<>-----------<>----XQQQ--------------XXXX------------------SS-----------<>-
-------------------------[]----------------[]------E--E-X------------XX-XX-----------X---------------------------------------------------------------------<>-----[]--E--------------------------------------[]-----------[]---X-------E-----XXXXXXXX--------------------------------[]-
-------------------------[]----------------[]-----<>-----------------XX--------------X---------------------------------------------------------------------[]-----[]--------------------------------SS-------[]--------XX-[]--<>------X>----------XX---------------------------------[]-
-------------------EE-E--[]-----E----------[]-----[]---------------XXX----------E---XXX--------------------------------------------------------------------[]-----[]----------------E---------------S--------[]--E--------[]--[]------[]-------X---X---------------------------------[]-
XXXXXXXXXXXXXXXXXXXXXXXXXXXXXXXXXXXXXXXXXXXXXXXXXXXXXXXXXXXXXX---XXXXX----------X---XXXXXXXXXXXX--XXXXXXXXXXXXXXXXX---XXX------XXXXXXXXXXX--XXXXXXXXXXXXXXXXXXX-XXXXXXXXXXXXXXXXXXXXXXXX-----XX-XXXXXXXXXXXXXXXXXXXXXXXXXXXXXXXXXXXXXXXXXXXXX--XXXXXXXX-XXXXXXXXXXXXX-------XXXXXXXXXXX-
