----------------------------------------------------------------------------------------------------------------------------------------------------------------------------------------------------------------------------------------------------------------------------------------
----------------------------------------------------------------------------------------------------------------------------------------------------------------------------------------------------------------------------------------------------------------------------------------
------------------------------------------------------------------------------------SSSSSSSSSSSSSSSSSSSSSSSSSSSS----------------------------------------------------------------------------------------------------------------SSSSSSSSSS------SSSSSSSSSSSS----------------------------
----------------------------------------------------------------------------------------------------------------------------------------------------------------------------------------------------------------------------------------------------------------------------------------
----------------------------------------------------------------------------------------------------------------------------------------------------X-----------------------------------------------------------------------------------------------------------------------------------
-SS--------------------SS-------------------------------------------------X-----X--------------------------------SSSS--SSSS---------------SS------------------XXXXXXXX-----------------X------------X--SSSSSSSS------SSS------------------------------------------E------E---E----------
-------------------------------------------------------------------------XX-----------------------------------------------------------------------------------------------------------XX--------------------------------------------------------------------------XXX-------XXXXXX------
------------------------------------------------------------------------XXX--------------------------SX-------------------------------------------------------------------------------XX----------------------------------------------------------------------X-------------------------
---------------------------------E----------E--------------------------XXXX-------------------------XXXS---------------------------------------XXXX---------------------------------XXXX--------------XX-----------------------------------------SS-----------------------------------XX
-QQ----------------------------------------<>-------------------------XXXXX---------<>------SQS------X-X--X---------------------------------------------X--------------------------X--XX------------------------XXX----------<>---------QQ---------------------X------------XSS--------S
------------------X-------------[E---------[]------------------------XXXXXX---------[]---------------]-X--X----X------------------------------------------------------------------XXXXXX-----E-------------------------------[]------------------------------EXX------------------------
----------------XXX-------------<]---------[]-----------------------XXXXXXX---------[]-----------XXX[]-XX-X---XX-------------------------------------------------------------------XXXXX----<>-------------------------------[]-----------------<>-X--------XXXX------------------------
---------------XX-X-------------[]---------[]---------E-----------XXXXXXXXX---------[]----E-----XXX-[X-X--X--XXX---------------------------------------------------------E-EE----XXXXXXX----[]--------------------------E-E--[]-E-----E------EX-[]----------X-XX------------------------
XXXXX--XXXXXX--XX-----------XXXXXXXXXXXXXXXXXXX----XXXXXXXXXXX-XXXXXXXXXXXXXXXX-XXXXXXXXXXXXXXXXXXXXXX--XXXXXXXXXXXXXXXXXXXXXXXXXXXXXXXXXXXX--------XXX-----------------XXXXXXXXXXXXXXXXXXXXXXXXXXXXXXX---XXX-----------XXXXXXXXXXXXXXXXXXXXXXXXXX-XXXXXXXXXXX---XX--------------XXXXXXX
