----------------------------------------------------------------------------------------------------------------------------------------------------------------------------------------------------------------------------------------------------------------------------------------
---------------------------------------------------------------------------------------------------E----SS-----S------------------------------------------------------------------------------------------------------------------------------------------------------------------------
---------------------------------------------------------------------------------------SSSSSSSS---<>----SS----SS---SSSSSS-------------------SSSSSSSSSSSSSSSSSSSSSSSSSSSS----------------------------------------------------------------------------------------------------------------
---------------------------------------------------------------------------------------SSSSSSSSSSS[]----SS---SSS--SSSSSSSSSS------------------------------------------------------------------------------------------------------------------------------------------------------------
---------------------------------------------------------------------------------------SSSSSSS----[]----SS---SSS---S--SSSSS-------------------------------------------------------------------------------------------------------------------------------------------------------------
------------------X---------------------------------------------E-SSSS-----X--------?--SSSSSSSSSSSSS----SS-----S--SSSSSSSSSS-SSS------SSSSSS-----------------------------SSS---SSS------------------------------------------------XXXX--------------------------------------------------
------------------X---------------------------------------------------------------------------------------------------------------------------------------------------------------------------------------------------------------------------------------------------------------------
-----------------XX------------------------X----------------------------------------]-----------------------------------------------------------------------------------------------------------------------------------------------------------XXXX------------------------------------
----------------XXX------------------------X------------XXXXXX--------------------E---------------------------------E-------------------------------------------------------------------------------------------------------------------------------------------------------------------
---------------XXXX---------------------------------------------?---SSS----------<-----?SSSSSS---EE----------XX----SSSSSSSS-----------------SSSS---SSSS---------E------X---S---------------------------------Q------E----------------------------------------------------XXXXX----------
--------------EXXXX--------------------XXXXX-------------------------------------[]------SS-----------------------E----------------E---------------------------<>------X--------------------------------------------------------------------X-------------------------------------------
-------------EXXXXX-------------------XXXX-X-------------------------------------[]------X-------------------XX-------------------<>-----------------S------<>-[X------X------------------<X------------------------------------------------X----------------------------X--------------
--------------XXXXX-----------------XXXXXXEX--------E----------------------------[]---------------------E-E--XX-------------------[]--------------E---------[]-[X------X------------------E-------------------------------------------E-E-X-X---------E-EE-E------------EX-------E-EE---
XXXXXXXX-XXXXXXXXXXX--------XXXXXXXXXXXXXXXXXXXX----XXXX-----XXX--------XXXXXXXXXXX-XXXXXXXXXXXXXX--XXXXXXX-XXX-XXXXXXXXXXXXXXXXXXXXXXXXXXXXXXXXXXXXXXXXXXXXXXXXXXXXXXXXXXXXXXXXXXXXXXXXXXXXXXXXXXXXXXXXXXXXXXXXXXXXXXXXXXXXXXXXXXXXXXXXXXXXXXXXXXXXXXXXXXXXX---XX--XXXXXX----XXXXXXXXXX
