----------------------------------------------------------------------------------------------------------------------------------------------------------------------------------------------------------------------------------------------------------------------------------------
----------------------------------------------------------------------------------------------------------S-----------------------------------------------------------------------------------------------------------------------------------------------------------------------------
------------------------------------------------------------------------------------SSSSSSSSSSSSSSSSSSSSSSSSSSSS--------------------------------------------------------------------------------------------------------------------------------------------SSSSSSSSSSSSSSSSSSSSSSSSSSSS
--------------------------------------------------------------------------------------SSSSSSSSSSSSSS-----SSSSSSS------------------------------------------------------------------------------------------------------------------------------------------------------------------------
------------------------------------------------------------------------------------S-SSSSSSSSSSSSS------SSSSSS-------------------------------------------------------------------------------------------------------------------------------------------------------------------------
------------------------SSSS---------------------------------------------------XXX--SSSSSSSSSSS--SSS------SSSSSS---------------------------X--------------------------------------------------------------------EQQ-----XXXXXXXX-----------------------------S---------------------S----
----------------------------------------------------------------------------------------------------------------------------------------------------------------------------------------------------------------------------------------------------------------------------------------
----------------------------------------------------------------------------------------------------------------------------------------------------------------------------------------------------------------------------------------------XX-------------S--------------------------
----------------------------------------------------------------------------------------E------------------SS--------------------------------XXXXX---------------------------------------------------XSSSSSSS--------------------------------XXX-----------------------------------SS---
------------SS--------------SSS---------------XX----------------------XXXX------------SSSSSSSSS--------E-----------------------------SSSSSSS------------XX--------------------Q---------E-----------------------SSSS-----S-SS---------------XXXX------------SSSS----S-----------X-------
---------------------------------------------XXX--------------------------------------SSSSSSSS--------<>------------------------------------------------------------X------------------<>-------------------------------------------------XXXXXX-----------<[------E---------X-XX-------
-------------------------------------------XXXXX-------X------------------------------SSSSSSSS--------[]-------------------------------------------------------------------------------[]------------------------------------------------XXXXXXX-----------[------<>--------XXXXX-------
-------------------------------------------XXXXX-----XXX-------------------------------SSSSSSS--------[]---------------EE------------E-E-----------------------------------------------[]-E---------------------------------------------XXXXXXXX--------E--[]-----[]------XXXX-XX-------
XXXXXXXXXXXXXXXXXXXXXXXX-XXXXXXXXXXXXXXXXXXXXXXXXXXXXXXXX----X--XXXXX------X-------XXXXXXXXXXXXXXXXXXXXXXXXXXXXX---XXXXXXXXXXXXXXXXXXXXXXXXX------XX----------X---------XXXXXXXXXXXXXXXXXXXXXXXX-XXX---XXXXXXXXXXXXXXXXXXXXX---XXXXXXXXX-XXXXX---XXXXXXXX-XXXXXXXXXXXXXXXXXXXXXX------XX
