----------------------------------------------------------------------------------------------------------------------------------------------------------------------------------------------------------------------------------------------------------------------------------------
----------------------------------------------------------------------------------------------------------------------------------------------------------------------------------------------------------------------------------------------------------------------------------------
----------SSSSSSS-----------SSSSSSSSSSSSSSSSSSSSSSSSSSSS--------------------------------------------------------SSSSSSSSSSSSSSSSSSSSSSSSSSSS--------------------------------------------------------SSSSSSSSSSSSSSSSSSSSSSSSSSSS--------------------------------------------------------
------------------------------------S----------------------------------------------------------------------------------------------------------------------------------------------------------------------------------------------------------X----------------------------------------
-----------------------------------SSS---------------------------------------------------------------------------------------------------------------------------------------------------------------------------------------------------------X----------------------------------------
-----------------XX---------SSS----SS-------------------------------EQQ----------SSS-----------------------------------------------------------------------X-S--------------------------------------------------------X------------------------XXS--------------------------------------
----------------XXX---------------------------------------------------------------------------------------------------------------------------------------XXX--------------------------------------------------------XX-----------------------XXX---------------------------------------
----------------XXX--------------------------------------------------------------------------------------------------------------S------------------------XXX----------------------------------------S---------------XX----------------------XXXX---------------------------------------
---------------XXXX--------------------------------SS-----SSSSSSS---------------------------------------------------------E------SSS--------------------XXXXXE------------------------------------------------------XXX---------------------XXXXXE--------------------------------------
----------X-----XXXX--X-----SSSSS--SS-S--------EX------X------------SQSQ--------S---------Q----Q---QQ-----------<>-S----S<>---------X------X-----------X-XXXX---------------------------------------SS--------S-----XXXX--X------E---------XXXXXX----------E---------------XX-----------
E------------XXXXXX---X------------SS----------XX------X--------------------------------------------------------[]-------[]--------XX-X----X----------XXXXXXX----E----------------------------------[---------------XXXXX-X-----<>--------XXXXXXX----X----<>----------------------------
]-----------XXXXXXX---X--------S--SS--------<XXXX------X--------------------------------------------------------[]-------[]-----<>-XX-----------------XXXXXXX----X----------------------------------]------------XXXXXXX--X-----[]-------XXXXXXXX----X----[]----------------------------
]--E-------XXXXXXXXX--X-----------[S--------[]-XX------X--------------------------------------------------------S]----E--[]--EX-[]-XX--------E-EE----XXXXXXXX----X-----X----------------------------]-----------XXXXXXXX--------[]-EE---XXXXXXXXX----X----[]------------E---------------
XXXXXXXXXXXXXXXXXXXX--XXXXXXXXXXXXXXXXXXXXXXXXXXXXXXXXXX---XXXXXXXXXXXXXXXXXXXXXXX--XXXXXXXXXXXXXXXXXXXXXXXXXXXXXXXXXXXXXXXXXXXXXXXXXXXXXXXXXXXXXXXXXXXXXXXXXXXXXXXXXXXXXXXXXXXXXX-X--XXXXXXXXXXXXXXXXXXXXXXXXXXXXXXXXXX--XXXXXXXXXXXXXXXXXXXXXXXXXXXXXXX-XXXXXXXX--XXXXXX--------------
