----------------------------------------------------------------------------------------------------------------------------------------------------------------------------------------------------------------------------------------------------------------------------------------
----------------------------------------------------------------------------------------------------------------------------------------------------------------------------------------------------------------------------------------------------------------------------------------
-------------------------------SSSSSS---------------------------------------------------------------------------------------------------------------------------------------------------------------------------------------------------------------------------------------------------
-------------------------------SSSSSSSSSSSS---------------------------------------------------------------------------------------------------------------------------------------------------------------------------------------------------------------------------------------------
-------------------------------SSSSSSSS---SS--------------------------------------------------------------------------------------------------------------------------------------------------------------------------------------------------------------------------------------------
-------------------------------SSSSSSSSSSSSS----S------S-----------------------------------------------------------------------------------XS----------------------S--------------S?SSS----------------------------E------------------------------------X-X-----------------------SSSS--
---------------X------------EE------------------------------------------------------------------------------------------------------------------------------------------------------------------------------------E---------------------------------------------------------------------
--------------XXX-----------]--------------------------------------------------------------------------------------------------------------------------------------------------------------------------------------XXXXX----------------------------------------------------------------
-------------XXXX---------------E------------------E--?------------------------------------------------------------------------------------------------------------------XSSSSSSS-----------------E-------------X-----------------------------------------------------------------------
-------------XXXX----------E----SSSSSSSS----------<>---------E---E------E------------------------------------<E--------------S--------------QQQQ--------------XXX------------------SSSSS---------<>------------XX----------------------------XXXX-----------QQQQ--------------XX--------
-----------XXXXXX---------<>----------------------[]--------<>---------<>---E--------------------------------<>-------------------------------------------XXXXXXX--------------------------------[]------------XXX-------E------------------------------------------------XXXXXX--------
-----------XXXXXX---------[]-----X----------------[]--------[]---------[]--<>--------------------------------[]-----------------------------------X>----------XXX--------------------------------[]-----------XSS-------<>-----[-------------X---------------------------------X--------
-E-E-----XXXXXXXX---------[]-------------------EE-[]--------[]---------[]--[]--------------E-E---------------[]--------------------------------------------X---XX--------------------------E-----[]--EE-EEE-XXXXS-EE----[]--EE-E------------EX-------E--E----------------------X--------
XXXXXXXX-XXXXXXXXXXXXXXXXXXXXXXXXXXXXXXXXXXXXXXXXXXXXXXX-XXXXXXXXXXXXXXXXXXXXXXXXXXXXXXXXXXXXXXXXXXXXXX-XXXXXXXX---XXXXXXXXXXXXXXXXXXXXXXX-XXXXXXXXX-XXXX--X---X----XXXX---XXXXXX---XXXXXXXXXXXXXXXXXXXXXXXXXXXXXXXXXXXXXXXXXXXXXXXXXXX-XXXXXXX--XXXXXXXXXXXXXXXXXX---XXXXXXXXXXXXXXXXXX
