----------------------------------------------------------------------------------------------------------------------------------------------------------------------------------------------------------------------------------------------------------------------------------------
----------------------------------------------------------------------------------------------------------------------------------------------------------------------------------------------------------------------------------------------------------------------------------------
----------------------------------------------------------------------------------------------------------------------------------------------------------------------------------------------------SS-----------------SSSSSSSSS-----SSSSSSSSSSSSSSSSSSSSSSS----------------------------
-------------------------------------------------------------------------------------------------------------------------E--------------------------------------------------------------------------------------------------------------------------------------------------------------
-------------------------------------------------------------------------------------------------------------------------XXX------------------------------------------------------------------------------------------------------------------------------------------------------------
-----------------------XX-------------------------------SS-------------------------------------------------------------------QQ--------------------------------S--SSSS---------------------------------------------------------------------------------SS---------------------------SS--
----------------------------------------------------------------------------------------------------------------------------------------------------------------------------------------------------------------------------------------------------------------------------------------
----------------------------------------------------------------------------------------------------------------------------------------------------------------------------------------------------------------------------------------------------------------------------------------
--------------------------------------------------------------------------------------------------------------------SSSSS-------------------------------------------------------------------------------------E----------------------------------------SS-------------------------------
-------------XXXX---------------------------------------SQQQ--------------XXX-----XX---------Q------------------------------QQQQ----------E--XXXX-------------XX-X--------------------------------SS-----S---<>-----E-----------SSSS------------------------------------XX--------------
------------XXXXXX---------------------------------------------E---------XXX-------------------------------------------------------------<>---------------X--------------------------------------------------[]----<>---E------X-------E---------XXXX-----------------------------------
-----------XXXXXXX--------------------------------------------<>---------XXX---------------------------X---------------------------------[]------------------------------------------------------------------[]----[]--<>-----XX------<>--------XXXXX-----------------------------------
----------XXXXXXXX------E-------------------------------------[]-------XX-XXX------X-------------------------------------E---------------[]------------------------------------------------------------------[]----[]--[]----XXX------[]-------XXXXXX-----------------------------------
XXXXXX--XXXXXXX--XXXXX--XXXXXXXXXXXXXXXXX-XXX--------X--XXXXXXXXXXXXX--XXXX------XX-XXXXXXXXXXXXXXXXXXXXXXXXXXXXXXXXXXXXXXXXXXXXXXX----XXXXXX-------XXX-----------------XX---XXXXX----XXXXXXXXXXXXXXXXXXXXXXXXXXXXXXXXXXXXXXXXXXXXXXXXXXXXXXXXXXXXXXX----XXX---X--XXXXXXXXXXXXXXXXXXXX-X
