----------------------------------------------------------------------------------------------------------------------------------------------------------------------------------------------------------------------------------------------------------------------------------------
----------------------------------------------------------------------------------------------------------------------------------------------------------------------------------------------------------------------------------------------------------------------------------------
----------------------------------------------------------------------------------------------------------------------------------------------------------------------------------------------------------------------------------------------------------------------------------------
----------------------------------------------------------------------------------------------------------------------------------------------------------------------------------------------------------------------------------------------------------------------------------------
-----------------------------------------------------------------------------------------------------------------------------------------------------------------------------------------------------------------------------------------XXX--------------------------------------------
--------------------------X---------------------------------------------------------------SSQQSSS-------------------------------------SSSS----------SQSS----------------------------------------X---X---SSSSQQSSSSS------SS--S-S--------------------------------------------------------
----------------------------------------------------------------------------------------------------------------------------------------------------------------------------------------------------------------------------------------------------------------------------------------
---------------X------------------------------------------------------------------------------------------------------------------------------------------------------------------------------------X-----------------------------------------------------------------------------------
--------------XX-------------------------------------------------------------------------------------------E----------------------------------S-----------------------------------------------------X-----------------------------------------------------------------------------------
------------XXX----------------------Q------E-----------------------------------------E--SS--SSS----------<>----SSSXS-------------XX---------------S?--SSSSS---------<>---------------XXXX----------------SS?S-S?SS----------X----------------QQ---------QQ-----------------------------
----------XXXXXX---------------------------<>----------------------------------------<>-------------------[]-----------E----------XX---------------------------------[]-----------------------------------------------------XXXX----------E---------------------------------E---------E-
---------XXXXXXX---------------------------[]----------------------------------------[]-------------------[]----------<>--------XXXX---------------------------------[]------------------------------------------------------------------<>--------------------------------<>--------<>-
--------XXXXXXXX------E-E------------------[]------------------------------------EE--[]---------------EE--[]----------[]-------XXXXX---------------------------E-----[]------------------------------------------------EE-E--------------[]---------------E-----EE---------[]--------[]-
XXXXXXXXXXXXXXXXXXXXXXXXXXXXXXXXXXXXXXXXXXXXXXXXXXXXXXXXXXXXXXXXXXXXXXXXXXXXXXXXXXXXXXXXXXXXXXXXXXXXXXXXXXXXXXXXXXXXXXXXXXXXXXXXXXXXXXXXXXXXXXXXXXXXXXXXXXXXXXXXXXXXXXXXXXXXX-----XXXXX----XXXX-XXXXXXXXXXXXXXXXXXXXXXXXXXX-------XXXXXXXXXXXXXXXXXX--XXXXXXXXXXXXXXX-XXXX-XXX--XXXXXXXX
