----------------------------------------------------------------------------------------------------------------------------------------------------------------------------------------------------------------------------------------------------------------------------------------
----------------------------------------------------------------------------------------------------------------------------------------------------------------------------------------------------------------------------------------------------------------------------------------
------------------------------------------------------------------------------------------------------------------------------------------------------------------------------------------------------------------------------------------------------------SSSSSSSSSSSSSSSSSSSS--------
----------------------------------------------------------------------------------------------------------------------------------------------------------------------------------------------------------------------------------------------------------------------------------------
----------------------------------------------------------------------------------------------------------------------------------------------------------------------------------------------------------------------------------------------------------------------------------------
-----------??SS------------------------------------------------------------------------------------------------------------------------------------------------------XXX--------------------------------SSSSQQSSS------------------S--SSSSS---------------------------------------------
----------------------------------------------------------------------------------------------------------------------------------------------------------------------------------------------------------------------------------------------------------------------------------------
----------------------------------------------------------------------------------------------------------------------------------------------------------------------------------------------------X-----------------------------------------------------------------------------------
-XSSSSSSS-----------------E-----SSSSS--------------------------------------------------------------------------------------------------E---------------------------------------------------------------------------------------------------------------E---------------------------E----
------------SSS----------<>-------------S?SQ----------E-----------------------------------------S-------------E-SSQ---------------XXX-<>------------------QQ-------SS-----------------XXX-----------------SSSS-SSSS----------X--------SSS-------------<>----SS-S----SQS-----------<>----
-X-----------------------[]--------------------------<>------------------------------------------------------<>--------E---------XXXX-[]---------------------------------------------XXXXX-----------------------------------XX-----------------------[]-----------------------X--[]----
-------------------------[]--------------------------[]------------------------------------------------------[]-------<>--------XXXX--[]---------------------------------------------XXXXX-----------------------------------XX-----------------------[]--------------------<>-X--[]----
XX-------E---------------[]--------E-E---------------[]------------------------------------------------------[]-------[]-------XXXXXX-[]---X---------E-----------------------------XXXXXXX-----------------------------EE-E--XX-------------------E---[]----E-----E---------[]----[]----
---XXXXXXXXXXXXXXXX-XXXXXXXXXXXXXXXXXXXXXXXXXXXXXXXXXXXX---X---XXXXX--XXXXXXXXXXXXXX------XX-------------XXXXXXXXXXXXXXX--XXXXXXXXXXXXXXXXXXXXXXXXXXXXXXXXXXXXXXX--XXX-XXXXXXXXXXXXXXXXXXXXXXXX-XXXXXXXXXXXXXXXXXXXXXXXXXXXXXXXXXXXXXXXXX--XXXXXXXXXXXXXXXXXXXXXXXXXXXXXXXXXXXXXXXXXXXXX
