----------------------------------------------------------------------------------------------------------------------------------------------------------------------------------------------------------------------------------------------------------------------------------------
----------------------------------------------------------------------------------------------------------------------------------------------------------------------------------------------------------------------------------------------------------------------------------------
----------------------------------------------------------------------------------------------------------------------------------------------------------------------------------------------------------------------------------------------------------------------------------------
----------------------------------------------------------------------------------------------------------------------------------------------------------------------------------------------------------------------------------------------------------------------------------------
----------------------------------------------------------------------------------------------------------------------------------------------------------------------------------------------------------------------------------------------------------------------------------------
-------SQSSSS-------------SS-----------------------SS--------------------------------------------------------------S---SS--------------------SSS---SS--------------------X-X---------------------------------------------------------------------------XXX------------------XX----------
---------------------------------------------------------------------------------------------------------------------------------------------------------------------------------------------------------------------XXX---------------------------------------------------XXX----------
--------------------------------------------------------------------------------------------------------------------------------------------------------------------------------------------------------------------------------------------------------------------------XXXX----------
-------------------------------------------------------------------------------------------------------------------------------------------------------------------------------------------------------------------------------------------------------------------------XXXXX----------
--E--QQ--SSS----------------------------------X----------------------------------SS---------------------------E---SSS-------------------------SSS----------------------------------------------------X-----------------------?SSX-------------XXXXX--------------------X-XXXXX----------
-<>---------------------------------------EXXXX--------------------------------------------------------------<>------------------------E----------------------X--------------------------------------X----------------------------------------------------------------XXXXXXXX----------
-[]---------------------------------------XXXXX--------------------------------------------------------------[]-----------------------<>----------------------X-------------------------------------XXX--------------------------------------------------------------XXXXXXXXX----------
-[]---------------EE----------------------XXXXX-----------------------------------E--------E-----------------[]-----------------------[]-X--------------------X-------------------------------------XX-------------------------------------------------------E-E-----XXXXXXXXX---------X
XXXXXXXXXXXXXXXXXXXXXXXXXXXXXXXXX--XXXXXXXXXXXXXX----XXX---XXXXXX----XXX-----XXXXXXXXXXXXXXXX-----XX-----XXXXXXXXXXXXXXXXXXXXXXXXXXXXXXXXXXXXXXXXXXXXXXXX--XXXXXXXXXXXXXXXXXXXXXXXXXXXXX--------XXXXXXXXXXXXXXX--XXXXXXXXXXXXXXXXXXXXX---XXXXXX----XXXX-XXXXXXXXXXXXXXXXXXXXXX-XXXXXX--X
