----------------------------------------------------------------------------------------------------------------------------------------------------------------------------------------------------------------------------------------------------------------------------------------
----------------------------------------------------------------------------------------------------------------------------------------------------------------------------------------------------------------------------------------------------------------------------------------
----------------------------------------------------------------------------------------------------------------------------------------------------------------------------------------------------------------------------------------------------------------------------------------
----------------------------------------------------------------------------------------------------------------------------------------------------------------------------------------------------------------------------------------------------------------------------------------
----------------------------------------------------------------------------------------------------------------------------------------------------------------------------------------------------------------------------------------------------------------------------------------
-------------------------XXX---S----S--------------SSSS-------------------------------SS---SS----S--------SSSS----------QQSSSQ-----------------------------------------------------------------------------------------------------------------------------------------------E----------
----------------------------------------------------------------------------------------------------------------------------------------------------------------------------------------------------------------------------------------------------------------------------XXXX--------
----------------------------------------------------------------------------------------------------------------------------------------------------------------------------------------------------------------------------------------------------------------------------------------
----------------------------------------------------------XXX-------------------------E---------------------------S-----------------------E---------------------------------------------------------------------------------------------------------------------------------------------
--------------------SS-SS-------------------------------------------SSS-------------SSSSS-------------XX-------------------SSSSS---------<>------------------------------X---------------------SSSSS-------------XXXXX-----------------------------------------------------------------Q
-------------------------------------------------------------------------------------------E----------XX---------------------------------[]---------------------------------------------------------------------------------------------------------------------------------------------
----------------------------------------------X-------------------------------------------<>--------XXXX---------------------------------[]-----------------------------------------------------------------------------------------------------------------XXXX------------------------
----------------------------------------------E-------------------------------------------[]-------XX-XX---------------------------E-----[]------------------------------X-----E-E---------------------------------------------------------------------------------------E--------------
XXXXXXXXXXXXXXXXXXXXXXXXXXXXXXXXXXXXXXXXXXXXXXXXXXXXXXXXXXXXXXXXXXXX----XXX---------XXXXXXXXXXXXXXXXXXXXXXXXXXXXXXXXXXXXXX-XXXXXXXXXXXXXXXXXXXXXXXXX------XXXXXXXXXXXXXX---XXXXXXXXXXXXXXXXXXXXXXXXXXXXXXX--XXXXX---------------XXXXXXXXX-----XXXXXXXXXXXXXXXXX-XXXXXXXXXXXXXXX-XXXXXXXX
