----------------------------------------------------------------------------------------------------------------------------------------------------------------------------------------------------------------------------------------------------------------------------------------
----------------------------------------------------------------------------------------------------------------------------------------------------------------------------------------------------------------------------------------------------------------------------------------
------------------------------------------------------------------------------------------------------------------------------------------------------------------------------------------------------------------------------------------------------------SSSSSSSSSSSSSSSSSSSSSSSSSSSS
----------------------------------------------------------------------------------------------------------------------------------------------------------------------------------------------------------------------------------------------------------------------------------------
----------------------------------------------------------------------------------------------------------------------------------------------------------------------------------------------------------------------------------------------------------------------------------------
----SSSSSSSSS--------------S--------------------------------------------------------------------------------------------------------------------------------X----------------------XXX-----------------------------------------XQ---------------------------SSS-------------------------
-----------------------------------------------------------------------------------------------------------------------------------------------------------XX---------------------------------------------------------------------------------------------------------------------------
X----------------------------------------------------------------------------------------------------------------------------------------------------------XXX--------------------------------------------------------------------------------------------------------------------------
---------------------------------------------------------------------------------------------------------------------------------------------------------XXXXX---------------------------------------------------------------------------------------------------------------------SS---
------SSSSSSQQ----------------------SQS------------------------------------------SS----------------------------------------------------------E---------XXXXXX--------------------------XXSSSSS-----------------------------------------------XXXXX----------SSSS---------------XX------X
-----------------------E-----------------------E--------------------------------------------------------------------------------------------<>-------XXXXXXXX----X--------XX---------------------------------------------------------------------------------------E---------XXXX------X
----------------------<>-X------------------<>-X------XX------------------------------------------------------------------------------------[]-------X-XXXXXX----XX--------------------------------------------------------------------------X--------------------<>--------XXXXX------X
-------------------EE-[]-X--------E---------[]-------XXX-------EE-----------------------------------------------------------E---------------[]-EE-------XXXXX----X------------------------------------------------------------------------------------------------[]-------XXXXXX------X
XXXXXXXXXXXXXXXXXXXXXXXXXXXXXXXXXXXXXXXXXXXXXXXXXXXXXXXXXXXXXXXXXXXXXXXXXXXXXXXXXXXX---X-------XXXXXXXXXXXXXXXXX--XXXXXXXXXXXXXXXXXXXXXXXXXXXXXXXXXXXXXXXXXXXXXXXXXXXXXX--------------X---XXXXXXXXXXXXXXXXXXX--XXXXXXXXXXXXXXXXX---XX----XXXXX--------------XXXXXXXXXXXXXXXXXXXX---XXXXX
