----------------------------------------------------------------------------------------------------------------------------------------------------------------------------------------------------------------------------------------------------------------------------------------
----------------------------------------------------------------------------------------------------------------------------------------------------------------------------------------------------------------------------------------------------------------------------------------
----------------------------------------------------------------------------------------------------------------------------------------------------------------------------------------------------------------------------------------------------------------------------------------
-------------------------------------S--------------------------------------------------------------------------------------------------------------------------------------------------------------------------------------------------------------------------------------------------
----------------------------------------------------------------------------------------------------------------------------------------------------------------------------------------------------------------------------------------------------------------------------------------
-------------------------------SSSSSSSSSS----------------S------------------------------------------X-----------------------------------------------------------------------------------------------------------------SS----------------------------------------------------------------
----------------------------------------------------------------------------------------------------XX--------------------------XXXX------------------------------------------------------XX--------------------------------------------------------------------------------------------
---------------------------------------------------------------------------------------------------XXX----------------------------------------------------------------------------------------------------------------------------------------------------------------------------------
--------------------------------E------------------E----------------------------------------------XXXX------------------------------------------------------------------------------------------------XXX-------------------------------------------------------------------------------
--------------------------------SSSSSSSS----------<>-------S-----Q--------------------------------XXXX---------------------------SS-S------S----------------E-------------------------------SS--S-SS------------XXX--------------------------------------------------------X------------
------------------------------E-------------------[]---------------------------------------------XXXXX---------E-E-----------------------------------------<>-----------------------------------------------------------------------------------E-----------------------XX--------------
-----------------------------SS-------------------[]------------------------------XX------------XXXXXX---------XXXXX---------------------------------------[]-----------XX---------------------------------------------------------------------<>----------------------XXX--------------
--E-------E--------------EE-------------------E---[]-----------------------------XXX-E-E-------XXXXXXX---------X--------------------------------E------E---[]-----------XX----------------------------------------------------------EE----E----[]----------------------XXX----------E---
XXXXXXXXXXXXXXXXXXXXXXXXXXXXXXXXXXXXXXXXXXXXXXXXXXXXXXXXXXXXXXXXXXXXXXXXXXXX--XXXXXXXXXXXXXXXXXXXXXXX--XXXXXXXXX-----XXXX----XXXXXXXXXXXXXXXXXXXXXXXXXXXXXXXXXXX-----XXX---XXXXXXXX-XXXXXXXXXXXXXXXXXXX---XXXX-X--XXXXXXXXXXXXXXXXXXXXXXXXXXXXXXXXXX--XXXXXXXXXXXXX---XXXXX---XXXXXXXXXX
