----------------------------------------------------------------------------------------------------------------------------------------------------------------------------------------------------------------------------------------------------------------------------------------
----------------------------------------------------------------------------------------------------------------------------------------------------------------------------------------------------------------------------------------------------------------------------------------
----------------------------------------------------------------------------------------------------------------------------------------------------------------------------------------------------------------------------------------------------------------------------------------
----------------------------------------------------------------------------------------------------------------------------------------------------------------------------------------------------------------------------------------------------------------------------------------
----------------------------------------------------------------------------------------------------------------------------------------------------------------------------------------------------------------------------------------------------------------------------------------
---------------------------------------?SSS-----------------------------------------SSSSS--SS--------------SSS---------------------------XXX-----------?SSS-----XXX---------------------------------------------------------------------------------------------------------------------
----------------------------------------------------------------------------------------------------------------------------------------------------------------------------------------X-----------------------------------------------------------------------------------------------
---------------X------------------------------------------------------------------------------------------------------------------------------------------------------------------------------------------------------------------------------------------------------------------------
--------------XX------------XXXXXX--------------------XX-------------------------------------------------------------------------------------XXXXX--------------------XX----------------------------------------------------------------------------------------------------------------
--------------XXX-------------------?---SSS----------X-----------------X--------------SSS--------------------------------------Q-------SS---------------SS--------------------------------------S-SQ-----------------------------------------------------SS-----------------------------
-------------XXXX-----------------------------------XXXX---------------X------------------------------X--------------------------------------X----------------------X--S----------------------------------------------------------------------------------------------E-----------------
-----------XXXXXX-----------------------------------------------------XX----------------------------X-X--------------------------------------------------------------------------------------------------------------------------------------------------------------<>-----------------
---E------XXXXXXX--------------------------------------------------E--XX------------------------------X------------------E------------------XX----------------------------------E----E---------E---------------------------------------E-EE--------------------------[]--------------EE-
XXXXX--XXXXXXXXXXXXXXX--XXXX----XXXX-----XXXXXXXXXXXXX--XXXXXXXXXXXXXXXXXXXXXX--XXXXXXXX--XXXXXXXXXXXXXXX----XXXXXXXXXXXXXXXXXXXXXXXXXXXXXXX------XX-XX----------------------XXXXXXXXXXXXX--XXXXXXXX-----XXXXX--XXXXXXXXXXXXXXXXXXXXXXXXXXXXXXXXXXXXXXXXXXXXXXXXXXXXXXXXXXXXXX----XXXXXX
