----------------------------------------------------------------------------------------------------------------------------------------------------------------------------------------------------------------------------------------------------------------------------------------
----------------------------------------------------------------------------------------------------------------------------------------------------------------------------------------------------------------------------------------------------------------------------------------
--------------------------------------------------------------------------------------------------------------------------------------------SSSSSSSSSSSSSSSSSSSSSSSSSS---------------------SSSSSSSSS---SSSSSSSSS--SS----SS--------------------------------------------------------------
------------------------------------------------------------------------------------------------------------------------------------------------------------------------------------------------------SSSSSSSSSSSSSS----S------S--------------------------------------------------------
-------------------------------------------------------------------------------------------------------------------------------------------------------------------------------------------------------SSSSSSS----SS-----S----SS--------------------------------------------------------
--------------------------------------------------SSSS------------------------------------------------------------------------------------------------------X---------------------------------------S-SSSSSSSSS--SSS----S--------SSSSSSSSSS--SSS--------SSSS------SSSSSS----------------
------------------------------------------------------------------------------------------------------------------------------------------------------------X---------------------------------------------------------------------------------------------------------------------------
------------------------------------------------------------------------------------------------------------------------------------------------------------XX--------------------------------------------------------------------------------------------------------------------------
------------------------------------------------------------------------------------------------------------------------------------------------------------XX-S------------------E---------------------E------------------E--?----------------------------------------------------E----
-----------QQ---------------QQQQ--------------XXXX------------------XX------------------------------X-------------------------------------S-<>---------XXX--X-----X--------------<>--------------------?SSSSSS---------E--<>-------SSSSSSS--------------------E--SS--SSS----------<>----
-----------------------------------E-----XXX-XXXX------------------XXX-----------------------------XX----------E----------------------------[]-------X--XXX-X----XX----E---------[]---------E-----------SSSS----------<>--[]---------------------------------<>-------------------[]----
-------------------------<>-------<>---------XXXX-----------------XXXX----------------------------XXX---------<>----------------------------[]-------X--XXXXXX---XX---<>---------[]--------<>----------SSSS-----------[]--[]----------------------<>---------[]-------------------[]----
-------------------------[]-------[]-------XXXXX----------------XXXXXX-E------E-E----E-E-------E-XXXX---------[]-------E--------------------[]--E-------XXXXXX---XX---[]---------[]--------[]-------------------------[]E-[]----------------------[]E--------[]---------------E---[]----
XXXXXXXXXXXXXXXXX--------XXXXXXXXXXXXXXXX--XXXXXXX----XXXXXXXXXXXXXXXXXXXXXXXXXXXXXXXXXXXXXXXXXXXXXXXXXXXXXXXXXXXXXXXXXXXXXX-XXXXXXXXXXXXXXXXXXXXXXXXXXX---XX---XXXXXXXXXXXXXXXXXXXXXXXXXXXXXXXXXXXXXXXXXXXXX-XXXX-XXXXXXXXXXXXXXXXXXXXXXXXXXXXXXXXXXXXXXXXXXXXXXXXXXXXXXXXXXXXXXXXXXXXX
