----------------------------------------------------------------------------------------------------------------------------------------------------------------------------------------------------------------------------------------------------------------------------------------
----------------------------------------------------------------------------------------------------------------------------------------------------------------------------------------------------------------------------------------------------------------------------------------
----------------------------------------------------------------------------------------------------------------------------------------------------------------------------------------------------------------------------------------------------------------------------------------
----------------------------------------------------------------------------------------------------------------------------------------------------------------------------------------------------------------------------------------------------------------------------------------
----------------------------------------------------------------------------------------------------------------------------------------------------------------------------------------------------------------------------------------------------------------------------------------
----------------------------------------------S-------------------QQQQQ---------SSSS--X------------------------------------------------------------------------XXXXSSS---------------S--------------------------------------------------QQQQQQQ---------SSSS-----SSSSSSSS---------------
----------------------------------------------------------------------------------------------------------------------------------------------------------------------------------------------------------------------------------------------------------------------------------------
----------------------------------------------------------------------------------------------------------------------------------------------------------------------------------------------------------------------------------------------------------------------------------------
----------------------------------------------------------------------------------------------------------------------------------------------XXXX------------------------SSS------------------------------------------------------------------------------------------------------E----
---------------X------------QQQ---------------XX--------------Q---QQQQQQQQ------------------------------------------------------------------------------XXX-------------------------SS-----------------------------------------S-------S?-QSSSQQ-----------------SSSSSSS----------<>----
---------------X--------------------------XXX-----------------------------------------------------------------E-----------------------------------------------------------------------------------------------------------------------------------------------?-------------------[]----
-------------XXX---------------------------------------------------------------------------------------------<>-------------X------------------------------------------------------------------------XX------------------------------------------------------SS-------------------[]----
----------XXXXXX----------------------------------------------------------------------------E---E------------[]---------E-XXX-----------EE-E---------------------------------------------------------------------E---------E-----------------------E--------------------------E---[]----
XXXXX--XXXXXXXXXXXXXXX--XXXXXXXXXXX---XXXXXXXXXXXXXXXXXXXXXXXXXXXXXXXXXXXXX---------XXXXXXXXX-XXXXXXXXXXXXXXXXXXXXXXXXXXXXXXXXXXXXXXXXXXXXXX------XXXXX-----XXXXXXXX----XXXXXXXXX---XXXXXXXXXXXXXX--XX---XXXXX--XXXX----XXXXXXXXXXXXXXXXXXXXXXXXXXXXXXXXXX--XXXXXXXXXXXXXXXXXXXXXXXXXXXX
