----------------------------------------------------------------------------------------------------------------------------------------------------------------------------------------------------------------------------------------------------------------------------------------
----------------------------------------------------------------------------------------------------------------------------------------------------------------------------------------------------------------------------------------------------------------------------------------
----------------------------------------------------------------------------------------------------------------------------------------------------------------------------------------------------------------------------------------------------------------------------------------
----------------------------------------------------------------------------------------------------------------------------------------------------------------------------------------------------------------------------------------------------------------------------------------
------------------------------------------------------------XX--------------------------------------------------------------------------------------------------------------------------------------------------------------------------------------------------------------------------
----------------------------------------------------------------------------------------------------------------------------------------------XX----------------------------------------------------------------------------------------------------------------------------------------
--------------------------------------------------------------------------------------------------------------------------------------------------------------------------------------------------------------------X-------------------------------------------------------------------
-----------------------------------------------------------------------------------------------------XX---------------------------------------------------------------------------------------------------------------------------------------------------------------------------------
-----------------------------------------------------------------------------------------------------XX---------------------------------------------------------------------------------------------------------------------------------------------------------------------------------
---------------Q----------------------------E-----------XQQ--------------XEXXX----------------------XXX-----------------------------------E-------------------------------------------------S----SSS-----------------------SSSSS--------------------------------------------------------
-------------------------------------------<>------------------------XXXXXXXX----------------------XXXX----------X-----------------------<>-----------------------------------------------------------------------------------------------------E---------------------------------------
-------------------------------------------[]------------------------------X----------------------XXXXX----------------------------------[]-----------------------------XXX--------------------------X-----------------------------------------<>---------------------------------------
---------E----------------------E----------[]-----------------------------------------------------XXXXX----------X-----------------------[]---------E---E----------E-E-------------------------------------EE---------------------E-------E----[]---------------------------------------
---XXXXXXXXXXXXXX--------XXXXXXXXXXXXXXXXXXXXXXXX--X-XXXXXXXXXX---XXXX-----XXXX-XXXXXXXXXXXXXXXXXXXXXXXX-------XXXXXXXXXX------X--------XXXXXXXXXXXXXXXXXXXXXXXXXXXXXXXXXXXXXXXXXX---XXXXXXXXXXXXXXX----XXXXXXXXXXXXXXX-XXXXXXXXXXXXXXXXXXXXXXXXXXXXXXXXXXXXXXXXXXXXXXXX-XXXXXXXXXXXXXXX
