----------------------------------------------------------------------------------------------------------------------------------------------------------------------------------------------------------------------------------------------------------------------------------------
----------------------------X---------------------------------------------------------------------------------------------------------------------------------------------------------------------------------------------S-------------------------------------------------------------
----------------------------------------------------------------------------------------------------------------------------------------------------------------------------------------------------SSSSSSSSSSSSSSSSSSSSSSSSSSSSSSSSSSSSSSSSSSSSSSSSSSSSSSSS----------------------------
----------------------------------------------------------------------------------------------------------------------------------------------------------------------------------------------------SSSSSSSSSS-SS--------SSSSSSS--------------------------------------------------------
----------------------------------------------------------------------------------------------------------------------------------------------------------------------------------------------------SSSSSSSSSS?---------SSSSSSSS--------------------------------------------------------
------------------------------------------------------------------------------------------------SS--------------X---SSSSSSSSS------------------------------------------------------------XXX--------SSSSSSSSSS---SS--------S--SS--------------------------------------------------------
----------------------------------------------------------------------------------------------------------------------------------------------------------------------------------------------------------------------------------------------------------------------------------------
---------------------------------E----------E-------------------------------------------------------------------X-----------------------------------------------------------------------------------------------------------------------------------------------------------------------
---------------------------------E---------<>------------------------------------------XXXX-------------------XX------------------------------------------------------------XXX-------------------E--?-E-------------------SS-------------E---------------------------------------------
------Q---------E---------------<>---------[]-----------------------------------------------------------S-------------SSSS--?SS----------X-------------------------------X-----------------------<>-SSSSSSSSS----------E?------X---S-----<>-----------------------------------------S---
---------------<>---------------[]---------[]----E-----------------------------------X---------------------------------------------------XX------------------------------------------------------[]-----SSSSSS--------<>-----------------[]--------<>------X----------------------------
---------------[]---------------[]---------[]---<>-------------------X-------------------------------------------------------------------XX------------------------------------------------------[]----SSSSSS-------XX[]X-------SS-------[]--------[]-----------------------------------
---------------[]-E-------------[]---------[]---[]------------------E---------------XXX---------------------------------------------E-E--XX-------------------------------X----------------------[]----SSSSSS-------XX[]X------XS--------[]--------[]------X----------------------------
XXXXXXXXXXXXXXXXXXXXXXXXXXXX-XXXXXXXXXXXXXXXXXXXXXXXXXXXXXXXXXX-XXXXXXXXXXXXXXXXXXXX------XXXXX---XXXXXXXXXXX---XXXXXXXXXXXXXX--XXXXXXXXXXX----XXXXXXXXXXXXXXXXXXXXXXXXXXXX--XXX---------XXXXXXXXXXXXXXXXXXXXXXXXXXXXXXXXXXXXXXXXXXXXXXXXXXXXXXXXXXXXXXXXXXXXXXXXXXXX---XXXXXXXXXXXXXXXX
