----------------------------------------------------------------------------------------------------------------------------------------------------------------------------------------------------------------------------------------------------------------------------------------
----------------------------------------------------------------------------------------------------------------------------------------------------------------------------------------------------------------------------------------------------------------------------------------
------------------------------------------------------------------------------------------------------------------------------------------------------------------------------------------------------SSSSSSSSSSSSS-----SSSSSSSS--------------------------------------------------------
------------------------------------------------------------------------------------------------------------------------------------------------------------------------------------------------------SS-SSSSSSSSS----------------------------------------------------------------------
-------------------------------------------------------------------------------------------------------------------------------------------------------------------------------------------------------S-SSSSSSSSS------------S---------------------------------------------------------
-----------------S-----------XXX------------------------------------------------------XXXX---------E---------------------------------------------------------------------S-----------------------------SSSSSSSSSS--S----------SS--S--------------------SSS------------------------------
-----------------------------------------------------------------------------------------------------------------------------------X-----------------------------------------------------------------E----------------------------------------------------------------------------------
---------------XX---------------------------------------------------------------------------------------------------------------------------------------------------------------------------------------------S-------------------------------------------------------------------------
-------------------------------------------------------------E----------E-----------------------------------------------------------------XE------------------------------------------------------------E-----S--------------------------------------------------E----------E-----------
-----------------------------------------------------------------------<>-----------------------X----------------XX------------------------S-------------XXX------------SSSQ--------------XX----------E-SSSSSSSS------------------------------------------------<>---------<>----------E
---------------------E---------------------------------------E---------[]-----------------------X----------------XX-------------------------------------XXXX-------------------E---------XXX----------E---------------------------------------------------------[]---------[]---------<>
---------------X----<>-----[--------------------------------<>---E-----[]-----------------------X---------------XXXX-----------------------------------XXXXX------------------<>--------XXXX-------X-SS--X------------<>----------------------------------------[]---------[]---------[]
-E--EE-----E--EX----[]-----[--------E---E----------E-EE-----[]---E-----[]----------------EE-E---X--------EEE-E-EXXXX----------------------------------XXXXXX--------E---------[]-------XXXXX-----XXX-[]------E--------[]----------------------------------------[]---------[]---------[]
XXXXXXXXX-XXXXXXXXXXXXXXXXXXXXXXXXXXXXXXXXXXXX--XXXXXXXXXXXXXXXXXXXXXXXXXXXX--XXXXXXX-XX-XXXXXXXXXXXXXXXXXXXXXXXXXXXXXXXX-----XXXXXXXXXXXXXXXXXXXXX--XXXXXXXXXXXXXXXXXXXXXXXXXXXXXXXXXXXXXXXXXXXXXXXXXXXXXXXXXXXXXXXXXXXXXXXXXXXXXXXXXXXXXXXX--XXXXXX---------XXXXXXXXXXXXXXXXXXXXXXXXXX
