----------------------------------------------------------------------------------------------------------------------------------------------------------------------------------------------------------------------------------------------------------------------------------------
----------------------------------------------------------------------------------------------------------------------------------------------------------------------------------------------------------------------------------------------------------------------------------------
--------------------------------------------------------SSSSSSSSSSSSSSSSSSSSSSSSSSSS----------------------------SSSSSSSSSSSSSSSSSSSSSSSSSSSS--------------------------------------------------------------------------------------------------------------------------------------------
---------------------------------------------------------------------------------------------E------------------S----------------------------------------------------------------------------------------------------------------------------------------------------E------------------
---------------------------------------------------------------------------------------------XXX-------------------------S?------------------------------------------------------------------------------------------------------------------------------------------XXX----------------
------------------XX------------------------------------SSS--------------------SS-------------------------------------------------------------------------------------------------------------------------------------------XXXX--XX------------------------------------EQQ-------------
------------------------------------------------------------------------------------------------------------------------------------------------------------XXX-------------------------------------------------------------------------------------------------------------------------
------------------------------------------XX-------------------------------------------------------------------------------------------E--------------------XXX----------------------------------------------------------------------------------------------------S--------------------
---XXXX----------------------------------XXX-----------------------------------SS--------SS---------------------E---------E-----------<>--------------------XXX-----------------------------------------------------------------------------------------------SSSSSSS-------------------
-----------------------------------------XXX------------SSSS---------------XX------------------E--QQQ---------E->--S-----[]---------E-[]---X--------Q-X-----XXX---X--------------------X------------------------------------------------------------SSSSSSSS-----------QQQSQ---------<>-
-------------------------E------------XXXXXX-----------<-------E---------X-XX--------------------------------<>-SSSSS----[]--------<>-[]---X-------------XX-XXX---X------------------------------------------------------------------------------------------------------------------[]-
-------------------------------------XXXXXXX-----------[------<>--------XXXXX--------------------------------[]-SS?SS----[]--------[]-[]---X------------XXXXXXX---X------------------EXX---------------------------------------------------------------------------------------------[]-
------------------------------------XXXXXXXX--------E--[]-----[]-------XXXXXX----------------E---------------[]-SSSS--ES-[]--------[]-[]--XXEE-E--------XXXXXXX---X----------------E-XXX-------------------EE-E----------------------EEEE---E--------EEE-------------E---------------[]-
---------------XXXXXXXXXXX--XXXXXXXXXXXXXXXXXXXXXXXXXXXXXXXXXXXXXXXXXXXXXXXX----XXXXXXXXXXXXXXXXXXXXXXXXXXXXXXXXXXXXXXXXXXXXXXXXXXXXXXXXXXXXXXXXXXXXXXXXXXXXXXXXXXXXXXXXXXXXX---XXXXXXXXXXXXXXXXXXXXXXXXXXXXXXXXXXXXXXX------XXXXXXXXXXXXXXXXXXXXXXXXXXXXXXX--XXXXXXXXXXXXXXXXXXX-XXXXXX
