----------------------------------------------------------------------------------------------------------------------------------------------------------------------------------------------------------------------------------------------------------------------------------------
--------------------------------------------------------X-------------------------------------------------------------------------------------------------------------------------------------------------------------------------------------------------------------------------------
----------------------------------------------------------------------------------------------------------------------------------------------------------------------------------------------------------------------------------------------------------------------------------------
----------------------------------------------------------------------------------------------------------------------------------------------------------------------------------------------------------------------------------------------------------------------------------------
---EE----------------E---------------------------------------------------------------------------------------------------------------------------------------------------------------------------------------------------------S--------------------------------------------------------
---SS--------------SSSSSSSS---------------------------XX---------------------------------------------------------------------------------------------------------------------------------------------------S---------SSS-------------------------SSS---------XXX------------------------
---------------------------------------------------------------------------------------------------X------------------------------------------------------------------------------------------------------------------------------------------------------------------------------------
--------------------------------------------------------------------------------------------------XX------------------------------------------------------------------------------------------------------------------------------------------------------------------------------------
--EX--------------------------------------------------------------E------------E-----------------XXX------------------------------------------------------------------------------E-----------------------------------------------------------------------------------------------------
-XXXX--------EE----XXX---------------------------------------E---<>-----E-----<>---E-------------XXX------------X---------------XXXX---------------------X-XX----------------E---<>-----E-----------SXXXX-------------XX------XXSQQXX-------------XX--<>-----------------------------SSS
-------E---EXX----------------------------------------------<>---[]----<>-----[]--<>----------XXXXXX--------------------------XX------------------------XX-----------------------[]----<>---E--E---E-------E---EX-----XX------------------------------[]--------------------------------
------XX--------X-------------------------------------------[]---[]----[]-----[]--[]---------XXXXXXX----------------------------------------------------XX-----------------------[]----[]--<>-<>--XX------<>----------XX------X-------------------X---[]--------------------------------
----------------X-------------------------------------------[]---[]----[]-----[]--[]--------XXXXXXXX--------E------------------------------------------XXX-------E--E------------[]----[]--[]-[]--XX------[]-------XX-XXX-E--XXX----------------------[]-----------EE--------------E----
X------XXXX----XXXXXXXX--XXXXXXXXXXXXXXXXXXXXXXXXXXXXXXX-XXXXXXXXXXXXXXXXXXXXXXXXXXXXXXXX-XXXXXXXXXXXXXXXXXXXXXXXX-------XXX----------------XXXXXXX-XXXXXXXXXXXXXXXXXXXXXXXXXXXXXXXXXXXXXXXXXXXXXXXXXXX--XXXXXXXX--XXXXXXXXXXXXXXXXXXXXX---XX--XXXXXXXXXXXXXXX--XXXXXXXXXXXXX----XXXXXXX
