----------------------------------------------------------------------------------------------------------------------------------------------------------------------------------------------------------------------------------------------------------------------------------------
----------------------------------------------------------------------------------------------------------------------------------------------------------------------------------------------------------------------------------------------------------------------------------------
------------------------------------------------------------------------------------------------------------------------------------------------------------------------SSSSSSSSSSSSSSSSSSSSSSSSSS--------------------------------------------------------------------------------------
----------------------------------------------------------------------------------------------------------------------------------------------------------------------------------------------------------------------------------------------------------------------------------------
----------------------------------------------------------------------------------------------------------------------------------------------------------------------------------------------------------------------------------------------------------------------------------------
-S-------------------------------------------------SSSSX--------------------------------------------S-----------------------------------------------------------------------------------X--------------------------------------------------?SSS------------------------------------SS---
----------------------------------------------------------------------------------------------------------------------------------------------------------------------------------------XX----------------------------------------------------------------------------------------------
-----------------XX---------------------------------------------------------------------------------------------------------------------------------------------------------------------XX----------------------------------------------------------------------------------------------
----------------XXX---------------------------------------------------------------------------------E-----------------------------------------------------------------------------------XXXS-------------------------------------XXXXX--------------------XX----------------------------
--------Q-------XXX--------------------Q---Q--------S-------------------------SS---------E---------<X----------E---------------XXX----------------Q----Q----Q-----------<>------Q---X---XX----X---------------------------------------------SS-----------X--QQQ---------------X---------
---------------XXXX--------E---------------------------------E----------E---------------<>---------X]----X-----E--------------------------------------------------------<>----------XXX-XX---XX----E-----E----------E----E-------X----------------------XEXS---------------XXXXX--------
-------------XXXXXX-------<>-------------------------------------------<>---------------[]---------[]----X----<>--------------------------------------------------------[]----------XXXXXX---XX---XX----<>---------<>------------------------------------------------------XXXXX--------
---E--------XXXXXXX-------[]------------------E-------------EE----E----[]-----E-----EE--[]-----E-XX[]----X----[]----------------------------------------------E---------[]-E--------XXXXXX---XX----X----[]---------[]-----------XXX----------------------------------------XXXXX--------
XXXXXXXXXXXXXXXXXX----XXX-XXXXXXXXXXXXXXXXXXXXXXXXXX-XXXXXXXXXXXXXXXXXXXXXXXXXXXXXXXXXXXXXXXXXXX---XX---XXXXXXXXX----X--XX-XXXXX--XXXXXXXXXXXXXXXXXXXXXXXXXXXXXXXXXXXXXXXXXXXXXXXXXXXXXXXX----XXX-XXXXXXXXXXXXXXXXXXXXXXXXXXXXXX----XXXX-----XXXXXXXXXXXXX--XXXXXXXXXXXXXXXXXXXXXXXXXXXX
