----------------------------------------------------------------------------------------------------------------------------------------------------------------------------------------------------------------------------------------------------------------------------------------
----------------------------------------------------------------------------------------------------------------------------------------------------------------------------------------------------------------------------------------------------------------------------------------
---------------------------------------------------------------------------------------------------------------------------------------------------------------------------------------------------------------------------S------------------------------------------------------------
----------------------------------------------------------------------------------------------------------------------------------------------------------------------------------------------------------------------------------------------------------------------------------------
--------------------------------------------------------------------------------------------------E--------------------XX---------------------------------------------------------------------------------------------------------------------------------------------------------------
SS------------------------------------------------------X-------QQSSSSS-------------E----------------E----------------------SSS----XXXX--------------------X-------------------------------------------S-SSSSSSS--------------SS-----------------X------------------------------------XX
---------------------------------------------------------------------------------------XXXXX-------------XXXXX---------------------------------------------XX----------------------------------------------------------------------------------XXX--------------------------------------
--------------------------------------------------------E-------------------------------------------------------------------------------------------------XXX---------------------------------------------------------------------------------XXXX--------------------------------------
--------------------------------------------------------XXX-----------------------E-----------------------------XXXXXXX-------------------XX-------------XXXX--------------------------------------------------------------------------------XXXXX--------------------------------------
QQ----------------X------------------------<>------------------S?S-SSSSS---------<---------------XXXXXX---------------------XX-----------X---------------XXXX------------XQX--------------XX------------SSSSSSS------------------------------XXXXX---------E----------------------SSSSSS
--------------EXXXXX-----------------------[]------------------------------------[]-----------------------------------------------------XXXS----------XXXXXXX----------E--------------XX--------------E-----------------------------------X-XXXXXX--------<>----------------------------
---------------X-XX-------X----------------[]------------------------------------[]------------------------------------------------------------------XXXXXXXX---------<[----------------------------------------------->-----------------XXXXXXXXX--------[]----------------------------
-------------------------XXX---------------[]------------------------------E-----[]----------------------------------------------------------E-E----XXXXXXXXX---------[[-------------------------------------E--------E]-----------E-----XXXXXXXXX--------[]-------E-EE-----------------
XXXXXXXXXXXXXXXX-------XXXX-XXXXXXXXXXXXXXXXXXXX---XXXXX---XXXXXXXX-XXXXXXXXXX-----------X--------------------------------------XXXXXXXXX---XXXXXXXXXXXXXXXXXX-----XX--XXXX-------X-----------------XXXXXXXXXXXXXXXXXXXXXXXXXXXXXXXXXXXXXXXXXXXXXXX--XXXX-XXX-XXXXXXXXXXXXXXXXXXXXXXXXXX
