----------------------------------------------------------------------------------------------------------------------------------------------------------------------------------------------------------------------------------------------------------------------------------------
----------------------------------------------------------------------------------------------------------------X-------------------------------------------------------------------------------------------------------S---------------------------------------------------------------
----------------------------SSSSSSSSSSSSSSSSSSSSSSSSSSSS-----------------------------------------------------------------------------------------------------------------------------------------------SSSSS------SS----SS--------------------------------------------------------------
------------------------------SSSSSSSSSSSSSS----SS-S--SS-----------------------------------------------------------------------------------------------------------------------------------------------SSSSSSSSSSSSS----S-----SS--------------------------------------------------------
----------------------------X-SSSSSSSSSSSSSS----SSSS--SS-----------------------------------------------------------------------------------------------------------------------------------------------SSSSSSSS-S-SS----SS----SS--------------------------------------------------------
-X---------------------------SSSSSSSSSSSSSSS----------SS----------SSSS------------------------------------------------------S---SSS---------------------------------------------------------------XX---SSSSSSSSSSSSS----SS----SS------------XXX-----------------------------------------
----------------------------ES------------------------------------------------------------------------------------------------------E---------------------------------------------------------------EE--------------------------------------------XXX-----------------------------------
--------------------------------------S------------------------------------------------------------XXXXX-------------E---------------E--------------------------------------------------------------------------------------------------------------------------------------------------
--------------------------------E-----S-----------------XXXXXX--------------------E----------------------------------E----------E-----------------------------------------------------------------------E-------------------------------------------------XX----------------------------
-------------------------------SSSSSSSSS-----------------------S?--SSSS----------<>---------------------------------<>---------<>----------E-------------------------------------------------SSSSSS----?SSSSSS----------------X--X--------------------------X-----------------X---------
---------------X--------------E--------------------------------------------------[]-------------X--------------<----[]---------[]----X----<>-----E----------E--------------------------------------------------------------E-----X----------------------------------------XXXX----------
-----------------------------SSSSX----S-------<>---------------------------------[]-------------X--------------[----[]---------[]---<>X---[]----<>---------<>--------------------------------------------X------------<---<>----XXX-----------------------------------------------------
-----------------------------[]------E--------[]---------------------------E-----[]--EE--EE-EXXXX-EE--------E-E[[E--[]-----E-E-[]---[]]---[]----[]-----E---[]----------E-------E--E-----------------------------------E]E-[]-X--XXX-----------------------------------------------------
XXXXX--XXXXX----------------XXXXXXXXXXXXXXXXXXXXXXXXXXXX--XXXXXXX---XXXXXXXXXXXXXXX-XXXXXXXXXXXXXXXXXXXXXXXXXXXX-XXXXXXXXXXX---XX---XXXXXXXXXXXXXXXXXXXXXXXXXXXXX-XXXXXXXXXXXXXXXXXXXXXXXXXXXXXXXXXXXXXXXXXXXXXXXXXXXXXXXXXXXXXX-------XXXX----X-----XXXX--XXX--XX----XX----------------
