--------------------------------------------------------------------------------------------------------------------------------------------X-------------------------------------------------------------------------------------------------------------------------------------------
-----------------------------------------------------------------------------------------------------------------------------------------------------------S----SSS----S----------------------------------------------------------------------------------------------------------------
----------------------------------------------------------------------------------------------------------------SSSSSSSSSSSSSSSSSSSSSSSSSSSSS-SSSSSSSSSSSSSSSS--SSSSSSSS----------------------------------------------------------------------------------------------------------------
----------------------------------------------------------------------------------------------------------------------------------------------SSSSSSSSSSSSSS----SSSSSSSS----------------------------------------------------------------------------------------------------------------
--------------------------------------------------------------------------------------------------------------------------------------------SSSSSSSSSSSSSSSS----SSSSSSSS----------------------------------------------------------------------------------------------------------------
--------------------------------------------------------------------------------------XX------------------------------------------------------SSSSSSSSSSSSSS----SS----SS-----------XXX-----X---------------------------------------------------X----------------------------------------
----------------------------------------------XX--------------------------------------------------------------------------------------------EE-S----------------------------------------------------------------------------------------------XX----------------------------------------
----------------------------------------------------------------------------------------------------------------------------------------------------------------------------------------------------------------------------------------------XX----------------------------------------
------------------------------------------------------E-------------------------------------------------------------------E---------------------E------------------?-------XXXX-------------------XX----------------------------------------XXXXX---------------------------------------
---------------------------S-X--------------------------SSSQ--------------XX-------------------------------S-S-->--S-----<>--------------------?SSSSSSS--------E-----XXX-------------------------------------------------------------------X-XXX-------------------------X--------------
-----------------------------X---------------------------------E---------XXX--------------------X------------------S-----[]--------<>---------E-SSSS----------<>---E-----X-----------------------E----------------------------------------XXXXXXX-----------------------XX--------------
----------------------------XXX-------------------------------<---------XXXX-------X------------X---------------SS-S-----[]--------[]--------SSSSSSS----------[]--<>---------------------------------------------------------------------XXXXXXXX----------------------XXX--------------
----------------------------XXXX------------------------------[]-------XXXXXX-----XX------E-E---X--------EEE-E--S-----E--[]--------[]----------------E--------[]E-[]--X--X----------------------------------E-EEE----------------E-EE---XXXXXXXXX----------E----------XXXX----------EE-E
XXXXXXXXXX---XXXXXXXXXXXXXXXXXX-XXXXXXX----X--X-XXXXXXXXXXXXXXXXX-XXXXXXXXXXXXXXXXXX-----XXXXXXXXXXXXXXXXXXXXXXXXXXXXXXXXXXXXXXXXXXXX--XXXXXXXXXXXXXXXXXXXXXXXXXXXXXXXXX----------------------------X-XXXXXXXXXXXXXXXXXX-XXXXXXXXXXXX--XXXXXXXXXXXXX-X-XXXXXXXXXXXX--XXXXXXXXXXXXXXXXXXX
