----------------------------------------------------------------------------------------------------------------------------------------------------------------------------------------------------------------------------------------------------------------------------------------
---------------E-----------S--------------------------------------------------------X-------------------------------------------------------------------------------------------------------S-------------------------------------------------------------------------------------------
--------------<>-----------S-----------------------------------------------------------------------------------------------------------------------------------------------SSSSS------SS----SS------------------------------------------------------------------------------------------
-EEE----------[]-----S---S-S-----------------------------------------------------------------------------------------------------------------------------------------------SSSSSSSSSSSSS----S-----SS------------------------------------------------------------------------------------
-XXXXXXXX-----[]-----E---SSS-----------------------------------------------------------------------------------------------------------------------------------------------SSSSSSSS-S-SS----SS----SS------------------------------------------------------------------------------------
?-----?----------??SSSS---------------SSSS------------------------------------------------------S---SSS---------------------------------------------------------------XX---SSSSSSSSSSSSS----SS----SS------------XXX---------------------------------------------------Q-----------------
--------------------------------------------------------------------------------------------------------E---------------------------------------------------------------EE--------------------------------------------XXX---------------------------------------------------------------
---E-------------------------------------------------------------------XXXXX-------------E---------------E------------------------------------------------------------------------------------------------------------------------------------------------------------------------------
X--X------------------------XXXXXX--------------------E----------------------------------E----------E-----------------------------------------------------------------------E-------------------------------------------------XX--------------------------------------------------------
-XXXXS--------E----XXX---XXX-------S?--SSSS----------<>---------------------------------<>---------<>----------E-------------------------------------------------SSSSSS----?SSSSSS----------------X--X--------------------------X-----------------X-------------E-Q---QQQ--QQ-----------
------SX---EXX------------XX-------------------------[]-------------X--------------<----[]---------[]----X----<>-----E----------E--------------------------------------------------------------E-----X----------------------------------------XXXX--------------------------------------
-----SSX--------X--------XX--------------------------[]-------------X--------------[----[]---------[]---<>X---[]----<>---------<>--------------------------------------------X------------<---<>----XXX---------------------------------------------------------------------------------
---------------XX---XXX------------------------E-----[]--EE--EE-EXXXX-EE--------E-E[[E--[]-----E-E-[]---[]]---[]----[]-----E---[]----------E-------E--E-----------------------------------E]E-[]-X--XXX---------------------------------------------------------------------------------
------------------------------XXXXXXX---XXXXXXXXXXXXXXX-XXXXXXXXXXXXXXXXXXXXXXXXXXXX-XXXXXXXXXXX---XX---XXXXXXXXXXXXXXXXXXXXXXXXXXXXX-XXXXXXXXXXXXXXXXXXXXXXXXXXXXXXXXXXXXXXXXXXXXXXXXXXXXXXXXXXXXXX-------XXXX----X-----XXXX--XXX--XX----XX----------------XXXXXXXXXXXXXXXXXXXXXXXXXXXX
