----------------------------------------------------------------------------------------------------------------------------------------------------------------------------------------------------------------------------------------------------------------------------------------
---------------------------------------------------------------------------------------------------------------------------------------------------------------------------------------------------------------------------------------------------------------------------E----S------S
------------------------------------------------------------------------------------SSSSSSSSSSSSSSSSSSSSSSSSSSSS----------------------------------------------------------------------------------------------------------------------------------------------------------<>----SS-----S
----------------------------------------------------------------------------------------------------------------------------------------------------------------------------------------------------------------------------------------------------------------SS--------[]----SS---S-S
---------------------------------------------------------------------------------------------------------------------------------------------------------------------------------XXX---------------------------------------------------------------------------EE---------[]----SS---SSS
----------------------------Q-----------------E--------------------------S--------------------?---------------------------S-----------------------------------------X-X-----------QQQ---------------------SSQQSQ--------------------------------------------X--SSSSSSSSSS-SS-??SSS-----S
--------------------------------E------------<>-----------------------------------------------------------------------------------------------------------------------------------------------------------------------------------------------------------------------------------------
--------------------------------------------XXX-----------------------XXXXXX------------------S-------------------------------------------------------------------------------------------------------------------------------------------------------------]---------------------------
------------------------------------------XXXXX-----------------------------------------------E------------E---------------------------E------------------------------------------------E----------------------------------E-------SS---------------------XXX-?-------------------------
----------------------------X------------XXXXXX----------------------------------------S-S---[]------------>---------SS--SS-----------<>----------------XX------------------E-----QQQQ-?QQ----------------S---QQ----------<>------------------------------------SSSSSS---SS----------XX-
----------------------------X------------XXXXXX--------------E---------------E-----<-SE------[]---------E--]---X----------------------[]---------------XXX----------------------------------------E-----------------------[]-----X---------------------------------------------------XX-
----------------------------]----------XXXXXXXX-------------<>---------X----<>-----[SS?S-----[]--------<>--]---X----------------------[]---------------XXX---------------------------------------<>-----------------------[]-------------------------------------X-------------------XX-
-------------E--------------]---------XXXXX-XX------E----E--[]----EE--EE----[]-----[S[]------[]--------[]-[]--XX----------------------[]------------EXXXXX-------EE-E----------------------E-----[]-----------------------[]----XX----------------------------------------------E-E--XX-
-----X-XXXXXXXXXXXXXXXXXXXXXXXXXXX---XXXXX--------------XXXXXXXXX-XX-XXXXXXXXXXXXXXXXXXXXXXXXXXXXXXXXXXXXXXXXXXXXXXXXXXXX-XXXXXXXXXXXXXXXXXXXXXXXXXXXXXXXXXXXXXXXXXXXXXXXXXXXXXXXXXXXXXXXXXXXXXXXXXXXXXXXXXXXXXXXXXXXXXXXXXXXXXX---XXXXXXXX----X-XX----XX---XXX--XXXXXX-----XXXXXXXXXXXX
