----------------------------------------------------------------------------------------------------------------------------------------------------------------------------------------------------------------------------------------------------------------------------------------
----------------------------------------------------------------------------------------------------------------------------------------------------------------------------------------------------------------------------------------------------------------------------------------
----------------------------------------------------------------------------------------------------------------------------------------------------------------------------------------------------------------------------------------------------------------------------------------
----------------------------------------------------------------------------------------------------------------------------------------------------------------------------------------------------------------------------------------------------------------------------------------
--XEE-----------------------------------------------------------------------------------------------------------------------------------------------------------------------------------------------------------------------------------------------------------------------------------
?--S-------------??SS----------------------------------------------------------------------------S--------SSS----------------S----------------------SSS--------------S----------------------------X-----------------------------------------XE--------------Q---------------------------
-------------------------------------------------------------------------------------------------------------------------------------------------------------------------------------------------------------------------------------------------XXXX----------XXXX----------------XXX--
----------------------------------------------------------------------------------------------------------------------------------------------------------------------------------------------------------------------------------------------------------------------------------------
--EX---------------------------------------------------------E----------E----------------------------------SS------XXX--------------------XX-----------------------------------------------------------------------X--------------------------------------------------------------------
-XXXXS--------E----------XX---------------------------------<>---------<>-----------SSSS?-------------XXX--------X--------------------------------------SSS-----------------------------------------------------XX---------------X------------------S---S-SS-------------XXXXXXX--------
-------E---EXX-----------XX---------------------------------[]---------[]------------------E---------XXX---------X------------------------------------------------------------------XXXX-----------------------XXXXX-------------X------------------------------------------------------
-----XXX--------X--------XX-------------X-------------------[]---------[]-----------------<>--------XXXX---------------------------------------------------------------------------XXXXX----------------------XXXXXX-----------[XXX-----------------------------------------------------
----------------X---XXX--XX---------E---X--------E----------[]-----E---[]-----------------[]-------XXXXXX-------XX----------------------------------------------------------------XXXXXX--------------------XXXXXXXX--------EE-EXX-----------------------------------------------E-E----
X-----XX-----------------XX-XXXXXXXXXXXXXXXXXXXXXXXXXXXXXXXXXXXXX-XXXXXXX-XXXXXXXXXXXXXX-XXXXXXXXXXXXXXXXXXXXXXX-----XXXX-----XXXXXXXXXXX---XXXXXXXXXXXXXXXXXXXXXXXX-X--XXXXXXXXXXXXXXXXXXXXXX--XXXXXXXXXXXXXXXXXXXXXXXXXXXXXXXXXX--XXXXXXXX-XXXXXXXXXXXXXXXX----X----XXXX-----XXXXXXXXX
