----------------------------------------------------------------------------------------------------------------------------------------------------------------------------------------------------------------------------------------------------------------------------------------
----------------------------------------------------------------------------------------------------------------------------------------------------------------------------------------------------------------------------------------------------------------------------------------
--------------------------------------------------------SSSSSSSSSSSSSSSSSSSSSSSSSSSS----------------------------------------------------------------------------------------------------------------------------------------------------------------------------------------------------
-------------------------------------E--------------------------------------------------------------------------------------------------------------------------------------------------------------------------------------------------------------------------------------------------
-------------------------------------XXX----------------------------------------------------------E---------------------------------------------------------------------------------------------------------------------------------XXX-------------------------------------------------
-------------------------------------------------------------------------------------------------E---E---------------------------------------XXX----------------------------------QQ---------------------------------E----------S----------------SSS----------SSSSSSSSS---SS----------SS
------------------------------------------------------------------------------------------XX--------XXXXXXXXXX------------------------------------------------------------------------------------------------------XXXX----------------------------------------------------------------
-------------------------------------------------------------------------------------------------------------------------------XX--X----------------------------------------------------------------------------------------------------------------------------------------------------
---------------------------------S----------E-----------E---------E------SSS------------------------------------------------------------------------------------------------------------------------------------------------------------------------------------------------------------
-------------X-X---------------------------<>-----SS-S-->--S-----<>----------------------------------SSSSS-----Q-------------------------------------------------------------------QQQQQ----------E---------------------------SSXQQQ--------------XXXX---------SSSSSSS------------------
-----------XXX------------------------E-----]-----------S--------[]---------?------X---------------------------------E----------E----E-----------------------------------------------------------<>------------------------------------------XXXX---------------------------------------
-----------XXX-----------------------<>----[]-----------SS-------[]--------[]------XXXXX----------------------------->---------<>----------[-----------------------------------------------------[]-XXXX----------------------------------------------------------------------<>--------
---------XXXXX-------EE-EE-E----EE---[]----[]-----------S]-------[]--E-----[]--------------------E-------E-E--------E]----E----[]---------E[------------E----------------------------------E-----[]-XX------------------------------------------------------------------------[]--------
XXXXXXX-XXXXXXX--XXXXXXXXXXXXXXXXXXXXXXXXXXXXXX----XXXXXXXXXXXXXXXXXXXXXXXXXXXXXXXXX--------XXX-XXXXXXXXXXXXXXXXXXXXXXXXXXXXXXXXXXXXXXXXXXXXXXXXXXXXXXXXXXXXXXX-----XXXXXXXXXXXXXX-XXXXXXXXXXXXXXXXXXXXXXXXXXX---XXXX----XXXXXXXXX--XXX----X----------------XXXXXXXXXXXXXXXXXXXXXXXXXXXX
