----------------------------------------------------------------------------------------------------------------------------------------------------------------------------------------------------------------------------------------------------------------------------------------
------------------------------------------------------------------------------------------------------------------------------------S---------------------------------------------------------------------------------------------------------------------------------------------------
------------------------------------------------------------------------------------------------------------------------------------S---------------------------------------------------------------------------------------------------------------------------------------------------
-------------------------------------------------------------------------------------------------------------------------------------------S--------------------------------------------------------------------------------------------------------------------------------------------
-------------------------------------------------------------------------------------------------------------------------------------S----S---------------------------------------------------------------------------------------------------------------------------------------------
------------------------------------------------------------------------S------------------QQQQQQ-----------SSSS----SSSSSSSSSSSS----SS---SSS-------------------------------S-------------------------------SQSSSS-------------SSE----------------------X--------------------------------
----------------------------------------------------------------------------------------------------------------X-----------------------------------------------------------------------------------------------------------------XXXXX----------------XXX------------------------------
-----------------------------------------------X----------------------------------------------------------------X-----------------------------------------------------------------------------------------------------------------------------------------------------------------------
------------------------------------------------------------------------E----------------------------------------------------------------------------------------------------------------------------------------------------------------------------------------E----------E-----------
--------Q-----------------------------------------SS--------->---------<>-----------------Q---QQQ--------------------SSSSSSSQ------------------------------X---------------------QQ-------------------E--QQ--SSS----------------X------------XXXXXXX------------<>---------<>-----------
----------------XX------------------------------------------[]---------[]----X-----------------------------------------------------------------------------------------------------------------------<>---------------------------------------------------------[]---------[]----E------
---------------XXX--------XX--------------------------------[]---------XX----X-----------------------------------------------------------------------------------------------------------------------[]---------------------------------------------------------[]---------[]---<>------
--------------XXXX--------XX--E--E--E-E-----------E--E---E--[]-----E-XXXX----X------------------------E----------------------------EE-E--------------------------------------------------------------[]---------------EE-------------------------------------E--[]-----E-E-[]---[]------
XXXXXXXXXXXXXXXXXX----XXXXXXXXXXXXXXXXXXXXXXXXXXXXXXXXXXXXXXXXXXXXXX-XXXX-XXXXXXXXXXXXXXXXXXXXXXXXXXXXXXXXXX-XXXXXXXXXXXXXXXXXXXXXXXXXXXXXXX---X----XX-XXXX---XXXXXXXXXXXXXXXXXXXXXXXXXXXXX---------XXXXXXXXXXXXXXXXXXXXXXXXXXXXX--------XXXX---------------XXXXXXXXXXXXXXXXX-XXXXXXXXXX
