----------------------------------------------------------------------------------------------------------------------------------------------------------------------------------------------------------------------------------------------------------------------------------------
----------------------------------------------------------------------------------------------------------------------------------------------------------------------------------------------------------------------------------------------------------------------------------------
SSSSSSSSSSSSSSSSSSSSSSSSS---------------------------------------------------------------------------------------------------------------------------------------------------------------------------SSSSSSSSSSSSSSSSSSSSSSSSSSSS--------------------------------------------------------
----------------------------------------------------------------------------------------------------------------------------------------------------------------------------------------------------------------------------------------------------------------------------------------
-----------------------------------------------------------------XXX---------------------------------------------------------------------------------------------------------------------------------------------------------------------------------------------------X----------------
-----------------------------------------------------------------------------------------------------S-----------------------------------------------------------------------------------------S-----------------------------------------------X----------------------------------------
--------------------------------------------------------------------------------------------------------E-------------------------------------------------------------------------------------------------------------------------------------XX----------------------------------------
--------------------------------------------------------------------------------------------------XXXX-X-------------------------------------------------------------------------------------------------------------------------------------XXX----------------------------------------
----------E------SSS-----------------------------------------E----------E-----------------------------------------------------------------------SSSSS-----------------------------------------------E---------E-------S---------------------XXXX----------------------------------------
>--------<>-----------X------------------------------SS-----E------E---<>------------------------------------------------------------------------------QQQQQ---------------------------------------->--S-----<>-----------------------------XXXX----------------------------------------
---------[]-----------X----E-------------------------------------------[]---------E------E----------E----E-----<-----------------------------------------------------------------------XXXX------------------[]---------?------X----------XXXXXX-----------<----------E-----------------
<>-------[]---X-<>-E--X---<>-------------------------------------------[]--------<>-----<>---------<>---<>-----[-----------------------------------------------------<>----------------XXXX---------SS-------[]--------<>-----XX---------XXXXXXX-----------[---------<>-----------------
[]-------[]--XX-[]----X---[]-------------------------------------E-----[]--------[]--E--[]-----E---[]---[]-----[-------E--E------------------------------------------[]----------------XXXX---------S--------[]--------[]-E--XXX--------XXXXXXXX--------E--[---------[]-----------------
XXXXXXXXXXXXXXXXXXXXXXXXXXXXXXXXXXXXX----XXXXXXXXXXXXXXXXXXXXXXXXXXXXXXXXXXXXXXXXXXXXXXXXXXXXXXXXXXXXXXXXXXXXXXXXXXXXXXXXXXXXXXXXXXXXXXXXXXXXXXXXXXXXX-XXXXXXXXXXXXXXXXXXXXXXXXXXXXXXXXXXXXX-------XXXXXXXXXXXXXXXXXXXXXXXXXXXXXXXXXXXXX-XXXXXXX-XXXXXXXXXXXXXXXXXXXXXXXXXXXXXXX--XXXXXX
