------------------------------------------------------------------------------------X---------------------------------------------------------------------------------------------------------------------------------------------------------------------------------------------------
--------------------------------------------------------X-------------------------------------------------S----S--------------------------------------------------------X---------------------------------------------------------------------------------------------------------------
--------------------------------------------------------SS--------------------------SSSSSSSSSSSSSSSSSSSSSSSSSSSS--SSSSSSSSSSSSSSSSSSSSSSSSSS--------------------------------------------------------------------------------------------------------------------------------------------
------------------------------------------------------------------------------------SSSSSSSSSSSSSSSS----SSSSSSSS--S----SS---------------------------------------------------------------------------------------------------------------------------------------------------------------
------------------------------------------------------------------------------------SSSSSSSSSSSSSSSS----SSSSSSSS-------SSS--------------------------------------------------------------------------------------------------------------------------------------------------------------
------------------SS-----------------------------------------------SS---------------SSSSSSSSSSS--SSS----------SS-SSSSSSSSS---SSS-------SS------------------------------------------------------------------------------------------------------X----------------------------------------
----------------------------------------------------------------------------------------------------------------------------------------------------------------------------------------------------------------------------------------------XX----------------------------------------
-------------------------------------------------------------------------------------------------------------------------------------------------------------------------------------------X--------------------------------------------------XX----------------------------------------
---X--------------------------------------------------------------E------------------?--?------------------??------E------------------------------------------------------------------------------------------------------------------------XXXX-----------------E----------E-----------
------------XX--------------------------------------------E--E---<>-----E------>----SSSSSSSSSSS--------E------XX-SSSSS-SSS---------E-------------------QQQQQ----------E-----------------------SS-------------------------------------------XXXXX----------------<>---------<>-----------
--------------------------------------E------------------<>-<>---[]----<>---E-[]----XSSSSSSSSSS-------<>-----------SS--SSS--------<>-------------------------------E-<>------E----------E----E--------------------------------------------XXXXXX-----E----------[]---------[]----X-----E
-------------------------X-----------<>------------------[]-[]---[]----[]--<>-[]---XSSSSSSSSSSS-------[]-------X---SS-SSS---------[]---------------------------------[]-----<>---------<>---<>-----[-------------------------------------XXXXXXX----->----------[]---------[]----<>---<>
-------------------------------------[]--------------EE--[]-[]---[]----[]--[]-[]--XXSSSSSSSSSSS-------[]-----XXX------SS----------[]------------------------------E--[]-----[]----E----[]---[]-----E------------E----------E-E---E-E----XXXXXXXX-----]--E--EEE--[]-----E-E-[]----[]---[]
------XXXX------XXXXXXXXXXX-XXXXXXXXXXXXXXXXXXX-XXXXXXXX-XXXXXXXXXXXXXXXXXXXXXXXXXXXXXXXXXXXXXXXXXXXXXXXXXXXXXXXXXXXXXXXXXXXXXXXXXXXXXXXXXXXXXXXXXXXX--XXXXXXXXXXXXXXXXXXXXXXXXXXXXXXXXXXXXXXXXXXXXXXXXXXXX-XXXXXX-----XXXXXXXXXXXXXX-XXXXXXXXXXXXXXXXXXXXXXXXXXXXXXXXXX---XX---XXXXXXXX
