----------------------------X-----------------------------------------------------------------------------------------------------------------------------------------------------------------------------------------------------------------------------------------------------------
X-------------------------------------------------S-------------------------------------------------------------------------------------------------------------------------------------------------------------------------------------------------------------------------------------
----------------------------SSSSSSSSSSSSSSSSSSSSSSSSSSSS------------------------------------------------------------------------------------------------------------------------------------------------------------------------SSSSSSSSSSSSSSSSSSSSSSSSSSSS--SSSSSSSSSSSSSS----SSSSSSSS
----------------------------SSSSSSSSSSSSSSSS----SSSSSSSS------------------------------------------------------------------------------------------------------------------------------------------------------------------------------------------------------SSSSSSSSSSSSSS----SS---SSS
----------------------------SSSSSSSSSSSSSSSS----SSSSSSSS-------------------------------------------------------------------------------------------------------------------------------------------------------------------------------------------------------SSSSSSSSSSSS-----SS----SS
---------------------X------SSSSSSSSSSSS-SSS--------S-SS------------------------------------------------------S--------------------------------------------E-------------XXX-----------------------------------------------------S---------------------------SSSSSSSSSSSSSSS----------SS
----------------------------SS-S----------------------------------------------------------------------------------------------------------------------------------------------------------------------------------------------------------------------------EE--------------------------
----------------E--X------------------S-------------------------------------------------------------------------------------------------------------------XX----------------------------------------------------------------------------------------------------------------------------
-----E--------------------------E-----S------------??----------------------------------------------------------------------------------------------------XXX------------------------------------------------------------------------------E---------------------E-----------------------
---------------------------E-SSSSSSSSSSS-------E------XX------------------X-------------------------E-----------XQQQ--------------XX--------------------XXXX-----------------------------------------------------------------QQ->S-S----S<>---------E------X---?SSSSSSSS----------------
-----E----------E----E----<>-SSSSSSSSSS-------<>----------------------EXXXX------------------------<>------------------E-----XXXX-XX------------------XXXXXX----------------------------------------------E---E-----------------S--S-----[]--------<>------X--E-------------------------
----<>---------<>---<>----[]SSSSSSSSSSS-------[]-----------------------XXXX------------------------[]-----------------<>-----------X-----------------XXXXXXX-----------[-------------------------------------<>-----------------SS-S-----[]-----<>-[]-----XX-SS--X------------<>--------
----[]----E----[]---[]----[]SSSSSSSSSSS-------[]X----------------------X-XX------------------------[]-E---------------[]-------X--------------------XXXXXXXX--------EE-[----------E-E----------------------E-[]--------------EE-S--S--ES-[]-----[]-[]----XXX------------------[]E-E-----
XXXXXXXXXXXXXXXXXXXXXXXXXXXXXXXXXXXXXXXXXXXXXXXXXXXXXXXXXXXXXX--XXXXXXXXX--XXXXXXXXXXXXXXXXXXXXXXXXXXXXXXXXXXXXXXXXXXXXXXXXX----------------XXXXXXXXXXXXXXXXXXXXXXXXXXXXXXXXXXXXXXXXXXXXXXXXXXXXXXXXXXXXXXXXXXXXXXXXXXXXXXXXXXXXXXXXXXXXXXXXXXXXXXXX--XXXXXXXXXXXXXXXXXXXXXXXXXXXXXXXXXX
