----------------------------------------------------------------------------------------------------------------------------------------------------------------------------------------------------------------------------------------------------------------------------------------
--------------------------------------------------------X-------------------------------------------------------------------------------------------------------------------------------------------------------------------------------------------------------------------------------
------------------------------------------------------------------------------------SSSSSSSSSSSSSSSSSSSSSSSSSSSS----------------------------SSSSSSSSSSSSSSSSSSSSSSSSSSSS----------------------------------------------------------------------------------------------------------------
--------------------------------------------------------------------------------------S----SSSS-----------------------------------------------------------------------------------------------------------------------------------------------------------------------------------------
--------------------------------------------------------------------------------------S----SSSS---------------S-------------------------------------------------------------------------------------------------------------------------------------------------------------------------
--------------------------XX---------------------------------------SS----------------SSSS--SSSS---------------S---XX--------------------------------------------------------------------------------------------------------------SS------------------------------SSSSSS----------------
----------------------------------------------------------------------------------------------------------------------------------------------------------------------------------------------------------------------------------------------------------------------------------------
----------------------------------------------------------------------------------------------------------------------------------------------------------------------------------------------------------------------------------------------------------------------------------------
-----------------------------------------------------------------?E-----------------------------------------------------------------------------------E----------------------------------------------------------------------------------------------------------------------------E----
---------------X------------------------------------------E--E---<>-----E------------SSSS--SSSS----------------X-------------------------------S-----<>-------------------------------XXX--------------------------------------S-SSSS----------------------------SS--SS-----------<>----
-------------X----------------------------------------------<>---[]----<>---E---------SSSS-SSSS--------<-------X------------X-----------------E------[]---------E------X--------------------------------------------------------------------------X-------------------------------[]----
-----------XXXX---------------------------------------------[]---[]----[]--<>-----XX-SSSS-SSSSS--------[]------X------------X---------------SS-------[]--------<>-----XX------------------------------------------------------------------------X-X-------------------------------[]----
----------XXXXXX--------------------E---EE-------E-E-EE-----[]---[]----[]--[][]--XXX-SSSSSSSSSS--------[]----XXX--------E---EE-------EEE----S--------[]--------[]----XXX-----------------------------------------------------------------------XX-X---------------------------E---[]----
XXXXXXX-XXXXXXXXXXXXXXXXXXXXXXXXXXXXXXXXXXXXX--XXXXXXXXX--XXXXXXXXXXXXXXXXXXXXXXXXXXXXXXXXXXXXXXXXXXXXXXXXXXXXXXX----XXXXXXXXXXXXXXXXXXXXXXXXXXXXXXXXXXXXXXXXXXXXXXXXXXXXXXXXX-----XXXX----XXXXXXXXX-----XXXXXXX---X--------X---XXXXXXXXXXXXX--XX-----------XXXXXXXXXXXXXXXXXXXXXXXXXXXX
