----------------------------------------------------------------------------------------------------------------------------------------------------------------------------------------------------------------------------------------------------------------------------------------
----------------------------------------------------------------------------------------------------------------------------------------------------------------------------------------------------------------------------------------------------------------------------------------
----------------------------------------------------------------------------------------------------------------------------------------------SSSSSSSSSSSSSSSSSSSSSSSSSSSSSSSSSSSSSSSSSSSSSSSSSSSSSS------------------------------------------------------------------------------------
----------------------------------------------------------------------------------------------------------------------------------------------SSSSSSSSSSS-S-----SSSSSSSSSSSSSSSSSSSS----------------------------------------------------------------------------------------------------
----------------------------------------------------------------------E-----------------------------------------------------------------------SSSSSSSSS---------SSSSSSSSSSSS-SSSSSSS--------------S-------------------------------------------------------------------------------------
--XX-------------------------XXXX-----------------------E--E--E----------E-----------------------------------------S---SSSS---------------SSSSSSSSSSSS---SSS-------SSSSS-SSS---SSSS---------------S--------------------------------------------------------------------------------XXXX-
------------------------------------------------------------XXXXX----------XXXXXX----------------------------------------------------------------------------------------S--------------------------------------------------------------------------------------------------------------
--------------------------------------------XXXX----------------------------------------------------------------------------------------------------------------------------------S------------------------------------------------------------XXXXX------------------------------------
-----------------------------------------------------------------------------------------------------------------------------------------------E----------------------------E-----S------------SS---------------------------------------------------------------------------------------
-----------------------------------------------------------------------XXXX--------S-----E----------E----------------SSSSSS------------------SSSSSSSSS---------E-------X-S-SSS-SSSSS--------E------X--------------------------E---------------------------------------------------------
----------------------------------------------------------------------------------------<>---------<>------------------------------------------SSSSSSS--------<>--------SSSSSS-SSSS--------<>------X----------E--------------<>---------------------------------------------------------
--------------------------------------------------------XXXX----------------------------[]---------[]------------------------------<-----------SSSSSSS--------[]--------SSSSSSSSSSS--------[]------X---------<>--------------[]---------------------------------------------------------
--------E---E----------E-EE---E--EE-E-E-E---------E--E-E--------------------------------[]---------[]-----------------------------E[-------X---SSSSSSS--------[]E-------SSSSSSSSSSS--------[]----XXX-------E-[]--------------[]--EE-EEE-E-EEE-EE--------EE-E----------------------------
XXXXXXXXXXXXXXXXXXXXXXXXXXXXXXXXXXXXXXXXXXXXXXXXXXXXXXXX-----X---------------XXXXXXX-XXXXXXXXXXXXXXXXXXXXXXXXXXXXXXXXXXXXXXXXXXXXXXXXXXXXXXXXXXX-XXXXXXXXXXXXXXXXXXXXXXXXXXXXXXXXXXXXXXXXXXXXXXXXXXXXXXXXXXXXXXXXXXXXXXXXXXXXXXXXXXXXXXXXXXXXXXXXXXXXXXXXXXXXXXX---XXXXXXXXXXXXXXXXXXXXX
