------------------------------------------------------------------------------------------------------------------------------------------------------------------------X---------------------------------------------------------------------------------------------------------------
--------------------S-----------------------------------------------------------------------------------------------------------------------X-------------------------------------------------S----S--------------------------------------------------------X---------------------------
--------------------SS-----S----------------------------------------------------------------------------------------------------------------SS--------------------------SSSSSSSSSSSSSSSSSSSSSSSSSSSS--SSSSSSSSSSSSSSSSSSSSSSSSSS--------------------------------------------------------
--------------------SS---SSS--------------------------------------------------------------------------------------------------------------------------------------------SSSSSSSSSSSSSSSS----SSSSSSSS--S----SS---------------------------------------------------------------------------
---EE---------------SS---SSS------------------------------------------E-------------------------------------------------------------------------------------------------SSSSSSSSSSSSSSSS----SSSSSSSS-------SSS--------------------------------------------------------------------------
S-SSSSSSSS----SS---SSS-----S-------Q--QQ--------------------------------------------------------------SS-----------------------------------------------SS---------------SSSSSSSSSSS--SSS----------SS-SSSSSSSSS---SSS-------SS-----------------------------------------------------------
----------------------------------------------------------------------------------------------------------------------------------------------------------------------------------------------------------------------------------------------------------------------------------------
-------------------------------------------------------------------------------------------------------------------------------------------------------------------------------------------------------------------------------------------------------------------------------X--------
--EE-----------------------------------------------------------------------------------X--------------------------------------------------------------E------------------?--?------------------??------E--------------------------------------------------------------------------------
--S?SSSSS-----E----X-----XXX------Q---QQQ--QQ--------------------------------S------------------XX--------------------------------------------E--E---<>-----E------>----SSSSSSSSSSS--------E------XX-SSSSS-SSS---------E-------------------QQQQQ----------E-----------------------SS----
------SS----X-------------------------------------------------------------------------------------------------------------E------------------<>-<>---[]----<>---E-[]----XSSSSSSSSSS-------<>-----------SS--SSS--------<>-------------------------------E-<>------E----------E----E------
-----SS---------X--------------------------------------------------------------------------------------------X-----------<>------------------[]-[]---[]----[]--<>-[]---XSSSSSSSSSSS-------[]-------X---SS-SSS---------[]---------------------------------[]-----<>---------<>---<>-----[
--------------------E-E---------------------------------------------EE-------E-E-----------------------------------------[]--------------EE--[]-[]---[]----[]--[]-[]--XXSSSSSSSSSSS-------[]-----XXX------SS----------[]------------------------------E--[]-----[]----E----[]---[]-----E
XXXX-XXXXXXXX--XXXXXXXXXXXX-XXXXXXXXXXXXXXXXXXX------XXX-----X-XXXX-XXXXXXXXXXXXXXXX------XXXX------XXXXXXXXXXX-XXXXXXXXXXXXXXXXXXX-XXXXXXXX-XXXXXXXXXXXXXXXXXXXXXXXXXXXXXXXXXXXXXXXXXXXXXXXXXXXXXXXXXXXXXXXXXXXXXXXXXXXXXXXXXXXXXXXXXXXX--XXXXXXXXXXXXXXXXXXXXXXXXXXXXXXXXXXXXXXXXXXXXX
