----------------------------------------------------------------------------------------------------------------------------------------------------------------------------------------------------------------------------------------------------------------------------------------
----------------------------------------------------------------------------------------------------------------------------------------------------------------------------------------------------------------------------------------------------------------------------------------
----------------------------------------------------------------------------------------------------------------------------------------------------------------------------------------------------------------------------------------------------------------------------------------
----------------------------------------------------------------------------------------------------------------------------------------------------------------------------------------------------------------------------------------------------------------------------------------
----------------------------------------------------------------------------------------------------------------------------------------------------------------------------------------------------------------------------------------------------------------------------------------
--------------------------------------------------------------------XX-------------------------?SSS-------------------------------------------------------------------------------------XX---------------------------S----------Q----------------------------XXX------------------------
---------------------------------------------------------------------------------------------------------------------------------------------------------------------------------------XXX-----------------------------------------XXX-----------------X--------------------------------
--------------------------------------------------------------------------------------------------------------------------------------------------------------------------------------XXXX-------------------------XX-------------------------------------------------------------------
-----------------------------------------------------------------------------------E-XSSSS--------------------EX---------------------------------------------------------------------XXXXX----------------------------------------------------------------------------------------------
-------------XXXXX----------X---------------XXXX---------X------------------SS------------------SS-----------------------------X---------------------------X-----------------------X-XXXXX---------------------------------------------------XXXXXX-------------------------------------
-------------XX-XX------------------------XX-------------X---------------------------------------------------E--------------------------------------------------------------------XXXXXXXX---------E---------------------E--------------------------------------------------------------
------------XXXXX----------------------------------------------------------------------------------------------------------------------------------------XXX---------------------XXXXXXXXX---X-----[---------------X----<>-----[--------------------------------------------------------
----------XXXXX---------E-------------------------------XXX-----------------------------------------------------------------E--------------------------EEXXX----------E--E-E----XXXXXXXXXX---X-----[-E--EE-----E--EX----[]-----[------------------------------------E---E----------E-EE-
XXXXXXX--XXXXXX---XXXXXXXXXXXXXXXX---XXXXXX----XXXXXXXXXXXX-XXXXXXX---XXXXXXXXXXXX-X---XXXXXXXXXXXXXXXXXXXXXXX--XXXXXXX--XXXXXXXXXXXXXXXXXXXXXXXXXXX-XXXXXX------XXXXXXXXXXXXXXXXXXXXXXXXXXXXXXXXXXXXXXXXXXXX-XXXXXXXXXXXXXXXXXX---------XXXXX-----XXX--X-XXXXXXXXXXXXXXXXXXXX--XXXXXXXX
