----------------------------------------------------------------------------------------------------------------------------------------------------------------------------------------------------------------------------------------------------------------------------------------
----------------------------------------------------------------------------------------------------------------------------------------------------------------------------------------------------------------------------------------------------------------------------------------
----------------------------------------------------------------------------------------------------------------SSSSSSSSSSSSSSSSSSSSSSSSSSSS--------------------------------------------------------------------------------------------------------------------------------------------
----------------------------------------------------------------------------------------------------------------------------------------------------------------------------------------------------------------------------------------------------------------------------------------
----------------------------------------------------------------------------------------------------------------------------------------------------------------------------------------------------------------------------------------------------------------------------------------
----------------------SSSSS------------------------------------------------------------------------X--------------------------------------------------------------------------------------------------------------------------XX------------------------XXXX----------------------------
--------------------------------------------------------------------------------------------------XX------------------------------------------------------------------------------------------------------------------------------------------------------------------------------------
--------------------------------------------------------------------------------------------------XXX-----------------------------------------------------------------------------------------------------------------------------------------------------------------------------------
-----------------------SS-----------------------------------------------------------------------X-XX----------------------E-------------------------------------------------------------E-----------------------------------------------------------------------------------------------
SSSSS--------------X-------------------------------------------------XXXX----------------------X---------------->--S-----<>--------------------------------X----------------EQQ---QQQ--QQ--------------------------------SSSSS-------------------------SS----------------------------SSS
-------E----------XX------------------------------------------------XXX------------------------XXXX------E-----<---S-----[]--------<>---------------------------------E---------------------------------------E---------------------------E---------------------------------------------
------<>--------XXXX------------------------XX--------XX-----------XXXX----------------------------X----<>-----[S--S-----[]--------[]--------------------------------<>--------------------------------------<>-------------------------------------------------------------------------
------[]-------XXXXX------------------------XX--------XX----------XXXX----------E----E--EE--XXXE--EX----[]-----[S-----E--[]--------[]--------------------------------[]-------------------E----------------E-[]---------------------------E-------------------------E---EE-------E-E----
XXXXXXXXXXXXXXXXXXXXXXXXXXXXXXXXXXXXXXXXXXXXXXX---XXXXXXXXXXXX--XXXXXX----XXXX--X-X-XXXXXXXXXXXXXXXXXXXXXXXXXXXXXXXXXXXXXXXXXXXXXXXXX--XXXXXXXXXXXX---XXXXX----XXXXXXXXXXXXXXXXXXXXXXXXXXXXXXXXXXXXXXXXXXXXXXXXXXXXXXXXXXXXXXXXXXXXX-XXXXXXXXXXXXXXXX----XXXXXXXXXXXXXXXXXXXXXXXXXXXXXXX
