----------------------------------------------------------------------------------------------------------------------------------------------------------------------------------------------------------------------------------------------------------------------------------------
--------------------------------------------------------------------------------------------------------------------------------------------X-------------------------------------------------------------------------------------------------------------------------------------------
--------------------------------------------------------SSSSSSSSSSSS-SSSSSSSSSSSSSSS----------------------------------------------------------------------------------------------------------------------------------------------------------------------------------------------------
----------------------------------------------------------------------------------------------------------------------------------------------------------------------------------------------------------------------------------------------------------------------------------------
----------------------------------------------------------------------------------------------------------------------------------------------------------------------------------------------------------------------------------------------------------------------------------------
---X--------------------------------------------------------------------------------Q---------------------------SS---------------------S----X-----------S-----------------XX-------------------------------QQQQQQ----------------SSSSSSSSSSS---S------SSSSS-------------QQQ-------------
----------------------------------------------------------------------------------------------------------------------------------------------------------------------------------------------------------------------------------------------------------------------------------------
----------------------------------------------------------------------------------------------------------------------------------------------------------------------------------------------------------------------------------------------------------------------------------------
------------------------------------------------------------------E------SSS--------------------------------------------------------------------------E--------------------------------------------------------------------E----------------------------------S-SSSSS-------------------
-----------------------------QQQ--------------XX--------<>-------<>------------------------------X-XXX----------QQQQ--------------XX-------------E---<>-----E----------E----------------------SSSSSS--E--QQ---QQQ---------<>--------SSSSSS-----------------------------QQQQQ------------
-------------------------------------------X------------[]-------[]-----------X----E------------X------------------------------XXXXX------------<>---[]----<>---E-----<>-----------------------------<>-------------------[]------------------------------------------------------------
----------------------------------------------X---------[]-------[]---X-E--EXXX---XX------------X--------------------------------XXX------------[]---[]----[]--<><>---[]------------X----------------[]-------------------[]----------------------<-------------------------------------
--------------------------E----------------X------------[]-------[]--XX------XX---XX------------EX-------E-E-------------------XXXXX--------E---[]---[]E-E-[]--[][]---[]-----EE-E---E--------E-E-----[]----------------E--[]----------------------E-------------------------------------
XXXXXXXXX-XXXXXXX--XXXXXXXXXXXXXXXXX--XXX--XXXXXXXXXXXXXXXXXXXXXXXXX-XXXXX-XXXXXXXXX----XX--XXXXXX----XXXXXXXXXXXXXXXXXXXXXXXX-XXX--------XX-XXXXXXXXXXXXXXXXXXXXXXXXXXXX---XXXXXXXXXXXXXXXXXXXXXXXXXXXXXXXXXXXXXXXXXXXXXXXXXXXXXXXXXXXXXXXXXXXXXXXXXXX--XXX---XXXXXXXXXXXXXXXX---------
