----------------------------------------------------------------------------------------------------------------------------------------------------------------------------------------------------------------------------------------------------------------------------------------
------------E---------------------------------------------------------------------------------------------------------------------------------------------------------------------------------------------------------------------------------------------------------------------------
-----------<>-------------------------------------------SSSSSSSSSSSSSSSSSSSSSSSSSSSS--------SSSSSSSSSSSS-SSSSS----------------------------------------------------------SSSSSSSSSSSSSSSSSSSSSSSSSSSS------------------------------------------------------------------------------------
-----------[]-----------------------------------------------------------------------------------------------------------------------------------------------------------SSSSSSSSSSSS----------------------------------------------------------------------------------------------------
-----------[]----E-------------------------------------------------------------------------------------------------------XXX--------------------------------------------SSSSSSSSSSSS--------------S-------------------------------------------------------------------------------------
-----------XXXX-----X-------------------------------------------------------------------------------XXX------------------------------------X-XXX-------------------------SSSSSSSSSS---------------S------------??SS-------------SSS-----------------------------------------------------
--X---XX--------------------------------------------------------------------------------------------XXX---------------------------------------------------------------------------------------------------------------------------------------------------------------------------------
--X------------------------------------------------------------------------------------------------XXXX---------------------------------------------------------------------------------------------------------------------------------------------------------------------------------
---------------------------X-----E----------E---------------------E------SS----------S------------XXXXX---------------------------------------------------------------------E-----S------------SS-------S---------------------XX--------------------------------------------------------
--XX------------XSSSS-----------<>---------<>----------E>--S-----<>---------E------X----------XX--XXXXX---X---------------------------SS---------------------------------S-SSSSSSSS---------E------X-X--------------------------SSSS----S--------------------------------------------SQS
-XXX----------------------------[]---------[]---------<>S--S-----[]--------<>------X>---------X-EXXXXXX---X---------------E-----E----------------------------------------SSSSSSSSSS--------<>------X-X-------------------------------------------X-X------------------------------------
--XX----------------------------[]---------[]---------[]SS-S-----[]-----<>-[]-----XX]---------XXXXXXXXX---X--------------<>----<>---------------------------------------SSSSSSSSSSS--------[]------XXX------------------------------------------XXXX------XX----------------------------
--XX----------------------------[]---E-----[]---------[]S-----E--[]-----[]-[X----XXX]--E------XXXXXXXXX---X---------EE---[]----[]---------------------------------------SSSSSSSSSSS--------[]------XXXX-------------------------------E--------XXXXX-----XXX-------EEEE------------E-EE-
------------------------------XXXXXXXXXXXXXXXXXXXXXXXXXXXXXXXXXXXXXXXXXXXXXXXXXXXXXXXXXXXXXXXXXXXXXXXXXX---XXXXXXXXXXXXXXXXXXXXXXXXXXXXXXXXXXXXXXXXXXXXXXXXXXXXXXXXXXXXXXXXXXXXXXXXXXXXXXXXXXXXXXXXXXXXXXXXXXXX----X-XX----XX---XXXXXXXXXXXXXXXXX-----XX-XXXXXXXXXXXXXXXXXXXXXXXXXXXXXXX
