----------------------------------------------------------------------------------------------------------------------------------------------------------------------------------------------------------------------------------------------------------------------------------------
----------------------------------------------------------------------------------------------------------------------------------------------------------------------------------------------------------------------------------------------------------------------------------------
--------------------------------------------------------SSSSSSSSSSS------S-S---SSS------------------------------------------------------------------------------------------------------------------------------------------------------------------------------------------------------
----------------------------------------------------------------------------------------------------------------------------------------------------------------------------------------------------------------------------------------------------------------------------------------
---------------------------------------------------------------------------------------------XXX-----------------------------------------------XXXXX------------------------------------------------------------------------------------------------------------------------------------
--------SSSS---------------------------XXXX-------------------------------------------------------------------------------------------------S----------------SSS--------X-------E----S-----SXXXSSS--------------------E-----------------------------------------------------------------
----------------------------------------------------------------------------------------------------------------------------------------------------------------------------------------------------------------------------------------------------------------------------------------
-----------------------------------------------------------------------------------------------------------------------------XX----X----------------------------------------------------------------------------------------------------------------------------------------------------
-----------------------E--------X---------------------XX----------E------SSS--------------------------------------------------------------------------------------------XXXXXX---------------------------------------X------------------------------------------------------------------
-----SS--SS-----------<>-----X-------------------------->----S---<>-----E-------------------------------------------------------------SS----XXXX--------------XX--------------------XXX----------------------------XX------------------------------------------------------X------------
-<>-------------------[]-----X-----------------------------------[]-----------X----E----------E-----E----------------E----------E----------------------EXXXXX-----------------------------------X-XX--------------XXXX---------E--------------------------------------------------------
-[]-------------------[]--------------------------------<>-------[]-----E--EX<X---<>---------<>---------------------<>---------<>-----------------XX-------------------------------------------------------------XXXXX--------E>--------------------------------------------------------
-[]---------------E---[]-----XX-------------------------[]-------[]--E-------[]---[]-----E---[]--------------EE-----[]----E----[]-----E--E-E---------------X-----XX-----------------------------------------------XXXX--------X]--------------------------------------------------------
XXXXXXXXXXXXXXXXXXXXXXXXXXXX-------X-X--------XX---X----XXXXXXXXXXXXXXXXX--XXXXXXXXXXXXXXXXXXXXXXXXXXXXXXXXXXXXXXXXXXXXXXXXXXXXXXXXXXXXXXXXXXXX--XX-------------------------XXXXXXX-X---XXXXXXXX----XXXXXXX---XXXX--------------XXXXXXXXX--XXXXXXXXXXXXXXXXXXXXXXXXXXX-XXXXXXXXXXXXXXXXX
