----------------------------------------------------------------------------------------------------------------------------------------------------------------------------------------------------------------------------------------------------------------------------------------
----------------------------------------------------------------------------------------------------------------------------------------------------------------------------------------------------------------------------------------------------------------------------------------
------------------------------------------------------------------------------------------------------------------------------------------------------------------------------------------------------SSSSSSSSSSSSSSSSSSSSSSSSSS--------------------------------------------------------
----------------------------------------------------------------------------------------------------------------------------------------------------------------------------------------------------------------------------------------------------------------------------------------
----------------------------------------------------------------------------------------------------------------------------------------------------------------------------------------------------------------------------------------------------------------------------------------
--------------------------------------------------------------------------------------------------------------------------------------------------------EQS--------------------------------------SXX-SSS---SS--------------SS------------------------------X----------------------------
----------------------------------------------------------------------------------------------------------------------------------------------------------------------------------------------------------------------------------------------------------------------------------------
-----------------------------------------------------------------------------------------------------------------------------XXXXXXX----------------------------------------------------------------------------------------------------------------------------------------------------
-----------------------------------------------------------------------------------------------------------------------------------------------SSSSSS-----------------E-----------------------------------------------------------------------------------------------------------------
-------------------------------------------X------------------------------------S-SS-------------------------------------------------SSS----------------S?S----------QQS---------------Q-----S-SS---SSSSS--SSSS-----------------------------------------S--Q--------------XXX-----------
-----------XXX------------------------------------------------------------------------------------------------------------------E----E------------E----------------------------------------------------S---SSS---------E----------------------------------------------------------------
-----------XXX------------------------------------------------------------------------------------------------------------E----<>---<------------------------------------------------------------------S---SS---------<>-------------------------------------------------X--------------
--------EXXXXXEE--------E--E-----------------------------------E-E------------------------------------------------E-EE----S----[]---[]E--E-E-------E-E---------------------------E------------------------XSS----------]----------------E-----------------------------------------------
XXXXXXXXXXXXXXXXXXXX-X-XXXXX--XXX----XXXXXX----XXXXXXXXXXXXXXXXXXXXXXXXXXXXX--XXXXXX------XXXXX-----XXXX--------XXXXXXXXXXXXXXXXXXXXXXXXXXXXXXXXXXXXXXXXXXXXXXX----XXXXXXXXXXXXXXXXXXXXXXXXXXXXXXXXXXXXXXXXXXXXXXXXXXXXXXXXXXXXX-----XXXXXXXXXXXXX---X--XXXXX-XXXX----XXXXX----X-X--X--X
