----------------------------------------------------------------------------------------------------------------------------------------------------------------------------------------------------------------------------------------------------------------------------------------
----------------------------------------------------------------------------------------------------------------------------------------------------------------------------------------------------------------------------------------------------------------------------------------
----------------------------------------------------------------------------------------------------------------------------------------------------------------------------------------------------------------------------------------------------------------------------------------
---------------------------S-------------------------------------------------------------------------------------------------------------------------------------------------------------------------E-E--------------------------------------------------------------------------------
---EE---------------------SS-------------------------------------------------------------------------------------------------------------------------------------------------------------------------XXXXXXX----------------------------------------------------------------------------
--SSSSSSS------S-??S--------X---SSSSSSSSS-----------------------------------------------------------------------------------QQQ-------------X-------E?--SSS----XXXX---------------------------------?----------------SSS--------Q----------------------XX-------------------------------
----------------------------X------------------------------------------------------------------------------------------------------------------------------------------------------------------------------------------------------XXX-----------------X-X------------------------------
----------------------------X----------------------------------------------------------------------------------------------------------------------------------------------------------X------------------------------------------------------------------------------------------------
--EE------------------------X----------------------E--?-----------------------------------------------------------SSSSSSS-------------------XXXXX-------------------------------------XX------------------------------------------------------------------------------------------------
-XS?SSSS------E----X-----XX------SSSSS-S?SS-------<>-[]---------------------------------------------------SS---------------SSSSS-------------------S?---XXX---------------------------XX------------XXXXX-------------XXXX----X-X------------XXXXX--------------------------------------
-----SSS---EX-------------------------------------[]-[]---------------------------------------E-----E---------------------------------------------------------------X-XX-----------X-XXX-------------------X---EXXX-----------------------------------------------------X---------------
-----SSS--------X--------XX-----------------------[]-[]--------------------------------------<>----<>------------------------------------------------------------------------------X--XX------------------XX-----------------XX--------------X--------------------------XX--------------
----------------X---E-E--XX--------------------EE-[]-[]---------------------------------EE---[]----[]--------------------------------------------------------------------E--------XXX-XX---------------------------XX---XXX--XX--------------X--------------------------XX-------E--E---
XXX--XXXX-X----------XX-XXX-XXXXXXXXXXXXXXXXXXXXXXXXXXXXXXXXXXXXXXXX--XXXXXXXXXXXXXXXXXXXXXXXXXXXXXXXXXX--XXXXXXXXXXXXXXXXXXXXXXXXXXXXXXXX------XXXXXXX-X--XXXXXXXXX----XXXXXXXXXXXXXXXXXXXXXXXXXXXXXXX---XX--X-----------------XXXXXX---XXXX---------------X-XXXXX-XXXXXXXXXXXXXXXXXXXX
