----------------------------------------------------------------------------------------------------------------------------------------------------------------------------------------------------------------------------------------------------------------------------------------
----------------------------------------------------------------------------------------------------------------------------------------------------------------------------------------------------------------------------------------------------------------------------------------
----------------------------------------------------------------------------------------------------------------------------------------------------------------------------------------------------------------------------------------------------------------------------------------
----------------------------------------------------------------------------------------------------------------------------------------------------------------------------------------------------------------------------------------------------------------------------------------
--------------------------------------------------------------------------------------------------E-----------------------------------------------------------------------------------------------------------------------------------------------------------XXX-----------------------
-------------------------------------------X-SS-----------------------------------------------------------------------------------------------------------------------XX---------------------------------------??SS-----------------------------------------?--S-------------S?SSSS-----
------------------------------------------XX--------------------------------------------------------------------------------------------------------------------------------------------------------------------------XX----------------------------------------------------------------
------------------------------------------XXX------------------------------X-------------------------------------------------------------------------------------------------------------------------------------------------------------------XXXXX------------------------------------
---------------------------------E--------XXX-----------------------------------------------------------------------------------------------------------------------------------------------------------S---------------------E--------------------------------X------------------------
-----S---<------E------------E--<>-----X--XXX----------E-------------------------------------------------------Q-----------------S-------------------------------SSSSS-------------------------------X-----------------------<>----------------------------E-XXXX---------E----XXX---XXX
---------E-----<>---E-------<>--[]-----X--XXX----E----<>----------------------------------------X----------------------------------------------------------------------------------------------------X-----------------------E------------------E---------<>-------E---EXX--------------
---------------[]--<>-----------[]--------XXX---<>----[]-----------------------------XX----------------------------------------------------------------------------------XX-------------------------XXX----------------------------------------<>----------[-----XXX--------------------
---------------[]--[]-------[E--[]-----E-XXXX---[]----[]--E-----E-E-E------------E----------E---EE-------E-E-------------------------------------E-EE-E-----------EE--------------------------------XXX--------------------------E--EE----EE--E[]---------E[---------------XX---X-X-----
XXXXXXXXXXXXXXXXXXXXXXXXXXXXXXXXXXXXXXXX--XXXXXXXXXXXXXXXXXXXXXXXXXXXXXXXXXXXXXXXXXXXX--XXXXXXXXXXXXX--XXXXXXXXXXXXXXXXXXX----XXXXXXXXXXXXXXXXXXXXXXXXXXXXXXXXXXXXXXXXXXXXX----XX----XXXXXXXXXXXXXXXXXXXXXXXXXX---XX-XX-XXXXXXXXXXXXXXXXXXXXXXXXXXXXXXXXXXXX----------------XXXXXXXXXXX-
