----------------------------------------------------------------------------------------------------------------------------------------------------------------------------------------------------------------------------------------------------------------------------------------
----------------------------------------------------------------------------------------------------------------------------------------------------------------------------------------------------------------------------------------------------------------------------------------
----------------------------------------------------------------------------------------------------------------SSSSSSSSSSSSSSSSSSSSSSSSSSSS----------------------------SSSSSSSSSSSSSSSSSSSSSSSSSSSS------------------------------------------------------------------------------------
---------------X------------------------------------------------------------------------------------------------------------------------------------------------------------------------------------------------------------------------------------------------------------------------
---------------X------------------------------------------------------------------------------------------------------------------------------------------------------------------------------------------------------------------------------------------------------------------------
---------------X-S------------------------------------------------------S----------------------------------------S-------------------------------------?SSS--------------------------------------------------------------------------------------S--------------------------------------
--------------XX------------------------------------------------------------------------------------------------------------------------------------------------------------------------------------------------------------------------------------------------------------------------
-------------XXX-----------------------------------------------------------------------------------X-------------S-----------------------------------------------------------------------S-----------------------------------------------------XX---------------------------------------
------------XXXX--------------------------------------------------------E-------------------------XX----------------------------------------XXXXXX--------------------XX-----------------XXS-----------------------------------------E---------X-----------------E----------E-----------
-----------XXXXX----------------------------X----------------E---------<>----------E--------------XXX-----------SSSS----S-S------X-XX------X--------?---SSS----------X--SS------Q-S------X--------------------------------S-------------------------------------<>---------<>----------E
----------XXXXXX-----E-----<---------E-----XX---------------[]---------[]-----[]--<>-------------XXXX-----------[----------------X-XX-X----X------------------------XXXX[----------------X-X------------------------E----------------E----------E----E-----<----[]---------[]---------<>
----------XXXXXX-----X-----[--------------XXX-----X---------[]---------[]-----[]--[]-----------XXXXXX--------------------------XXXXXX------X----------------------------]-------------XX[X-XX----------------------<>---------------<>---------<>---<>-----[----[]---------[]---------[]
-E-EE---XXXXXXXX-----X-----[EE-----------XXXX------------E--[]-----E-E-[]-----[]--[]---E------XXXXXXX-----------]-----E-------XXXX-XX------X----------------------------E-----E------XXX[X-X----------E-EE----E----[]----------E-E--[]-----E--E[]---[]-----[----[]---------[]---------[]
XXXXXXXXXXXXXXXXXXXXXXXXXXXXXXXXXXXXXXXXXXXXX--XXXXXXXXXXXXXXXXXX-XX---XX-XXXXXXXXXXXXXXX--XXXXXXXXXXXXXXX--XXXXXXXXXXXXXXXXXXXXXXXXX-XXXXXX----XXXX-----XXXXXXXXXXXXX--XXXXXXXXXXXXXXXXXXXXX--XXXXXXXXXXXXXXXXXXXXXXXXXXXXXXXXXXXXXXXXXXXXX-XXXXXXXXXXXXXXX-XXXXXXXXXXX-X-XX-XXXXXXXXXX
