----------------------------------------------------------------------------------------------------------------------------------------------------------------------------------------------------------------------------------------------------------------------------------------
----------------------------------------------------------------------------------------------------------------X-----------------------------------------------------------------------------------------------------------------------------------------------------------------------
----------------------------------------------------------------------------------------------------------------SSS--------------SSSSSSSSSSSSSSSSSSSSSSSSSSSSSSSSSSSSSSS----------------------------------------------------------------------------------------------------------------
----------------------------------------------------------------------------------------------------------------------------------------------------------------------------------------------------------------------------------------------------------------------------------------
---------------------------------------------------------------------------------------------------------------------------------------------------------------------------------------------------------------------------------------------------------------XXXXX--------------------
-------------------------------------------E----------------------------------------------------------------------------------------------------------------------------------------------E---------X---SSSSQQSSSSS------SSSSSSS----------------------------E------------------SSXXXXX--
-----------------------------------------------------------------------------------------------------------------------------------------------------------------------------------------<>---------------------------------------------------------------------------------------------
------------------X-------------------------XX-X-----------------------------------------------------------------------------------------------------------------------------------------XX---------X-----------------------------------------------------------------------------------
-----------------XX-----------------------------------------S-------------------------------------------------------------E----------------------------------SSS-----------------------XXXX---------------------------------------------------------------------------------------------
----------------XXX---------------------X---------------------------SSS----------------------Q-----------------------S---<>-----E-------------------QQS------X----------X------------XXXXXX---------------SSSSSSQQQ------------------------------S----------XXXX------------XXXXXX------
--------------EXXXX--------------------XXX---------------------------------------E---------------------------------------[]----<>---E------X-----------------X-X--X------------------XXXXXX------------------------------------------------------------------------------XXX------------
--------------XXXXX--------------------XX----------------------------------------X-----------------------------X---------[]----[]--<><>----X--------------XX<X-XX------------------XXXXXXXX--------------------------------------XXX----------------------------------------------------
--------------XXXXX-----------E---E-EXXXX-EE------E-EE-E-------------------------------------------------------X---------[]----[]--[][]--XXXE-----E------XX-[]-X------------------XXXXXXXXX-----E----------------------EE---------XX----------------------------------------------------
XXXXXX--XXXXXXXXXX-XXX-XXXXXXXXXXXXXXXXXXXXXXXXXXXXXXXXX-XXXXXXXX---XXXXXXXXXXXXXXXXXXXXXXXXXXXXXXXXXXXXXXXXXXXXXXXXXXXXXXXXXXXXXXXXXXXXXXXXXXXXXXXXXXXXXXXXXX-XXXXXXXXXXXXXXX---XXXXXX--XXXXXXXXXXXXXXXXXXXXXXXXXXXXXXXXXXX-X--XXXXXXXXX----XXXXXXXXXXXXXXX----------X-----------------
