----------------------------------------------------------------------------------------------------------------X-----------------------------------------------------------------------------------------------------------------------------------------------------------------------
--------------------------------------------------------------------------------------------------------------------------------------S----S--------------------------------------------------------------------------------------------------------------------------------------------
------------------------------------------------------------------------------------SSSSSSSSSSSSSSSSSSSSSSSSSSSSSSSSSSSSSSSSSSSSSSSSSSSSSSSSSSSSSSSSSSSSSSSSSSSSSSSSSSSS----------------------------SSSSSSSSSSSSSSSSSSSSSSSSSSSS--------------------------------------------------------
----------------------------------------------------------------------------------------------------------------SSSSSSSSSSSSSSSS----SSSSSSSS--------------------------------------------------------S-S----SS---------------------------------------------------------------------------
----------------------------------------------------------------------------------------------------------------SSSSSSSSSSSSSSS-----SSSSSSSS--------------------------------------------------------S-S----SSS?-------------------------------------------------------------------------
----------------------------------------EQQ-----XXXXXXXX-----------------------------S---------------------S----SSSSSSSSSSS--SSS----S-----SSSSS----SS--------------------------QQQQQQ--------SSSSSSSSSSSS--SS----S---------SS-----XXXX-----------------------XXX------------------------
-----------------------------------------------------------------------------------------------------------------S-S--------------------------------------------------------------------------------------------------------------------------------------------------------------------
----------------------------------------------------------------------XX-------------S------------------------------------S-------------------------------------------------------------------------------------------------------------------------------------------------------------
-----------------------------XSSSSSSS--------------------------------XXX-----------------------------------SS-------?------------------??--------------------------SS------------------------------------------------------SS-----------------------------------------------------------
------Q---------E-----------------------SSSS-----S-SS---------------XXXX------------SSSS----S-----------X--------SSSSSSSSSSS-------E--<>---XSSSSS--SS----------XX------X------SS--QQQQ--------------SSSSS--SS----------EX---------------------------------------------------------------
---------------<>-------------------------------------------------XXXXXX-----------<[------E---------X-XX-------XSSSSSSSSSS-------<>--[]-----------SS--------X-XX------X-----------------------------------SSS--------<XX-------------------X-------------------------------------------
---------------[]------------------------------------------------XXXXXXX-----------[------<>--------XXXXX-------SSSSSSSSSSS-------[]--[]----------<S--------<XXXX------X-------------------------------S--SSS-------XXXXX-------------------X-------------------------------------------
---------------[]-E---------------------------------------------XXXXXXXX--------E--[]-----[]------XXXX-XX-------SSSSSSSSSSS-------[]--[]---X]--E--[]-------XXX-XX------X------------------E------------S--SSS-------XX[XX------------EE-E---X---------EE-E-E--------E---E---------------
XXXXXXXXXXXXXXXXXXXXXXXX-XXX---XXXXXXXXXXXXXXXXXXXXX---XXXXXXXXX-XXXXX---XXXXXXXX-XXXXXXXXXXXXXXXXXXXXXX------XXXXXXXXXXXXXXXXXXXXXXXXXXXXXXXXXXXXXXXXXXXXXXXXXX--XXXXXXXXXXXXXXXXXXXXXXXXXXXXXX-X-XXXXXXXXXXXXXXXXXXXXXX-X--XXXX-XXXXXXXXXXXXXXXXXXXXXXXXXXXX---XXXXXXXXXXXX-------XXXX
