----------------------------------------------------------------------------------------------------------------------------------------------------------------------------------------------------------------------------------------------------------------------------------------
----------------------------------------------------------------------------------------------------------------------------------------------------------------------------------------------------------------------------------------------------------------------------------------
----------------------------------------------------------------------------------------------------------------------------------------------------------------------------------------------------SS--------------------SSSSSS--------------------------------------------------------
----------------------------------------------------------------------------------------------------------------------------------------------------------------------------------------------------------------------------------------------------------------------------------------
----------------------------------------------------------------------------------------------------------------------------------------------------------------------------------------------------------------------------------------------------------------------------------------
------------------SS-------------------SS----------------------------------------------------------E--------------------------------------------------------XXX--------------SSQQQQQQQQ------------S-----------------------------------Q--QQQQQ---------SSSS----------------------------
--------------------------------------------------------------------------------------------------E--------------------------------------------------------XXXX-------------------------------------------------------------------------------------------------------------------------
--------------------------------------------------------------------------------------------------XXXXXX---------------------------------------------------XXXX-------------------------------------------------------------------------------------------------------------------------
--XXX-------------------------------------------------------------------------------------------X---------------------------------------------------------XXXXX-----------------------------------------------E------------E------------------------------------------------------------
------------XXX---------------E--QQ--S?-----E--------------------------------------------------XX------------------------------X----------------------X--XXXXXX---------------SS?-QSSSQQ--------------E--S---<>-----E-----<>--------E-Q---QQQQQQQQ--------------------------------------
-----------------------------<>------------<>---E-----------------------E----------------------XXX-------E------------------XX------------------------X-EXXXXXX--------------------------------------<>------[]----<>---E-[]--------------------------------------------------X---------
-----------------------------[]--X---------[]--------------------------<>---------------------XSS-------<>-----[-----------XXX-------------->---------XXXXXXXXX-------XX-----------------------------[]--X---[]----[]--<>-[]---X--------------------------------------------XXX---------
-----------------------------[]------------[]-EE------------EE----E----[]------------EE-EEE-XXXXX-EE----[]--EE-[-----------XXX----------E---EE-E------XXXXXXXXX-------XX-------------------E---------[]------[]----[]--[]-[]-----------------------E------------------------XXX---------
XXX---XXXX-X--XXXXXXXXXXXXXXXXXXXXXXXXXXXXXXXXXXXXXXXXXXXXXXXXXXXXXXXXXXXXXX--XXXXXXXXXXXXXXXXXXXXXXXXXXXXXXXXXXXXXXXXX---XXXXX---XXXXXXXXXXXXXXXXXXXXXXXXXXX------X----XXXXXXXXXXXXXXXXXXXXXXXXXX--XXXXXXXXXXXXXXXXXXXXXXXXXXXXXXXXXXXXXXXXXXXXXXXXXXXXXXXXXXXXXXXXXXXXXXXXXXXXXXXXXXXX
