----------------------------------------------------------------------------------------------------------------------------------------------------------------------------------------------------------------------------------------------------------------------------------------
--------------------------------------------------------------------------------------------------------------------------------------------------------------------------------------------------------------------------S-------------------------------------------------------------
------------------------------SSSSSSSSSSSSSSS---SSSSSSSS--------------------------------------------------------------------------------------------------------------------------------------------SSSSSSSSSSSSSSSSSSSSSSSSSSSS--------------------------------------------------------
------------------------------SSSSSSSSSSS-S------S----SS----------------------------------------------------------------------------------------------------------------------------------------------SSSSSSSSSSSSSS-----SSSSSSS--------------------------------------------------------
------------------------------SSSSSSSSS-S-------SS----SS--------------------------------------------------------------------------------------------------------------------------------------------S-SSSSSSSSSSSSS------SSSSSS---------------------------------------------------------
--------SS------------------SSSSSSSSSSSS-SSS----------SS---------------------------------------------E----------------------------------SSSS---------------------------------------------------XXX--SSSSSSSSSSS--SSS------SSSSSS---------------------------X----------------------------
------------------------------------------------------------------------------------------XX--------------------------------------------------------------------------------------------------------------------------------------------------------------------------------------------
---------------------------------------------------------------------XX---XX------------------------------------------------------------------------------------------------------------------------------------------------------------------------------------------------------------
--------------------------------E-----------------------------------------------------------------------------------------------------------------------------------------------------------------------E------------------SS--------------------------------XXXXX----------------------
-------------------------------SSSSSSSS---------------------------------------SS-------------------XXXX---------------------SS--------------SSS---------------XX----------------------XXXX------------SSSSSSSSS--------E-----------------------------SSSSSSS------------XX--------------
------------------------------E---------------<>------------------------E------------------------------------------------------------------------------------XXX--------------------------------------SSSSSSSS--------<>------------------------------------------------------------X---
-------------------------------S-X------------[>--------------------------------------XX-------------------------------------------------------------------XXXXX-------X------------------------------SSSSSSSS--------[]----------------------------------------------------------------
------------------E--------X------------------[]E---------E-EE----E-----------E--E-E-----------------------------------------------------------------------XXXXX-----XXX-------------------------------SSSSSSS--------[]---------------EE------------E-E--------------------------------
XXXXXXXXXXXXXXXXXXXXXXXXXXXXXXXXXXXXXXXXXXXXXXXXXXXXXXXXXXXXXXXXXXXXXXXXXXXXXXXXXXXXXX----------XXX-----XXXXXXXXXXXXXXXXXXXXXXXXXXXXXXXX-XXXXXXXXXXXXXXXXXXXXXXXXXXXXXXXX----X--XXXXX------X-------XXXXXXXXXXXXXXXXXXXXXXXXXXXXX---XXXXXXXXXXXXXXXXXXXXXXXXX------XX----------X---------
