X---------------------------------------------------------------------------------------------------------------------------------------------------------------------------------------------------------------------------------------------------------------------------------------
----------------------------------------------------------------------------------------------------------------------------------------------------------------------------------------------------------------------------------------------------------------------------------------
SSSSSSSSSSSSSSSSSSSSSSSSSSSS------------------------------------------------------------------------------------------------------------------------------------------------------------------------------------------------------------------------------------------------------------
SSS----SSSS---------------------------------------------------E-------------------------------------------------------------------------------------------------------------------------------------------------------------------------------------------------------------------------
S------SSS?----------------------------------------------XXXXXXXX-----------------------------------------------------------------------------------------------------------------------------------------------------------------------------------------------------------------------
-S------S-?---------------S----------------------------------------------SSSS-----------------------------------------------------------------------------------------------------------------------Q-------------------------------------------------------------------------SS--------
----------------------------------------------------------------------------------------------------XX-----------------------------------------------------------------------------------------------------------------------------------------X----------------------------------------
----------S----------------------------------------------------------------------------------------------------------------------------------------------XX-XXXX------------------------------------------------------------------------------XX----------------------------------------
----------E------------SS--------------------------------------------------------------------------------------------------------------------------------------------------------------------------------------------------------------------XXX--------------XX------------------------
>--S-----[]---------E------X-----------------------------XXXX-------------XXXX------------------------------------------------QQ----------------------------------S----------------------------------------------XXXXX-----------------------XXX------------------------XXX----------X--
SSSSSS---[]--------<>------X------------X--------------------------E-X------------XX------------------------------------------------------------------E-----E---------------------------E-----------------------XX------------------------XXXXXX------------------------------------X-XX
SS?SS----[]--------[]------X------------X-------------------------------------------------------------------------------------------------------------E---------------------------------------------------------XX------------------------XXXXXX-----------[----------------------------
SSSSS--S-[]--------[]------X--------E---X--------EE-EE-----------------------XX-------------E----------------------------E--------------------E--E--E-S-----------EE-E-E----------E---------------E------------XXX-------E--E------------XXXXXXX--------E--[----------------------------
XXXXXXXXXXXXXXXXXXXXXXXXXXXXXXXXXXXXXXXXXXXXXXXXXXXXXXXX---------------------------------XXXXXXXXXXXX-------X-XXXXXXXXXXXXXXXXXXXXX---------XXXXXXXXXXXXXXXXXXXXXXXXXXXXXXXXXXXXXXXXXXXXXXXXXXXXXXXXXXXXXX--XXXXXX---XXXXXXXXXXXXXXXXXXXXXXXXXXXXXXX-XXXXXXXXXXXXXXXXX--XXXXXXXXXXXXXXX-
