----------------------------------------------------------------------------------------------------------------------------------------------------------------------------------------------------------------------------------------------------------------------------------------
----------------------------------------------------------------------------------------------------------------------------------------------------------------------------------------------------------------------------------------------------------------------------------------
---------------------------------------------------------------------------------------------------------------------------------------S--------------------------------------------------------------------------------------------------------------------SSSSSSSSSSSSSSSSSSSSSSSSSSSS
-----------------------------------------------------------------------------------------------------------------------------------------------------------------------------------------------------------------------------------------E------------------S---------------------------
------------------------------------------E--------------------XX------------------------------------------------------------------------------------------------------------------------------------------------------------------------XXX-------------------------S?-----------------
X-------QQSSSSS-------------E----------------E----------------------SSS----XXXX--------------------X---------------S-SSSSSSS--------------SS-----------------X------------------------------------XX------------------------------------------------------------------------------------
-------------------------------XXXXX-------------XXXXX---------------------------------------------XX------------------------------------------------------XXX--------------------------------------------------------------------------------------------------------------------------
E-------------------------------------------------------------------------------------------------XXX-----------------------------------------------------XXXX----------------------------------------------------XX---------------------------------------------------------------E----
XXX-----------------------E-----------------------------XXXXXXX-------------------XX-------------XXXX----------------------------------------------------XXXXX---------------------------------------------------XXX-----------------SS---------------------E---------E-----------<>----
-------S?S-SSSSS---------<---------------XXXXXX---------------------XX-----------X---------------XXXX---------------SSSSSSS------------------------------XXXXX---------E----------------------SSSSSS-------------XXX-----------------------E--QQQ---------E->--S-----[]---------E-[]---X
-------------------------[]-----------------------------------------------------XXXS----------XXXXXXX----------E--E-----------------------------------X-XXXXXX--------<>--------------------------------------XXXXXX-----------<-------------------------<>-SSSSS----[]--------<>-[]---X
-------------------------[]------------------------------------------------------------------XXXXXXXX---------<[------------------->-----------------XXXXXXXXX--------[]-------------------------------------XXXXXXX-----------[-------------------------[]-SS?SS----[]--------[]-[]---X
-------------------E-----[]----------------------------------------------------------E-E----XXXXXXXXX---------[[---------E--------E]-----------E-----XXXXXXXXX--------[]-------E-EE-------------------------XXXXXXXX--------E--[---------E---------------[]-SSSS--ES-[]--------[]-[]--XX
---XXXXXXXX-XXXXXXXXXX-----------X--------------------------------------XXXXXXXXX---XXXXXXXXXXXXXXXXXX-----XX--XXXXXXXXXXXXXXXXXXXXXXXXXXXXXXXXXXXXXXXXXXXXXXXX--XXXX-XXX-XXXXXXXXXXXXXXXXXXXXXXXXXXXXXXXXXXXXXXXXXXXXXXXXXXXXXXXXXXXXXXXXXXXXXXXXXXXXXXXXXXXXXXXXXXXXXXXXXXXXXXXXXXXXXX
