----------------------------------------------------------------------------------------------------------------------------------------------------------------------------------------------------------------------------------------------------------------------------------------
----------------------------------------------------------------------------------------------------------------------------------------------------------------------------------------------------------------------------------------------------------------------------------------
SSSSS-------------SSSSSSSSSS----------------------------------------------------------------SSSSSSSSSSSSSSSSSSSS------------------------------------------------------------------------------------SSSSSSSSSSSSSSSSSSSSSSSSSSSS--------------------------------------------------------
----------------------------------------------------------------------------------------------------------------------------------------------------------------------------------------------------------------------------------------------------------------------------------------
----------------------------------------------------------------------------------------------------------------------------------------------------------------------------------------------------------------------------------------------------------------------------------------
------------------------------------------------------XX-------------------S-------------------------XX-----------SS----SS-------SSS--------------------------------XXX-----------------------------------------------------------------------------------------------------------------
----------------------------------------------------------------------------------------------------XXX---------------------------------------------------------------------------------------------------------------------------------------------------------------------------------
---------------------------------------------------------------------------------------------------XXXX---------------------------------------------------------------------------------------------------------------------------------------------------------------------------------
----------E------------E-------------------------------------------------------------S-------------XXXX-------------------------------------------------------------------------------------------------------E-------S-----------------------------------------------------XS----------
---------<>-----------<>----------------------------------XXX---------------------------------X-----XXXX--X----------------------------------------------XXXX-------------------------------SSSSSSSS---S-----<>---------------------------------E------------>--------------------------
---------[]-----------[]------------------------------------------------------------>------------XX-XXX---X---------------------------------------------XXX--------------------------------------------------[]----------------X---------------<>-----------<>-------E------X-----------
---------[]--------<X-[]---X-----------------------------------------------------XX-]---------X-XXXXXXXX--X--------------------------------------------XXX--------------XX-----------------------------------[]-----<--XX------X---------------[]-----------[]----------XXXXXX----------
---------[]--------[--[]---X----------E---------------------------------------E--X--]--E-------XXXXXXXXX--X-------------------------------------------XXXX-------E--E----------EE-------------------E-----E--[]----------------X----E------E---[]-----------[]----------XXXXXX----------
XXXXXXXXXXXXXXXXXXXXXXXXXXXXXXXXXXXXXXXXXXXXXXXXXX--XXXXXXXXXXXXX--X---XXXXXXXXXXXXXXXXXXXXXXXXXXXXXXXXXXXXXXXXXXXXXXXXXXXXXXXXXXXXXXXXXXXXXXXXXXXX--XXXXX---XXXXXXXXXXX----XXXXXXXXXXXXXXXXXXXXXXXXXXXXXXXXXXXXXXXXXXXXXXXXXXXXXXXXXXXXXXXXXXXXXXXXXXXX-XXXXXXXXXXXXXXXXXXXXX-XXXXXXXXX
