----------------------------------------------------------------------------------------------------------------------------------------------------------------------------------------------------------------------------------------------------------------------------------------
S---------------------------------------------------------------------------------------------------------------------------------------------------------------------------------------------------------------------------------------------------------------------------------------
SSSSSSSSSSSSSSSSSSSSSSSSSSSS----------------------------------------------------------------------------------------------------------------SSSSSSSSSSSSSSSSSSSSSSSSSSSS----------------------------------------------------------------------------------------------------------------
---------------------------------------------------------------------------------------------------------------------------------------------------------------------------------------X---------------------E--------------------------------------------------------------------------
-------------------------------------------------------------------------------------------------------------------------------------------------------------------------------------------------------------XXX--------------------XXXX------------------------------------------------
-----------------------------XXX-----------------------------------------------------------------------------------------------------------X-------------------------------------------X--------------------------------------------------------------SSSS---------------E---E----------
--------------------------------------------------------------------------------------------------------------------------------------------------------------------------------------EX------------------------------------------------------------------------------------XXXXXXX-----
-----------------S--------------------------------------------------------------------------------XX----------------------------------------------------------------------------------XXXX-X--------------------------------------------------------------------------------------------
E---------E------SSS-----------------------------------------E----------E------------------------XXXX-------------------------------------------------------XSSS--------------------X-XX--------------------S---------------------------------------------------------------------------
<>---S---<>-----------X------------------------------S-S----<>---------<>------------------------XXX----------------------------------SSSSS-<>-------E-----------------------------XX-X---------------------------QQ---------QQ-XQQQ-------------XXXXX-----------------------SS-S------Q
[]-------[]-----------X----E--------------------------------[]---------[]----E----------------XXXXXX------------------E---E-----------------[]-------E-----------XX---------------XXXXXX-----E-----<------E---E------------------------------XXXXX-X---------E--------------------------
[]-------[]---X-E--EXXX---<>-XX---------X-------------------[]---------[]---<>---------------XXXXXXXX--------------------<>-----------------[]----------XXXX<>---XX---------------XXXX-X----<>-----[---------<>---------------------------------------------XXXX------------------------
[]-------[]--XX------XX---[]-----E--E---E--------E-E-----E--[]-----E-E-[]---[]-----X---------XXXXXXXXX------E------------[]-----------------[]-----------XX-[]---XX------E--EEE-XXXXX-EE----[]--E--[---------[]--------------EE---------------------------------------------------------
XXXXXXXXXXXXXXXXXX--XXXXXXXXXXXXXXXXXXXXXXXXXXXXXXXXXXXXXXXXXXXXXXXX-XXXX--X-XXXXXXXXXXXX---XXXXXXXXXXXXXX--XXXXXXXXXXXXXXXXXXXXXXXX--XXXXXXXXXXXXXXXXXXXXXXXX-XXXXXXXXXXXXXXXXXXXXXXXXXXXXXXXXXXXXXXXXXXXXXXXXXXXXXXXXXXXXXXXXX----------XXX--X-XXXXXXXXXXX-------------XXXX-XXXXXXXXXX
