----------------------------------------------------------------------------------------------------------------------------------------------------------------------------------------------------------------------------------------------------------------------------------------
----------------------------------------------------------------------------------------------------------------------------------------------------------------------------------------------------------------------------------------------------------------------------------------
----------------------------------------------------------------------------------------------------------------------------------------------------------------------------------------------------------------------------------------------------------------------------------------
XE--------------------------------------------------------------------------------------------------------------------------------------------------------------------------------------------------------------------------------------------------------------------------------------
<XXXXXXX-------------------------X----------------------------------------------------------------------------------------------------------------------------------------------------------------------------------------------------------------------------------------E-------------
?-----------------SSSSSSS---E-------------------XXXXXX-------------------XX-------------------------------------------------------------------------------------------------------------------------------------SSS--------------------QQ-QQQQQ---------SSSS----------------------------
----------------------------XXXX-XXX-------------------------------------XX-------------------------------------------------------------------------------------------------------------XXXX--------------------------------------------------------------------------------XXXX--------
-----------------------------------------------------------------------XXXX-------------------------------------------------------------------------------------------------------------------------------------------------------------------------------------------------------------
---------------------------------------------------------S------------XXXXX---------------------------------------------------------------------------E----------------------------------------------XSSSS--------------------E---------------------------------------------------------
XXXX-------------XXXXX---------------------XXXXXX-----------------X---XXXXX----------------------------------------X------------XSSSS----------------<>------------------------------------------SSS------------SS-----------Q------E-Q---QQQQQQQQ------------------------------------SS
-----------EXXXXX-------------XX-------------------------------------XXXXXX---------------------------------------XX---------------------------------[]---------E--------X---------------------------------------------------E----------------------------------------------------------
------XX----------------------------------------------------------XXXXXXXXX---------------------------------------XX---------------------------------[]--------<>-------XXX--------------------------------------------------X------------------------------XXXX------------------------
--------------------------------------------------------]---------XXXXXXXXX---------------------------------------XX---------------------------------[]-----------------XX-----EE--------------E---------------------------------------------------E----------------E---E----------E----
--------------------XX---XXX----------------------------XXXXXXXXXXXXXXXXXXXXXX--XXXXX-XXXXXXXXXXXXXXXXXXXXXXXXXXXX------------X-XXXXXXXXXXXXXXXXXXXXXXXXXXXXXXXXXXXXXXXXXXXXXXXXXXXXXXXXXXX-XXXXXXXX---XXXXX-----------------X--XXXXXXXXXXXXXXXXXXXXXX-XXX-------XXXXXXXXXXXX---XXXXXXXX
