----------------------------------------------------------------------------------------------------------------------------------------------------------------------------------------------------------------------------------------------------------------------------------------
----------------------------------------------------------------------------------------------------------------------------------------------------------------------------------------------------------------------------------------------------------------------------------------
--------------------------------------------------------SSSSSSSSSSSSSSSSSSSSSS----------------------------------------------------------------------------------------------------------------------------------------------------------------------------------------------------------
----------------------------------------------------------------------------------------------------------------------------------------------------------------------------------------------------------------------------------------------------------------------------------------
-----------------------------------------------------------------------------------------------------------------------------------------------------XXX-------------------------------------------------------------------------------------------------------XXXXX--------------------
----------QQQ------------------------------------------------------------XX----------------------------------------------------XXX--------------------------------------------------XE--------------------------------X----XXXX-----------------------------S------------------SSSSSSS--
-------------------------------------------X-----------------------------XX---------------------------------------------------XXXX------------------------------------------------------XXXXX------------------------XX-----------------------------------------------------------------
------------------------------------------XXX----------------------------XX--------------------------------------------------XXXXX-----------------------------------------------------------------------------------XX-----------------------------------------------------------------
----------------E------------------------XXXX---------------------------XXX--------------E----------E-----------------------XXXXXX---------------S----------E--------------------------------------ESS-------------XXXX-----------------------------------------------------------------
-----QQ---??---<>------------------------XXXX-------------------Q-S-----XXX---X--------------------<>----------------------XXXXXX----------------------E--QQQ----------------------------SS-SS----SSX-------------XXXXX-------------------------E-----------XXXXX-------------XXXX------
-<-------------[]------E--------------XXXXXXX-----------E-------------X-XXX---X----------E---------[]---------------------XXXXXXXX---X-----------------------------------E--------------------------X------------XXXXXX------------------------<>----------------------EXXX-------------
-----X---------[]---------------------XXXXXXX----------->-----------XXXXXXXX--X----X----<>---------[]--------------------XXXXXXXXX---X----------------------------------XXXX------------------------X------------XXXXXX------------------------[]------------------X--------------------
---------------[]-EE---------E-E-----XXXXXXXX-----------]--E--------XXXXXXXX--X----X----[]---E-----[]-----------EE-E----XXXXXXXXXX---X---------------E------------------XX------------------------------------XXXXXXXXX-------------E------E---[]--------------------------X------------
XXXXXXXXXXXXXXXXXXXXXXXXXXXXXXXXXXXXXXXXXXXXXXXXX--XXXXXXXXXXXXXXXXXXXXXXX----XXX--X-XXXXXXXXXXXXXXXXXXX---XXXXXXXXXXXXXXXXXXXXXXXXX-X-XXXXXXXXXXXXXXXXXXXXXXXXX---XXXXXXX---XXXXX--XXXXXXXXXXXXXXXXXXXXXX--XXXXXXXXXXXXXXX-XXXXXXXXXXXXXXXXXXXXX--XXXXXXXXX--------XXX-----------------
