----------------------------------------------------------------------------------------------------------------------------------------------------------------------------------------------------------------------------------------------------------------------------------------
----------------------------------------------------------------------------------------------------------------------------------------------------------------------------------------------------------------------------------------------------------------------------------------
--------------------------------------------------------------------------------------------------------------------------------------------SSSSSSSSSSSSSSSSSSSSSSSSSSSS-----------------------------------------------------------------SSSSSSSSSSS---SSS------------------------------
----------------------------------------------------------------------------------------------------------------------------------------------------------------------------------------------------------------------------------------------------------------------------------------
---------------------------------------------------------XX-XX--------------------------------------------------------------------------------------------------------------------------------------------------------------------------------------------------------------------------
-----------------SSS--------------------------E---------S---------------------SSS---------------------S----S-----------------E----------------------------------------------------------------------------SQQQQQ----------------SS--------------------------SS--------------------------
---------------------------------------------<>---------------------------------------------------------------------------------XXXXXX--------------------------------------------------------------------------------------------------------------------------------------------------
---------------------------------------------[X----------------------------------------------------------------------------------------------S---------------SX----------------------XX---XX----------------------------------------------------------------------------------X---------
---------------------------------------------XX--------------------------------------------------------------------------------------------------------------XXS-----------------------------------------------------------E---------------------------------S---------------XX---------
-XQX--------------XX---------------------XXXXX----------SQQQ--------------XXXX----X-X-----------------EX----------------------------SS-----Q<SSS----S-S------X-XX-X----X---------------------SSS-S--------SS--QSQ---------<>--E-SSS--------------XX---------SQQ-------------XXXX--------
--------------X--------------------------XXXXX-----------------E---EXXX--XXXX-------X-------------EXXXXXX--------E--------------------------[]---------------X-XX-X----X----------E-----E---------------------------------[]-->-----------------XXXX--------[--------------XXXXXX-------
----------------------------------------XXXXXX----------------<>---------XXXX-------X------------------X--------XXXX------------------------[]-----------XXX[]-XX-X----X----------E---------------------------------------[]-[-----------------XXXXX--------]--------------XXXXX--------
--------------------------------------XXXXX-XX----------------[]-------XXXXXX-------X---------------------------XX--------------------------]-----E------XXX[X-XX-X-------E-EE----S-----------EE-E-E----------------------[]-[--]-------------XXXXXX--------]-------------XXXXXX--------
XXX------XXXX--XXXXXXXXXXXXXXXXXX----XXXXX--------------XXXXXXXXXXXXX--XXXXXXXXXXXXXXXXXXX---XXXXXX---------X-XXXXX--XXXXX---XXXXXXXXXXXXXXXXXXXXXXXXXXXXXXXXXXX--XXXXXXXXXXXXXXXXXXXXXXXXXXXXXXXXXXXXXXXXXXXX-XXXXXXXXXXXXXXXXXXXXXXXXXXXXXXXXXXXXX----XXXXXXXXXXXXXXXXXXXXXX----------
