----------------------------------------------------------------------------------------------------------------------------------------------------------------------------------------------------------------------------------------------------------------------------------------
----------------------------------------------------------------------------------------------------------------------------------------------------------------------------------------------------------------------------------------------------------------------------------------
----------------------------------------------------------------------------------------------------------------------------------------------------------------------------------------------------------------------------------------------------------------------------------------
-----------------------------------------------------------------------------------------------------------------------------------------------------------------------------------------------------------------------------------------E----------------------------------------------
-----------------------------------------------------------------------------------------------------------------------------------------------------------------------------------------------------------------------------------------XXX---------------------------------E----------
-------------------------------------------X----------------SSSSSSSSS-SS----------SS--XX----------------------------------------------------------------------------SS--Q---------------------------------SQQQQQQ--------------S------------EQQ----------------E--E-----XEX--E----------
------------------------------------------E-------------------------------------------------------------------------------------------------------------------------------------------------------------------------------------------------------------------X--XXXX-----------XXXXX---
------------------------------------------XXXXXX--------X-----------------------------------------------------------------------------------------------------------------------------------------------------------------------------------------------------X-------------------------
----------------E-------------------------------------------------------------------------------------------------------------------------------------------------------------------------------------------------------------------SSSSS---------------------------------------------XX
-----E---------<>----------------------X---------------E-----SSSSSSSQ-------------------------------------SSSS--------------------------------Q---------------X-----------------------XXXX----------------SS--QSQQ--------------------------QQQQ---------Q>----X-----------XXSSSS-------
----<>---------[]----------------------X---------E-----<-----------------------E---------------------------------------------------------------------------------------------------------------------------------------------X---------------------------[---EXX------------------------
----[]---------[]-------------------------------<>-----[----------------------<>---------------------------------------------------------------------------------------------------------------------------------------------X---------------------------[]-XXXX------------------------
----[]---------[]------------EE-EEE-E-EEE-EE----[]----E[-------------------EE-[]-X----E--EEEE-E-E--------EEE-E---------------------------------------------------------------------------------------------------------EE-E--X-----------E---------------[]----X------------------------
XXXXXXXXXXXXXXXXXXXX---X-XXXXXXXXXXXXXXXXXXXXXXXXXXXXXXXXXXXXXXXXXXXXXXXXXXXXXXXXXXXXXXXXXXXXXXXXXXXXXXXXXXXXXXXXXXXXXXXX--XXXXXXXXXXXXXXXXXXXXXXXXXX--XXXXXXXXXXXXXXXXX----XX--XXXXXX----------X-X-XXXXXXXXXXXXXXXXXXXXXXXXXXXXXXXXXXXXXXXXXXXXXXXX--XXXXXX-----------------------XXXXX
