----------------------------------------------------------------------------------------------------------------------------------------------------------------------------------------------------------------------------------------------------------------------------------------
--------------------------------------------------------X-------------------------------------------------------------------------------------------------------------------------------------------------------------------------------------------------------------------------------
SSSSSSSSSSSSSSSSSSSSSSSSSSSS---------------------------------------------------------------------------------------------------------------------------------------------------SSSSSSSSSS---SSSSSSSS------------------------------------------------------------------------------------
---------------------------------------------------------------------------------------------------------------------------------------------------------------------------------------------SSSS---------------------------------------------------------------------------------------
--------------------------------------------------------------------------------------------------------------------------------------------------------------------------SSE----------------SSSS--------------------------------------------------------------------XXX----------------
SSSS----S------------------------------------------XXXX----------------------------------------------SSS--------Q----------------------X--------------------------------SSS-S--SS----S-------SSSS-------------------------------------------?SS-----------------------------------------
--------------------------------------------------------------------------------------------------------------------E-------------------------------------------------------------------------------------------------------------------------------------------------------------------
----------------------------------------------------------------------------------------------------------------------------------------------------------------------------------------------------------------------------------------------------------------------------------------
------------------------------------------------------------------------E-------------------------------------------------------------------------------------------------E--------------------SS----------------------------------SS---------------------E------E----------E-----------
--SSS--SSSS--------------------------------X-----------------E---------<>-------------XXX-----------------------X--------------EXXXX----------------------------------E-SSS?S-------------XXX------------------------------------X----------S------------QQ-----<>-----E---<>-----------
---S----SS---------E-------X--------------------------------<>---------[]----X-----E----------------------------X-------------EXXX-X---------E-----------------------<>--------E---EX-----XX-------------------------------------X------------------------------[]---------[]------E--E-
---S-----S------<>-XX------X--------------------------------[]---------[]----<>---<>-------------------------X--X---------------------------XXXX---------------------[]-------<>--------XXXX--------------------X-----------------------------------------------[]---------[]-----------
------E--S------[]-X------XX----------------------------EE--[]-----E-E-[]----[]---[]----------------------E---------------------------------XXXX---------------------[]-------[]-------XXXXXX---------E--EEEE-E-E---------EE-E--XXX----E-E----------------------[]---------[]-----------
XXXXXXXXXXXXXXXXXX----------XXXX----XXXXXXXXXXXXXXX--XXX-XXXXXXXXXXX---XX---XXXXXXXXXXX--XXX--------XXXXXXXXXXX-X---X-----XXX---------------XXXXXXXX------X---XXXXXXXXXXXXXX-XXXXXXXXX-XXXXXXX---XXXXXXXXXXXXXXXXXXXXXXXXXXXXXXX-XXXXXXXXXXXXXXXXXXXXXXXXXXX-XXXXXXXXXXXXXXXXXXXXXXXXXXX
