----------------------------------------------------------------------------------------------------------------------------------------------------------------------------------------------------------------------------------------------------------------------------------------
---------------------------------------------------------------------------------------------------------------------------------------------------------------------------------------------------------------------------------------------------------------------------E----SSS----S
---------------------------------------------------------------------------------------------------------------------------------------------------------------------------------------------------------------------------------------------------------------SSSSSS-----<>----SSS--SSS
-------------------------------------------------------------------------------------------------------------------------------------------------------------------------------------------------------------E-------------------------------------------------SSSSSS-----[]----SSSSSSSS
-------------------------------------------------------------------------------------------------------------------------------------------------------------------------------------------------------------XXX-----------------------------------------------SSSSSS-----[]----SSSSSSSS
-----------------------XXXX-----------------XXX----------------QQQQQQQQ------------S--SSSSSSSSS---SS-----------S-----------SS---------------------------------------------------------------------X--------------QQ--------------------------S--------------?--SSSSSSS---SSS---SSSSSSSSS
-------------------------------------------XXXX-----------------------------------------------------------------------------------------------------------------------------------------------------------------------------------------------------------------------------------------
-------------------------------------------XXXX---------E-------------------------------------------------------------------------------------------------------------------------------------------------------------------------------------------------------------------------------
------------------------------------------XXXXX---------------------------------------------------------------------------------E------------------------------------------------------------------------SS-----------------------SSSSS-------------------E---EX------------------------
--------------XXXX------------------Q-XX-XXXXXX---X-----------Q-?SQSQQQQ-Q-------<>----SSSSSSS---------E-------------E----??---<>---------------------------X----------------------------------S------------------QQ---------QQ-------------SSS----------Q---XS?SSSS-----EE----EXX---XXX
--------------XXXX---------->---------X-EXXXXXX---X----E-------------------------[]-------------------<>---E--------<>---------[]---E----------------------XX---------------------------E----------------------------------------------------------------E------SSSSS--EX---------------
-------------XXXXX---------->--------XXXXXXXXX----X---<>-------------------------[]-------------------[]--<>--------[]---------[]--------------------------XX--------------------------<>--------------------E--------------------------------------------------SSSS--------X-X---------
-------------XXXXX----------EE-E-------XXXXXXXX---X---[]-------------------EE-E--[]-------------------[]--[]--------[]---------[]-E--------------------E--XXX----------X-EE-E-----EE--E[]-----E--------------E----------------E---------------------------------------------X---E-X-----
XXXXX---XXXXXXXX-XXXXX---XXXXXXXXXXX-XXXXXXXXX---XXXX-XXXXXXXXXXXXXXXXXXXXXXXXXXXXXXXXXXXXXXXXXXXXXXXXXXXXXXXXXX-XXXXXXXXXXXXXXXXXXXXXXXXXXXXXXXXXXXXXXXXXXXXXXX--XXXXXXXXXXXXXXXXXXXXXXXXXXXXXXXXXXXXXXXXXXXXXXXXXXXXXX--XXXXXXXXXXXXXXXXXXXXXXXXXXXXXXXXXXXXX--XXXXXX----XXXXXXXX--XX-
