----------------------------------------------------------------------------------------------------------------------------------------------------------------------------------------------------------------------------------------------------------------------------------------
------------------------------------------------------------------------------------------------------------------------------------------------------------------------X---------------------------------------------------------------------------------------------------------------
SSSSSSSSSSSSSSSSSSSSSSSSSSSS------------------------------------------------------------------------------------------------------------------------------------------------------------------------------------------------------------------------------------------------------------
----------------------------------------------------------------------------------------------------------------------------------------------------------------------------------------------------------------------------------------------------------------------------------------
----------------------------------------------------------------------------------------------------------------------------------------------------------------------------------------------------------------------------------------------------------------------------------------
-------------------------------------------X-S-----------------------------------------------------------------------------------------------XXXX----------------------------------------------------XXX--------------------------------S--------SSSS--------------------S-----XXXX-----
----------------XX------------------------XX--------------------------------------------------------------------------------------------------------------------------------------------------------------------------------------------------------------------------------------------
-----------------XX-----------------------XXX-------------------------------------------------------------------------------------------------------------------------------------------------------------------------------------------------------------------------------------------
----------------XXXS-----------------------X---------------------------------------------------------------------------------------------------------------------------------E----------------------------------------------------XX---------------------------XXX---------------------X
<>------Q-S------X-X--X----------------X---------------E----------------------SSSSSS--------------------------------------------E------------------------------------S-----------------------XSS----------------------------------XXX-------XXX----------XX-------------S---------------
[]--------------XX---XX----------E-----X---------E----<>-----------------------------------------------------------------------<>--------------------------------------------E----------E----E------------------X----------------------------------------XX-----------------------------
[]----------XXXXXX-X--X---------<>---------X----<>----[]-----------------------------------------------------------------------[]-----------------------X-------------------<>---------<>---<>-----[------------X----------------------------------------XX-----------------------------
[]-E--E-----XXXXXX-X--X------E--[]-----E--EX----[]----[]-X-----EEE-------------E----------------E------------EE----------------[]-E--------------EEEE---E----------E-EE-----[]---------[]---[]-----[------E-E---X--------E-E-E----------------------E-E--X------------------------------
XXXXXXXXXXXXXXXXXX----XXXXXXXXXXXXXXXXXX--XXXXXXXXXXXXXXXXXXXXXXXXXXXXXXXXXXXXXXXXXXXXXXXXXXXXXXXXXXXXXXXXXXXXXXXXXXXXXXXXXXXXXXXXXXX----XXXXXXXXXXXXXXXXXXXXX--XXXXXXXXXXXXXXXXXXXXXXXXXXXXXXXXXXXXXXXXXXXXXXXXXXXXXXXXXXXXXXXXXXX---XXX----XXXXXXXXXXXXXXX------XXXXX-----------------
