----------------------------------------------------------------------------------------------------------------------------------------------------------------------------------------------------------------------------------------------------------------------------------------
----------------------------------------------------------------------------------------------------------------------------------------------------------------------------------------------------------------------------------------------------------------------------------------
------------------------------------------------------------------------------------------------------------------------------------------------------------------------------------------------------------------------S-----SS--------------------------------------------------------
------------------------------------------------------------------------------------------------------------------------------------------------------------------------------------------------------EE----------------SSSSSS-S--------------------------------------------------------
-----------------------------------------------------------------------------------------------------------------------------------------------------------------------------------------------------XXXX---------------SSSSSSSS--------------------------------------------------------
---------------------------------------------------SSSSX---------------XXX-----------------------Q--------------X-------E?SSSS-----X-------------------------------SS-------------------------------SSS----S-----S--------SSS---Q---------------------------X-------E?SSSSS----SSSS--S--
----------------------------------------------------------------------XXXX---------------------------------------------------------------------------------------------------------------------------------------------------------XXX--------------------------------------------------
---------------------------------------------------------------------XXXXX--------------------------------------------------------------------------------------------------------------------------------------------------------------------------------------------------------------
--------------------------------------------------------------------XXXXXX------------SSSSSSS-------------------XXXXX---------------------E-----------------------------------------------------------E-----------------------------------------------------XXXXX-----------------------
-------------------------------------------------------------------XXXXXXX----------------------S?S----------Q---------S?---SSS----------<>-SSSS---------------X--------------Q----QQ--QQ-----------SXXXX-------------XXXX----XXX------------XXXXXX----------------S?---SSS-------------
------------------------------------------------------------------XXXXXXXX---X-----<-----------------------------------------------------[]--------E---------XXXX------------------------------------------X---EXX----XX------------------------------------------------------------XXXX
-----------------------------------------------------------------XXXXXXXXX---X-----[-----------------------------------------------------[]-------<>--------XXXXX-----------------------------------------<>----------XX---------------------X------------------------------------------
--------------------------------------------------------EE-E----XXXXXXXXXX---X-----[--------------------------------------------------E--[]-------[]-------XXXXXX-----------------------------------------[]-------XX-XXX-------------------------------E-------------------------------
XXX-XXX-XXXX---------XXXXXXXXXXXXXXXXXXXXXXXXXXXXX---XXXXXXXXXXXXXXXXXXXXXXXXXXXXXXXX-XXXXXXXXXXXXXXXXX-XXXXXXXX------XX--------XXXXXXX--XX-XXXXXXXXXXXXXXXXXXXXXXXXXXXXXXXXXXXXX--XXXXXXXXXXXXXXXXXXXX--XXXXXXX----------------XXXXXX---XXXXX-----XXXX-X-XX-----XXXXXX-XXXXXXXXXXXX----
