----------------------------------------------------------------------------------------------------------------------------------------------------------------------------------------------------------------------------------------------------------------------------------------
----------------------------------------------------------------------------------------------------------------------------------------------------------------------------------------------------------------------------------------------------------------------------------------
----------------------------SSSSSSSSSSSS------------------------------------------------------------------------------------------------------------------------------------------------------------------------------------------------------------------------------------------------
----------------------------------------------------------------------------------------------------------------------------------------------------------------------------------------------------------------------------------------------------------------------------------------
---------------------------------------------------------XXXXXXXX-----------------------------------------------------------------------------------------------------------------------------------------------------------------------------------------------------------------------
-------------------------------------------------------------------------SSSS------------------------E-------------S----SSS-----------------------------------SS-------------------------------------SSS--SSSSS------------------XXX----------------------------------------------------
----------------------------------------------------------------------------------------------------XXXX---------------------------------------------------------------------------------XXXX---------------------------------------------------------------------------------XX--------
----------------------------------------------------------------------------------------------------------------------------------------------------------------------------------------------------------------------------------------------------------------------------------------
---------------------------------------------SSS---------------------------------------------------------------------------------------E------SXX---------------------E----------------------------E------------------------------------------------------------------------------------
--------------XXXXXX--------<--------QS-----------X----EXXXXX-------------XXXX---XX----------------------------S------S--SS-----------<>----------------SS-----------<>---------------------S------S------S----------------------------------------------S----------------------------SS
-------------------------------------E------------X---<>-----------EXX------------XX--------------------------------------------------[]-----------------------------[]--E--------------------------------------------------------------------------------------------------------------
----------------------------<]------------X-<>----X---[]-------X--------------------XXXX----------------------------------------------[]-----------------------------[]-XX--------------------------------------------------------------------------------------------------------------
---------------------E------[]-----------XX-[]----X---[]---------------X-----XX---------------------------------------------------E---[]-----------------------------[]-XX--------------------------------------------E-----------E--EEEE-E-E----------E-EE-----------------------------
X---X----XXXXXX---XXXXXXXXXXXXXXXXXXXXXXXXXXXX-XXXXXXXXX------------------XXXXXXXXX-XXXXXXXXXXXXX--X--------X-XXXXXXXXXXX--XXXXXXXXXXXXXXXXX---XXXXX------XXXXXXXXXXXXXX------XXXXX---XXXXXXXXXXXXXXXXXXXXXXXXXXXXXXXXXXXXXXXXXXXXXXXXXXXXXXXXXXXXXXXXXXXXXX-----XXXXX----XXX----XXXXXXX
