----------------------------------------------------------------------------------------------------------------------------------------------------------------------------------------------------------------------------------------------------------------------------------------
X---------------------------------------------------------------------------------------------------------------------------------------------------------------------------------------------------------------------------------------------------------------------------------------
----------------------------------------------------------------------------------------------------------------SSSSSSSSSSSSSSSSSSSSSSSSSSSS--------------------------------------------------------------------------------------------------------------------------------------------
----------------------------------------------------------------------------------------------------------------------------------------------------------------------------------------------------------------------------------------------------------------------------------------
--------------------------------------------------------------------------------------------------E-------------------------------------------------------------------------X-----------------------------------------------------------------------------------------------------------
X----------SS-------------------------------------------E----------------------------------------------------------------------------------------------------------SSSSS-----------------SSSS-----------------------------------------------------S-------------------------------------
-----------------------------------------------------------XXXXX-------------XXXXX--------X---------------------------------------------------------------------------------------------------------------------------------------------------------------------------------------------
---------------------------------------------------------------------------------------------------------------------------------S------------------------------------------------------------------------------------------------------------------------------------------------------
----------------E------E--------------------------------------------------------------------------------------------------E------SSS------------------------------------------------------------------------S------------------------------------------E--------SSSSS-------------------
-----E---------<>-----<>---E-------------------------SSSX------------XXXXXXSS-----------------------XX---------->>-S-----<>-----------X-----------Q---QQQ----------------XXXX--------------XXX-------------------------------QQ------E----------E-----<>---E-----------QQQQQ----------E-
----<>---------[]-----[]--<>------------------------------------------------------------------------------------[]-------[]-----------X----X-----------------------------------E---EXX----------------------------------------------<>---E-----<>-----[]--<>-------------------------<>-
----[]---------[]-----[]--[]---------------------------------------------------------XX-------------------------[]-------[]---X-<>-EXXX---XX-----------------------------------X---------------------------------------------------------------[]-----[]--[]-------------------------[]-
----[]---------[]-----[]--[]-------E-EE--------------------------------------E-------------------E---------E--E-S]----E--[]--E--[]----X--XXX------------------E------------------------X-----XX------------E-E----------------E-EE--E------E-E-[]-----[]--[]-------------------------[]-
--XXXXXXXXXX-X-XXXXXXXXXXXXX--XXXXXXXXXXXXXXXXX--XXXXXXX---------X--XXX---XXXXXXXXXXXX--XXX-X---XXX-----XXXXXXXXXXXXXXXXXXXXXXXXXXXXXXXXXXXXXXXXXXXXXXXXXXXXXXXXXXXXXXXXXXX--XXX-----------XXX---X--XXXXXXXXXXXXXXXXXXXXXXXXXXXXXXXXXXXXXXXX---XXXXXXXXXXXXXXXXXXXXXXXXXXXXXXXXXXXXXXXXX
