----------------------------------------------------------------------------------------------------------------------------------------------------------------------------------------------------------------------------------------------------------------------------------------
--------------------------------------------------------------------------------------------------------------------------------------------------------------------------------------------------------------------------------X-------------------------------------------------------
--------------------------------------------------------------------------------------------------------------------------------------------------------------------------------------------------------------------------------SSSSSSSSSSSSSSSSSSSSSSSSSSSS----------------------------
----------------------------XEEE--------------------S-----------------------------------------------------------------------------------------------------------------------------------------------------------------------------------------------------------------------------------
---------------------------->XXXXXXX-------------E--S-----------------------------------------------------------------------------------------------------------------------------------------------------------------------------------------------------------------------------------
----------------------------S------------S--------SSSS-----------------E--------------------------------------X-----------------------------SSSS---SSSS-------------------X--------------------------SSS---SS--------------SS-------------------S-S-------------------------------------
----------------------------------------------------------------------E-----------------------------------------------------------------------------------------------------------------------------------------------------------------------------------------------------------------
----------------------------------------------------------------------XXXXXX------------------------------------------------------------------------------------------------------------------------------------------------------------------------------------------------------------
---------------------------------------------------S----------------X---------------------------------------------------------------------------------------------------------------------------------------------------------------------------XSSS------------------------------------
-----E----------E----------EXXXXX-------------XXXX-----------------X--------------------------------------------------------X------------------S----S-----------------------------------------------SSSSS---S-------------------<>---E---E------X---------------------------X----------E
----<>---------<>---------<>-------X---EXXX---XX-------------------XXX-------E----------------------E-----------------------X---------------------------------X----E--------------------------------------------------XX--------[]--<>---E-----XX----XX--------------------XX------E--<>
----[]---------[]---------[]------<>----------XX-------------------S--------<>-----[---------------<>-----------------------X---------------------------------X---<>----------------X-------------------------------X-XX--------[]--[]------X-XXX----XX----X--------------XXX-----<>--[]
----[]---------[]---------[]------[]-------XX------------EE-EEE-EXXSS-EE----[]--EE-[---------------[]-----------------E-E---X--------EEEEE-E------------------X---[]--------------XXX------------EE-------------------X]--------[]--[]------XXXXX----X]----X-E-E---------XXXX-----[]--[]
XXXXXXXXXXXXXX-XXXXXXXXXXXXXXXX----XXXXX----------------XXXXXXXXXXXXXXXXXXXXXXXXXXXXXXXXXXXXXXXXXXXXXXXX-----XXXXXXXXXXXXXXXXXXXXXXXXXXXXXXXXXXXXXXXXXXXXXXXXXXXXXXXXXXXXXXXXXXXX-XXXXXXXXX--XXXXXXXXXXXXXXXXXXXXXXXXXXXXX--XXXXXXXXXXXXXXXX--XXX---XXXXXXXXXXXXXXXXXXXX-XXXXXXXXXXXXXXX
