----------------------------------------------------------------------------------------------------------------------------------------------------------------------------------------------------------------------------------------------------------------------------------------
----------------------------------------------------------------------------------------------------------------------------------------------------------------------------------------------------------------------------------------------------------------------------------------
----------------------------------------------------------------------------------------------------------------------------------------------------------------------------------------------------------------------------------------------------------------------------------------
---------------------------------------------------------------------------------------------------------------------------------------------------------------------------------------------------------------------------------------------------------------------E------------------
---------------------------------------------------------------------------------------------------------------------------------------------------------------------------------------------------------------------------------------------------------------------XXX----------------
----------------X--------------S-------------SSSSS------------------------------------------S--------SSS----------------------------------XX-----------------------------SSS---SS---------------------XXX---------------------XX-----------------------------------------QQ----------SXX
----------------X-----------------------------------------------------------------------------------------------------------------------------------------------------------------------------------------------------------------------------------------------------------------------
----------------X-----------------------------------------------------------------------------------------------------------------------------------------------------------------------------------------------------------------------------------------------------------------------
----------------XE------------XX------------------------------------------------------XX-------------------------------------------------------------------------------------------------------------------------------------------------------------------------SS---------------------
-E----------X--XX------------XXXX--------XX------X-------X-------------------------S---XX-------XXX----------XX----------------------S-SSS---------------------------------SS---S-----------------------------------------SS-----------------------------QQ------------E-QQQQ------SSS--
<>-------X--X-XXX----X--------------------------------XX-----------------------------------------------------XX----------------------------------E----------E----E-------------------------E--------------------------------------------------------------------------------------------
[]----------XXXXX----XX----X---------------------------------------------------------------------------------XX---------------------------------<>---------<>-----------------------------XX--------------------X----------------------------------------------------E------------------
[]-EE-------XXXXX----X-----X--------------------E-E------------E----------------------------------------E-E--XX---------------------------------[]---------[]-----------------------------X]--------------E-E---X--------EEE-----------E-----------------EE----------E--------E---------
XXXXXXXXXXXX---XX---XXXXXXXXX-----XX-------XXXXXXXXXXXX-XXXXXXXXXXXX--XXXXXX--XXXXXXXX----XXX------XXXXXXXXXXXXX---XXXXXXXXXXXXXXXXXXXXXXXXXXXXXXXXXXXXXXXXXXXXXXXXXXXXXXXXXXXXXXXXXXXXXXXXXXXXXXXXX---X-XXXXXXXXXXXXXXXXXXXXXXXXXXXXXXXXX---XXXXXXXXXXXXXXXXXXXXXXXXXXXXXXXXXXX---XXXXX
