----------------------------------------------------------------------------------------------------------------------------------------------------------------------------------------------------------------------------------------------------------------------------------------
----------------------------------------------------------------------------------------------------------------------------------------------------------------------------------------------------------------------------------------------------------------------------------------
---------------SSSSSS-------SSSSSSSSSSSSSSSSSSSSSSSSSSS---------------------------------------------------------------------------------------------------------------------------------------------------------------------------------------------------------------------------------
----------------------------------------------------------------------------------------------------------------------------------------------------------------------------------------------------------------------------------------------------------------------------------------
----------------------------------------------------------------------------------------------------------------------------------------------------------------------------------------------------------------------------------------------------------------------------------------
--------------------------------------------------------------SQQQQQ--------------------------------------------------------------E-----------------------------------------------------------------------------------X-------------------------------------------------S---------------
-----------------------------------------------------------------------------------------------------------------------------------------------------------------------------------------X---------------------------XX-----------------------------------------------------------------
-----------------------------------------------------------------------------------------------------------------------------------------------------------XXX-------------------------XXX--------------------------XXX-----------------------------------------------------------------
-----------------S--------------------------------------------------------------------------------------------------------------------------------------------------------------------XXXX----------SS-------------XXXX------------------------------------------E----------E-----------
--------Q--------------------S------SQS------X----------------SS--QQQ---------<>-----------------------------SQ---------------XXXX---------------------------------------------------XXXXX----------E------------XXXXXX------------------------------S----------<>---------<>----------E
-----------------X---------------------------X-X--X----X----------------------[]---------------------------------------------XXXXX---------------------X---------E------------------EXXXXX----------X------------XXXXXX-----------------------------------------[]---------[]---------<>
--------------XXXX--------------------------[X-X------XX----------------------[]-<------------------------------------------XXXXXX-------------------------X----<>-----------------XXXXXXX----------------------XXXXXXX-----------------------------------------[]---------[]----<>---[]
------E------XXXXX----------E-----E-------X-[X-X------XX-------------------E--[]-[---------E-EE---------------E-----------XXXXXXXX-----------EE-E---E-EEE-EE----[]-----E----------XXXXXXXX--------------------XXXXXXXXX---------------------EE-------E-E--------[]---------[]----[]---[]
XXXXXXXXXXXXXXXXXXXX--XXXXXXXXXXXXXXXXXXXXXXXXXXXXXXXXXXXXXXXXXXXXXXXXXXXXXXXXXXXXXXXXXXXXXXXXXXXXXXXXXXXXXXXXXXXXXXX----XXXXXX-------------XXXXXXXXXXXXXXXXXXXXXXXXXXXXXXXXX--XXXXXXXXXXXXXXX--XXXXXXXXXX--XXXXXXX--XXXXX--XXXX-----X--XXXXXXXXXXXXXXXXXXXX-XXXXXXXXXXXXXXXXXXX-XXXXXXX
