----------------------------------------------------------------------------------------------------------------------------------------------------------------------------------------------------------------------------------------------------------------------------------------
--------------------------------------------------------------------------------------------------------------------------------------------------------------------------------------------------------------------------------X-------------------------------------------------------
------------------------------------------------SSSSSSSS-----SSSSSSSSSSSSSSSSSSSSSSS------------------------------------------------------------------------------------------------------------------------------------------------------------------SSSSSS----------------------------
---------------------------------------------------------------------------------------------------------------------------------------------------------------------------------------------------------------------------------------------------------------------------X------------
---------------------------------------------------------------------------------------------------------------------------------------------------------------------------------------------------------------------------------------------------------------------------X------------
-----------------------------SSSSSSSSSS----S-------SSSS-SSS--------------------SS------SSSSSSS---------S--------------------------X-----------------Q-QQQQ------------------------------------------------------------X----X-----------------------------------------------X-S----------
---------------------------------------------------------------------------------------------------------------------------------XX----------------------------------------------------------------------------------XX---------------------------------------------------XX------------
---------------------------------------------------------------------------------------------------------------------------------XX---------------------------------------------------------------------------------XXX--------------------------------------------------XXX------------
--------------------------------------------------------------------------------------EE-------------------------S-------------XXXX--------------------------------------------------------------------------------XXXX-------------------E-----------------------------XXXX------------
-------------XXX---------------SSSSSSSS-----------------SSSS---------------------------?S--------XX----------------------------XXXX----------------S---SSSSS---------<>------E---E------E------------------------XXXXXX--------------E---<>-----E----------------------XXXXX------------
-------------XX--------------------------------E-------------------------X-X--------------------------------------------------XXXXX--------E-------------------------[]----------E-----<>------------------------XXXXXX-------------<>---[]----<>---E-----------------XXXXXX-----E-----<
-----------XXXX-------------------------------<>------------------------XXXXX------------------------------------------------XXXXXX-------<>-------------------------[]----------[-----[]-----------------------XXXXXXX-------------[]---[]----[]--<><>---XX---------XXXXXXX----<>-----[
----------XXXX--------------------------------[]--------------E--------XXXXX-------------------------------------------------XXXXXX-------[]-------------------E-----[]-----E----------[]---------------------XXXXXXXXX-------------[]---[]E---[]--[][]---XX-E-EE---XXXXXXXX----[]-----[
XXXXXXX-XXXXXX--------------XXXXXXXXXXXXXXXXXXXXXXXXXXXXXXXXXXXXXXXXXXXXXXXX-----XXXXXXX-XXXXXXXX--XXXXXXXXXXXX-XXXXXXXXXXXXXXX-------XX--X-XXXXXXXXX---XXXXXXX-XXX-XXXXXXXXXXXXXXXXXXXXXXXX--XXXXXXXXXXX---XXXXXXXXXXXXX---XXXXXXXXXXXXXXXXXXXXXXXXXXXXXXXXXXXXXXXXXXXXXXXXXXXX-XXXX-XX
