----------------------------------------------------------------------------------------------------------------------------------------------------------------------------------------------------------------------------------------------------------------------------------------
----------------------------------------------------------------------------------------------------------------------------------------------------------------------------------------------------------------------------------------------------------------------------------------
---SSSSSSSSSSSSS--------------SSSSSSSSSS--------------------------------------------------------------------------------------------------------------------------------SSSSSSSSSSSSSSSSSSSSSSSSSSSS------------------------------------------------------------------------------------
--SSSSSSSS--------------------S---SSSSS-------------------------------------------------------------------------------------------------------------------------------------------------------------------------------------------------------------------------------------------------
---SSSSSSS-------------------------SSSS-------------------------------------------------------------------------------------------------------------------------------------------------------------------------------------------------------------------------------------------------
SSSSSSSSSSS--SSS-------------SSSSSSSSSS---SS------------X-------QQSSSSS-------------X---S??-E?-------SSS--------------SQQQQQ-------------------------------------------X------------------------------------------------------------------------------------------------EQ?-------------
----------------------------------------------------------------------------------------------------------------------------------------------------------------------------------------------------------------------------------------------------------------------------------------
--------------------------------------------------------E-------------------------------------------------------------------------------------------------------------------------------------------------------------------------------------------------------------------------------
---E-----------------------------------------------E----XXX-------------------------X-XX-------------------------------------------------------------------------------------------------------------------------------------------------------X----------------SSSSS-------------------
-SSSSSSSS----------E--<>-------SSSSSSSS--------E--<>-----------S?S-SSSSS---------X--------------XXX----------<>-------Q---QQQQ-------------------------------------S----SSSS----SQS--------------------------------X----------------------------------------------------S?S---------S?SS
----SSSSSS--------<>--[]------E-----SS--------<>--[]-----------------------------XXX-------------------------[]------------------------E--------------E----------------------------------X-XX------------------------------------------------XXX------------------E---------------------
---SSSSSS-------X-[]--[]------SS-----S--------[]--[]-----------------------------XX--------------------------X]-----------------------<>-X----------------------------------------------<>-XX--------------------XXX-----------------------XXXXX----------------------------------------
------SSS-------X-[]--[]-------------S--------[]--[]-----------------------EE----XX---------------------XXX--XX--------------------EE-[]-[-----------EE-----------------E-----E-------X-[]-XX------------------EEXXX----------------------XXXXXX--------E--E-------E-E------------------
XXXXXXXXXXXXXXXXXXX--XXXXXXXXXXXXXXXXXXXXXXXXXXXXXXXXXXX--XXXXXXX---XXXXXXXXXXXXXXX-X-----XX-----------------XX-XXXXXXXXXXXXXXXXXXXXXXXXXXXXXXXXXXXXXXXXXXXXXXX-----XXXXXXXXXXXXXXXXXXXXXXXX---XXXXXXXXXX--XXXXXXXXXXXXX--------XXXXXXXXXXXXXXXXXXXXXXXXXXXXXXXXXXXXXXXXXXXXXXXXXXXXXXXX
