----------------------------------------------------------------------------------------------------------------------------------------------------------------------------------------------------------------------------------------------------------------------------------------
----------------------------------------------------------------------------------------------------------------------------------------------------------------------------------------------------------------------------------------------------------------------------------------
------------------------------------------------------------------------------------SSSSSSSSSSSSSSSSSSSSSSSSSS------------------------------SSSSSSSSSSSSSSSSSSSSSSSSSSSS----------------------------------------------------------------------------------------------------------------
-----------------------------------------------------------------------X----------------------------------------------------------------------------------------------------------------------------------------------------------------------------------------------------------------
-----------------------------------------------------------------------X----------------------------------------------------------------------------------------------------------------------------------------------------------------------------------------------------------------
-----X-----------------------------------------------------------------XXS--------------------------------------------------------------X---------------------------------------------------------X-------------------------------------------------------XX----------SSSS--------------
----------------------------------------------------------------------XXX---------------------------------------------------------------------------------------------------------------------------------------------------------------------------------------------------------------
---------------------------------------------------------------------XXXXX--------------------------------------------------------------------------------------------------------------------------------------------------------------------------------------------------------------
--------------------------------------------------------------------XXXXXX---------------------------SSS-----------------------------------------------------------------------------------------------------------------------------------------------------XSSS-----------------------
-------------------------------------------------------------------XXXXXX----------E--------QQS------X----X--------------------X------------SSSS----S-S------X--X-------------------X------------------------------------------------------------------SS--------------SSSS----------<--
------------X--------------------------------X--------------------XXXXXXX----X----<>-----------------X-X--X----X---------------------------------------------X-XX------------------XXX----------------------------------------------------E-----E------------------------------------E]-
------------X------------------------------XXXX------------------XXXXXXXX----X----[]--------------XX[]-X--X---XX--------------------------------------------[X-XX------------------XXX---------------------------------------------------->------------------------------------------X--
--------E---X--------EE-EE-E--------------XXXXX---------EE-EE---XXXXXXXXX----X----[]E-----E------XX-[X-X--X--XXX------------E---------------E-----E-------XX[]-XX---------------EXXXXX-E------E-E----------------------------------------[]---------------------------------------------
XXXXXXXXXXXXXXXXXXXXXXXXXXXXXXXXXXXXXXXXXXXXXXXXX-XXXXXXXXXXXXXXXXXX--XXX--XXXXXXXXXXXXXXXXXXXXXXXXXXX-XX-XXXXXXXXXXXX--XXXXXX----------X-XXXXXXXXXXXXXXXXXXXXXXXXXXXXXXXXXXXXXXXXXXXXXXXXXXXXXXXXXXXXXXXXXXXXXXXXXXXX----XXXXXXXXXXXXXXXXXXXXXXXXXXXXXXXXXX---XXXXXXX--XXXXXXXXXXXXXXX-
