----------------------------------------------------------------------------------------------------------------------------------------------------------------------------------------------------------------------------------------------------------------------------------------
----------------------------------------------------------------------------------------------------------------------------------------------------------------------------------------------------------------------------------------------------------------------------------------
----------------------------------------------------------------------------------------------------------------------------------------------------------------------------------------------------------------------------------------------------------------------------------------
---------------------------------------------------------------------------------------------------X------------------------------------------------------------------------------------------------------------------------------------------------------------------------------------
---------------------------------------------------------------------------------------------------X------------------------------------------------------------------------------------------------------------------------------------------------------------------------------------
----------------------------------------SSS--------------XXXXX-------------------------------------X------------------------SSS----XXXXXSS----X-----------------------------------------------SSS----------------------------------SS--SSS-----S----SSSSSSSS----------------------------
--------------------------------------------------------------------------------------------------XX------------------------------------------------------------------------------------------------------------------------------------------------------------------------------------
--------------------------------------------------------------------------------------------------XX------------------------------------------------------------------------------------------------------------------------------------------------------------------------------------
-----E----------E------------XXXXX---------------------X----------------------------------------X-XX---------------XXX-------------------------------------------------------------------------------------------------------------E-----------------------------E----------E-----------
----<>---------<>-----------------------SS--------------------------X--------------------------XX-XX-----------E------------XX---------------------------------------S--QQQ---------------XXX----------------------X--------------SSS---------------------------<>---------<>-----------
----[]---------[]-----------------------------------XEX-------------X-------------------------XXXXXX-----E----<>----------------------------------------------------------------------XXXXXXX----------------------XX-------------------------------------------[]---------[]-----------
----[]---------[]---------------------------------------------------X-------------------------XXXXXX----<>----[]---------------------------------------------------------------------------X-----------------------XX-----------------------------X-------------[]---------[]-----------
----[]---------[]--------------------------------------------EE-E---X--------E-E-E---E-EE---XXXXXXXX----[]----[]------------------------------E--E-EE-E------------E-EE--------------------X-------------------E--XXX-----------------------------X-------------[]---------[]-E---------
XXXXXXXXXXXXXXXXXXXX---XXXXX---XXXXXX---XXXXXXXXXXXXX---XXXXXXXXXXXXXXXXX---XXXXXXXXXXXXXXXXXXXXXXXXXXXXXXXXXXXXXXX-XXXXXXX---XXXXXXXXXX----XXXXXXXXXXXXXXXXXXXXXXXXXXXXXXXX---XXXXXXXXXXXXXXXX-XXXXXXXX---XXXXXXXXXXXXX-----XXXXXXXXXXXXXXXXXXXXXXXXXXXXXXXXXXXXXXXXXXXXXXXXXXXX--XXXXX
