----------------------------------------------------------------------------------------------------------------------------------------------------------------------------------------------------X-----------------------------------------------------------------------------------
-------------------------------------------------------S----------------------------------------------------------------------------------------------------------------------------------------------------------------SS-----S--------------------------------------------------------
----------------------------SSSSSSSSSSSSSSSSSS--SS----SS----------------------------------------------------------------------------------------------------------------------------------------------SSSSSSSSSSSSSS----SSS---SS----------------------------SSSSSSSSSSSSSSSSSSSSSSSSSSSS
---------E--------------------SSSSSSSSSSSSSS----SS----SS----------------------------------------------------------------------------------------------------------------------------------------------SSSSSSSSSSSSSS----SS-S-SSS--------------------------------------------------------
----------------------------S-SSSSSSSSSSSSSS----SS----SS-------------------------------------XXX----------------------------------------------------------------------------------------------------]--SSSSSSSSSSSSS----SSS-SSSS--------------------------------------------------------
-------------Q--------------SSSSSSSSSSS--SSS----S------S-----------------------------------------------------------------------X----------------------------SSS-------------------------------------?SSSSSSSSSSSSSSS----SS----SS--------------------------------------------------------
-------------------------------------------------------------------------------------------------------------------------------X--------------------------------E-----------------------------------EE-S--------------------------------------------------------------------------------
-------S----------------------------------------------------------------------------------------------------------------------XX---------------------------------E----------------------------------------------------------------------------------------------------------------------
--SSSSSSS-----------------------E------------------E-------------------------------------E----------E------------------------XXX-----------------E----------E----------------E----------E---------------E------------------E------------------------------------------E------SSS--------
------------S?SS----------E---SSSSSSSSS--------E--<>------------------------------Q-----<>---------<>----------E------------XXXX-------------E--<>---------<>----------E----<>---------<>--------------?SSSSSSSS-------E--<>-X--------------X---------------<>-------<>-----------X-----
-------------------------<>---SSSSSSSS--------<>--[]------------------------------------[]---------[]---------<>----------XXXXXX----------------[]---------[]----X----<>----[]---------[]---------E---E--S----------------[]---------------XXX--------------[]-------[]-----------X-----
-------------------------[]--SSSSSSSSSS-------[]--[]------------------------------------[]---E-----[]---------[]---------XXXXXXX----------------[]---------[]---<>----[]----[]---------[]--------->---SSSS------------<]--[]---------------XXX--------------[]-------[]---X-<>-EXXX-----
---------E---------E-----[]----SSS-SSS--------[]--[]------------------------------------[]---E-----[]---------[]--------XXXXXXXX--------E--E[E--[]-----E-E-[]---[]----[]----[]---------[]---------]-------------------[]E-[]------------EX--XX-------EE-EE-E[]-------[]--XX-[]---XX-----
XXXXXXXXX---XXXXXXXXXXXXXXXXXXXXXXXXXXXXXXXXXXXXXXXXXXXXXXXXXXXXXXXX--XXX-----XXXXXXXXXXXXXXXXXXXXXXXXXX-XXXXXXXXXXXXXXXXXXXXXXXXXXXXXXXXXXXXXXXXXXXXXXX---XX---XXXXXXXXXXXXXXXXXXXXXXXXXXXX--XXXXXXXXXXXXXXXXXXXXXXXXXXXXXXXXXXXXXXXXXXXXXXXXXXXXXXXXXXXXXXXXXXXXXXXXXXXXXXXXXXX-XXXXXX
