----------------------------------------------------------------------------------------------------------------------------------------------------------------------------------------------------------------------------------------------------------------------------------------
-------------------------------------------E----S------S--------------------------------------------------------------------------------------------------------------------------------------------------------------------------------------------------------------------------------
------------------------------------------<>----SS-----S--------------------------------------------------------SSSSSSSSSSSSSSSSSSSSSSSSSSSS--------------------------------------------------------------------------------------------------------------------------------------------
------------------------------------------[]----SS---SSS-------------------------------------------X------------------------------------------------------------------------------------------------------------------------------------------------------------------------------------
-------------------------------EE---------[]----SS---SSS-------------------------------------------X------------------------------------------------------------------------------------------------------------------------------------------------------------------------------------
------------------------XXXX?--SSSSSSSS---SS---SSSS----S-------------------------------------------X-------------S---------------------------------QQ-QQ----------------S---------------------SSS---------------------------------------------------------------------------------SSSS--
--------------------------------------------------------------------------------------------------XX------------------------------------------------------------------------------------------------------------------------------------------------------------------------------------
-------------------------------------------------------------------------XX----------------------XXX------------------------------------------------------------------------------------------------------------------------------------------------------------------------------------
----------------------------X-EE----------------------------------------XXX---------------------XXXX----------------------E------------------------------------------------------------------------------------------------E------------------------------------------------------------
-----------------------S-------?SSSSS----EE----------XXX----------------XX---------------------XXXXX---------------S-----<>-----------------------Q---QQQQQQ-Q--------E-QQQQ--------------XX-------------Q----------E-----<>---E----------------------------QQQQ--------------EX-X------
----------------E-------------------------------------XX---------------XXX--------------------XXXXXX-----E-----<--E------[]---------E--------------------------------<>---------------XXXXXX-----------------------<>-----[]--<>--------------------------E--------------XXXXXXX--------
---------------<>----------------X----------X------------------------XXXXXX------------------XXXXXXX----<>-----[-S-------[]--------<>--------------------------------[]--------------------------------------------[]-----[]--[]-------------------------<>-----------------------------
----E-----E----[]-------------------------------XXX--------E---------XXXXXX----------E-EE---XXXXXXXX----[]--E--[---------[]--------[]--------------------------------[]----------------X----------------E----------[]-----[]--[]-------------------------[]-----------------------------
XXXXXXXXXXXXXXXXXXXXXXX-XXXXXXX--XXXXXX-----------------XXXXXXXXXXXXXXXXXXXXX--XXXXXXXXXXXXXXXXXXXXXXXXXXXXXXXXXXXXXXXXXXXXXXXXXXXXXX--XXXXXXXXXXXXXXXXXXXXXXX-------XXXXXXXXXXXXXXXX--X-X-------XXXXXXXXXXXXXXXXXXXXXXXXXXXXXXXXXXXXXXXXXXXXXXXXX-XXXXXXXXXXXXXXX--XXXXX--XXXXXXXX--XXX
