----------------------------------------------------------------------------------------------------------------------------------------------------------------------------------------------------------------------------------------------------------------------------------------
----------------------------------------------------------------------------------------------------------------------------------------------------------------------------------------------------------------------------------------------------------------------------------------
------------------------------------------------------------------------------------------SS--------------------------------------------------------------------------------------------------------------------------------------------------------------------------------------------
------------------------------------------------------------------------------------------SSSSSSS---------------XE----------------------------------------------------------------------------------------------------------------------------------------------------------------------
-------------------------------------------------------------------------------------------SSSSSS----------------XXXXXXX----------------------------------------------------------------------------------------------------------------------------------------------------------------
-----------------------------SS-----------------------------------QQQ------------------SSSSSSSSSS--S------------S---------------------SSSS----SSSSSSSS----SS-----------S--------------------------------------------------SSSS----------------------------------------------------------
----------------------------------------------------------------------------------------------------------------------------------------------------------------------------------------XX----------------------------------------------------------------------------------------------
-------------X--------------------------------------------------------------------------------S-----------------------------------------------------------------------------------------------------------------------------------------------------------------------------------------
-------------X----------------------------------------------------------E---------------E-----S------------E-----------------------------------E----------------------------------------------------------------------------------------------------------------------------------------
----------------------SSSSS----S----S------------------------>----??---<>-------------E--SSSSSSS----------<>----XQQQ-------------XEXXX---------SSSSSS-----------------------------------------SSSSSSQQQQ--------------XXXX------------------XX------------------------------X-----------
----------E------------------------------------E------------[]---------[]------E------E-------------------[]---------------E-XXXXXXXX----------------------------------------------------------------------E-----XXX-XXXX------------------XXX-----------------------------XX----------E
---------<>---------------------------------<X-X------------[]---------[]-----<>-----SS--X------------<---[]----------X>-----------XX-------------------------X>--------XXXX------------------------------<>---------XXXX-----------------XXXX----------------------------XXX---------<>
--E--E-EE[]------------E-E--------E---------[]-X------------[]---------[]--E--[]-----[]------E--------E]--[]----------[]-----------X--------------------------[-E-E-------------E---EE-------E-E----------[]-------XXXXX----------------XXXXXX-E------E-E----E-E-------E-XXXX---------[]
XXXXXXXXXXXXXXXXXXXXXXXXXXXXXXXXXXXXXXXXXXXXXXXXXXXXXXXX-XXXXXXXXXXXXXXXXXXXXXXXXXXXXXXXXXXXXXXXXXXXXXXXXXXXXXXXXXX--X--XXXXXXXXXXXXXXXXXXXXXXXXXXXXXXXXXXXXXXXXXXXXXXXXXXX-XXXXXXXXXXXXXXXXXXXXXXXXXXXXXXXXXXXXX--XXXXXXX----XXXXXXXXXXXXXXXXXXXXXXXXXXXXXXXXXXXXXXXXXXXXXXXXXXXXXXXXXX
