----------------------------------------------------------------------------------------------------------------------------------------------------------------------------------------------------------------------------------------------------------------------------------------
---------------------------------------------------------------------------------------------------E------------------------------------------------------------------------------------------------------------------------------------------------------------------------------------
--------------------------------------------------------------------------------------------------<>------------------------------------------------------------------------------------------------------------------------------------------------------------------------------------
---------------------------------------------------------------------------------------E----------[]-----S---S-S-----------------------------------------------------------------------X------------------------------------------------------------------------------------------------
-------------------------------------------------------------------------------------XXXXXXXX-----[]-----E---S-------------------------------------------------------------------------X------------------------------------------------------------------------------------------------
------------------------------------------------------------SSSSSSSSS--------------S?--SS??----------??SSSS-SS-------------------------------------------------------------------------X---------------------------------------------------SS-------------------------------------------
--------------------------------------------------------------------------------------------------------------------------------------------------------------------------------------XX------------------------------------------------------------------------------------------------
--------------------------------------------------------X------------------------------E---------------------------------------------------------------------------------------------XXX------------------------------------------------------------------------------------------------
------------------------------------------------------------------------------------X-XX--------------------------------------------------------------------------------------------XXXX------------------------------------------------------------------------------------------------
---------------XXX-------------------------X------------------SSSSSSQQ---------------XXXXS-------XX----XXX---XXX--------SQS------------------------------------------SS------------XXXXX-----------------------------------SSSSS-----QQ--E?-----E---------------------------------------
-------------------------------------------------------------------------------E----------SX---EXX------------XX-------------------E----------------------------------------------XXXXXX-----E-----<------E------------------------------------<>------E--------------------------------
------------------------------------------------------------------------------<>-X-------SSX--------X---------------------------<>-X------XX-------------------------------------XXXXXXX----<>-----[---------------------------------X---------[]-----[]--------------------------------
------------E--------E-E---------------------------------------------------EE-[]-X------------------X---X-X-----------E---------[]-------XXX-------EE--------------------E-EE-E-XXXXXXXX----[]--E--[-------E-EE--------------------------------[]-----[]--------------------------------
XXXXXX--XXXXXX-----XXXXXXXXXXXXX----XXXXX-X------X----XXXXXXXXXXXXXXXXXXXXXXXXXXXXXX-------XXXX-----XXXXXXXXXXX-XXXXXXXXXXXXXXXXXXXXXXXXXXXXXXXXXXXXXXXXXXXXXXXXXXXXXXXXXXXXXXXXXXXXXXXXXXXXXXXXXXXXXXXXXXXXXXXXXXXXXXXXXXXXXXXX-XXXXXXXXXXXXXXXXXXXXXXXXXXX---X-------XXXXXXXXXXXXXXXXX
