----------------------------------------------------------------------------------------------------------------------------------------------------------------------------------------------------------------------------------------------------------------------------------------
--------------------------------------------------------------------------------------------------------S-S----S--------------------------------------------------------S---------------------------------------------------------------------------------------------------------------
--------------------------------------------------------------------------------------SSSSSSSSSSSSSSSS--SSSSSSSS--------------------------------------------------------SSSSSSSSSSSSSSSSSSSSSSSSSSSS-------------------------------SSSSSS-----------------------------------------------
--------------------------------------------------------------------------------------SSSSSSSSSSSSSS----SSSSSSSS-------------------------------------------------------------------------------------------------------------------SSSSSSSSS--------S------S----------------------------
------------------------------------X-----------------------------------------------]-SSSSSSSSSSSSSS----SSSSSSSS-------------------------------------------------------------------------------------------------------------------SSSSSSS-----------S----SS----------------------------
X---SSSSSSSSSS---------------------------S----XXXXX--S-------------------------XX---?SSSSSSSSSS--SSS----SS--SSSS-------------------------------------------------------------------------------------------------------------------SSSSSSSSSSSSS-----------S----------------------------
--------------------------------------------------------------------------------------------------------------------------------------------------------------------------------------------------------------------XX-----------E------------------------------------------------------
X----------------------------------------------------------------------------------------------------------------------------------------------------------------------->----------------S---------------------------------------------------------------------------------XXX----------
X------------------------------XXXX-----------------------------------------------------E-------------------------------------------------------------------------------E---------E------SSS----------------------------------------E--------------------------------------XXX----------
------SSSS-S?SS----------<>-------------XX--------------X--------------EXXEX----------S?SSSSSSS--------E-----XXX----------------------SSSSSS----------------E----------->>-S-----<>----------------X-------------------------SSS---?SSSSSS------------<>------------------XXXX----------
-------------------------[]-------------------------------------------EXXXXX----------S-SSSSS---------<>------------------E--------------------------------<>-----------S]-S-----[]---------?-X----X------------------------------E-------------------[]-----------------XXXXX----------
-------------------------[]-----------------------------------------------------------SSSSSSS---------[]-----------------<>--------------------------------[]-----------SS-S-----[]-----E--EXXX---XX-XX------------------------------X----------------[]----------------XXXXXX----------
-------------------EE-E--[]------------------------------------------------------------------E--------[]E--------------E-[]------------E-------------------[]-E---------S]-------[]--E-----[XXX--XXX-----E-EE--------------E-EE---------------------E-[]-X------------XXXXXXXX----------
--XXXXXXXXXXXXXXXXXXXXXXXXXX-----------------XXXXXXX----XXXXXX---XXXXXX----XXXXXXXXXXXXXXXXXXXXXXXXXXXXXXXXXXXXXXXXXXXXXXXXXXXXXXXXXXXXXXXXXXXXXXXXXXXXXXXXXXXXXXXXXXXXXXXXXXXXXXXXXXXXXXXXXXXXXXXXXXXXXXXXXXXXXXXXXXXXXXXXXXXXXXXXXXXXXXXXXXX-XXXXXXXXXXXXXXXXXXXXXXXXXXXXXXXXX---XXXXX
