----------------------------------------------------------------------------------------------------------------------------------------------------------------------------------------------------------------------------------------------------------------------------------------
----------------------------------------------------------------------------------------------------------------------------------------------------------------------------------------------------------------------------------------------------------------------------------------
---------------------------------------------------------------------------------------------------------------------------------------------------------------------------------------------------------------------------------------SSSSSSSSSSSSSSSSSSSSSSSSSSSSSSSSSSSSSSSSSSSSSSSSS
----------------------------------------------------------------------------------------------------------------------------------------------------------------------------------------------------------------------------------------------------------------------------------------
----------------------------------------------------------------------------------------------------------------------------------------------------------------------------------------------------------------------------------------------------------------------------------------
-----------------------XXXX-X-------S?SS---------------------------------------------------QQ-QQQQQ------------------------------------SS-------------------------XXXX--------SQQQQQQ-----------SSSS------------------------XXX--S------------------------------------------------------
----------------------------------------------------------------------------------------------------------------------------------------------------------------------------------------------------------------------------------------------------------------------------------------
------------------------------------------------------------------------------------E------S---------------------------------------------------------------------------------------------------------------------------------------------------------------------------------S----------
----------------------------X-X------------------------------------------------------------S------------------E--------------------------------------------------------------------------------------------------------------------------------------------------------------S-S--------
--------------XXXX-----------------S?---SSS----------X----------------------------------------QQQQQQ-Q-------<>-----------------------------X---------------XXXX----------E--SSS-SSSQ------------------------------X------------SS--------------------------SSSS----S-S------X-XX-X----X
-----------------------------------------------------XX-------------X----------------------------------------[]----------------XXXX-----------------------XXX------------<>----------------------------------------XX----------------------------X-X--------[----------------X-XX-X----X
-----------------------------------------------------XX-------------X----------------------------------------[]----------------X--X--------------------------------------[]----------------------------------------XX--------------------------XXXXX--------]--------------X[]-XX-X----X
-----------------------------------------------EE-E--X--------------X--------EEE-----------------------EE----[]----------------X--X--------------------------------------[]---------------EE-----------------------XX-----------------E-------XXXX-X--------]-----E-------X-[]-XX------X
XXXXXX--XXXXXXXXXXXXXXX-XXXXXXXXXXXXXX-XXXXXXXXXXXXXXXX-X-XXXXXXXXXXXXXXXXXXXXXXXXXXXXXXXXXXXXXXXXXXXXXXXXXXXXXXXXXXX--XXXXXXXXXXX-X-----XXX---------XXXX-------------XXXXXXXXXXXXXXXXXXXXXXXXXXXXXXXXXXX--XXXXXXXXXXXXXX----XXXXXXXXXXXXXXXXXXXXXXX---XXXXXXXXXXXXXXXXXXXXXXXXXXXXXXXXX
