----------------------------------------------------------------------------------------------------------------------------------------------------------------------------------------------------------------------------------------------------------------------------------------
----------------------------X-----------------------------------------------------------------------------------------------------------------------------------------------------------------------------------------------------------------------------------------------------------
----------------------------SSSSSSSSSSSSSSSSSSSSSSSSSSSS--------------------------------------------------------------------------------------------------------------------------------------------------------------------------------------------------------------------------------
---------------------------------------------------------------------------------------------------X------------------------------------------------------------------------------------------------------------------------------------------------------------------------------------
---------------------------------------------------------------------------------------------------X------------------------------------------------------------------------------------------------------------------------------------------------------------------------------------
S-SSSSSSSS----SS----SS-----S--------------------------------SS--SSSS-------------------------------X-------------------------S--------------------------EQQ-------------------------------------------------------------------------------------------------S-SSSSSSSSSS--SS-----------S
--------------------------------------------------------------------------------------------------XX------------------------------------------------------------------------------------------------------------------------------------------------------------------------------------
-------------------------------------------------------------------------------------------------XXX----------------------------------------------------------------------------------XXXXXX---------------------------------------------------X----------------------------------------
--EE----------------------------------E---------------------------------------------------------XXXX-------------XSSSS--------------------E---SSSSSSS------------------------------------------------------------------------------------------X----------------------------------------
---?SSSSS-----E-----------X------S---[]----------------X-------SS---SS-------------------------XXXXX------------------------SS-----------Q-------------SS?SS---------Q-----------------------------------E----------E------------------------------------------?SSSSSS------------------
-----------------------------<>------[]---------E------X-------------------------[]-----------XXXXXX-----E-----<-------------------------E---------------------------------------------------E----------<>---------<>---E----------------------X----------------------------------------
----------------------------S[]------[]--------<>------X-------------------------XX----------XXXXXXX-----X-----[-----------------------------------------------------------------------X----<>-----[----[]---------[]--<>----------------------X----------------------------------<--XX-
--------------------E-E-----S[]------[]--------[]------X-------------------------XX--E-E----XXXXXXXX-----X--E--[-------------------------------------E-------------------EE-EE----EE--EE----[]-----[----[]---------[]--[]--------E--------EE--EX--------------------------------E-E--XX-
XXXXXXXXXXXXX---XXXXXXX--XX-XXXXXXXXXXXXXXXXXXXXXXXXXXXXXXXXXXXXX--XX---XXXXXXXXXXXXXXXXXXXXXXXXXXXXXXXXXXXXXXXX----XXXX------XXXXXXXXXXXX--XXXXXXXXXXXXXXXXXXXXX--XXX--XXXXXXXXXXXXXXXXXXXXXXXXXXXX-XXXXXXXXXXXXXXXXXXXXX-XXXXXXXXXXXXXXXXXXXXXXXXXXXXXXXXXXXXXXXXXXXXXXX--XXX------XX-
