----------------------------------------------------------------------------------------------------------------------------------------------------------------------------------------------------------------------------------------------------------------------------------------
---------------------------------------------------------------------------------------------------E----S-------------------------------------------------------------------------------------------------------------------------------------------------------------------------------
--------------------------------------------------------------------------------------------------<>----SS------------------------------------------------------------------------------------------SSSSSSSSSSSSSSSSSSSSS---------------------------------------------------------------
--------------------------------------------------------------------------------------------------[]-----------S------------------------------------------------------------------------------------------------------------------------------------------------------------------------
--------------------------------------------------------------------------------------------------[]-----E------------------------------------------------------------------------------------------------------------------------------------------------------------------------------
--------E--------SSSSSS--S--------------XX--------XXXXX----------------------------XX---SSSSSSSSSSSS----SSS-SSSSSS----------------------------------SS--------SS--------------------------------XXXX----------------XXX----------------------------------------------------E----------X-
------------------------------------------------------------------------------------X-------------------------------------------------------------------------------------------------------------------------------XXX-----------------------------------------------------------------
------------------------------------------------------------------------------------X-------------------------------------------------------------------------------------------------------------------------------XXX-----------------------------------------------------------------
--XX--------------------------------------------------------------------------------X--------------------------------------------------E------XX-------------------------------------------------------------------XXXX-----------------------------------------------------------------
--XXX-------XXX------X-----------------------SSSSS--------------------------SSSSSSSS-----SSSSS-S?SS----------X--SSSQ--------------XX--<>----------------XXX------------------------------------SS-----------Q-XX----XXXX--X------------------------------SS-------------XX--------------
--------------------------XX--X-----------------------------------------------------------------------------X-XX-------E---------XXX--[]----------------------------XXXX----------------------------<>----------EXX-XXX---X----E---------------------------------------XXX--------------
----------------------------------------------------------------------------------------------------------------------<>--------XXXX--[]------------------------------------------------------------]]--------X-XXXXXXX---X---XX--------------------------------------XXXX--------------
--------------------E---------X--------------------------------EE------------E-E-----------------------EE-E-----------[]-------XXXXX--[]------------------------E-E---------------E-----------------]]-E--------XXXXXXX---X---XX-------EE-----------------E-------E-XXXXXX-------EE-EE-E
XXXXXXXXXX-XXXXXXXXXXXXXXX--XXX----XXXXX--XXXXXXXXXX--XXXXXXXXXXXXXXXXXXXXXXXXXXXXXXXXXXXXXXXXXXXXXXXXXXXXXX-X--XXXXXXXX--XXXX-XXXX-XXXXXXXX------XXX-------XXXXXXXXXX--X-XXXXXXXXXXXXXXXXXXXXXXXXXXXXXXXXXXXXXXXXXXXX----XXX-XXXXXXXXXXXXXXXXXXXXXXXXXXXXXXXXXXXXXXXXXXXXXXXXXXXXXXXXXX
