----------------------------------------------------------------------------------------------------------------------------------------------------------------------------------------------------------------------------------------------------------------------------------------
----------------------------------------------------------------------------------------------------------------------------------------------------------------------------------------------------------------------------------------------------------------------------------------
----------------------------------------------------------------------------------------------------------------------------------------------------------------------------------------------------------------------------------------------------------------------------------------
----------------------------------------------------------------------------------------------------------------------------------------------------------------------------------------------------------------------------------------------------------------------------------------
----------------------------------------------------------------------------------------------------------------------------------------------------------------------------------------------------------------------------------------------------------------------------------------
-------------------------------------------------------------------X-----XXXX----------------------------------------------------------XXXXX----------------XX------------SS---SSS---------------------------------X------------SSSS---SS--------------------------------------S--------
----------------------------------X------------------------------------------------------------------------------------------------------------------------XXX----------------------------------------------------XX--------------------------------------------------------------------
-----------------------------------------------------------------------------------------------------------------------------------------------------------XXX----------------------------------------------------XX--------------------------------------------------------------------
---------------------------------------------------------------------------------------------------------------------------------------------------------XXXXX---------------------------------E-----------------XXX--------------------------------------------------------------------
-------------------------QQ---------------XXXXXX---------XXX-------------SSSSS------------------------------S---------------------X-------------------XX-XXXXX------------SSS-----------------<>----------------XXXX------------SSSS--------------------------XXX-----------------------
----------------------------------------------------------XX------------------------------------------------------------------------------------------X-EXXXXX----------------------------X---[]--------------XXXXXX------------------------------XX------------------------------------
-----------------------------------------------------------------------------------------------------------------------------------------------------XXXXXXXXX----------------------------X---[]-------------XXXXXXX----------------------------XXXX------------------------------------
XX-----E-E----------------E-------------------------------XX-------------------------------E------------------------------------------------EE-E------XXXXXXXX----------------------------X---[]------------XXXXXXXX--------E--E------E--------XXXXX-------X----------------------------
XXXXXXXXXXXXXXXXXX-----XXXXXXXXXXXX-----XXX---XXXXXXXXXX--------------XXXXXXXXXXXXXX---XXXXXXX--XXXXXXXXXXXXXX-XX--XXXXXX--XXXXXXXXXXXXXXXXXXXXXXXXXXXXXXXXXXXXXX--XXXXXXXXXXXXXXXXXXXXXXXXXXXXXXXXXXXXXXXXXXXXXXXXXXXXXXXXXXXXXXXXXXXXXXXXXXXXXXXXXXXXXXXXXXXXXXXXXXXXXX--XXXXXXXXXXXXX
