----------------------------------------------------------------------------------------------------------------------------------------------------------------------------------------------------------------------------------------------------------------------------------------
----------------------------------------------------------------------------------------------------------------------------------------------------------------------------------------------------------------------------------------------------------------------------------------
----------------------------------------------------------------------------------------------------------------------------------------------------------------------------------------------------------------------------------------------------------------------------------------
----------------------------------------------------------------------------------------------------------------------------------------------------------------------------------------------------------------------------------------------------------------------------------------
----------------------------------------------------------------------------------------------------------------------------------------------------------------------------------------------------------------------------------------------------------------------------------------
------------------------------------------------------------------Q---------------------------QSS--------------S--------------Q---------SSXXXXXXX---------------------------------------------------------------------------------------------------------------------------------------
----------------------------------------------------------------------------------------------------------------------------------------------------------------------------------------------------------------------------------------------------------------------------------------
----------------------------------------------------------------------------------------------------------------------------------------------------------------------------------------------------------------------------------------------------------------------------------------
---------------------------------------------------------------------------------------------------------------------S------------------------------------------------------------------------------------------------------------------------------------------------------------------
-------------------------------------------------------E-----------QQQ------------E---E--QQ--SS?----E----------------------QQQQQQ------SS--------------------------------------------XXXX--------------------------------------------------QQ--QQ---------------------------------------
------------------------------------------------------<>-------------------------<>--<>------------<>--------------------------------------------------------------------------------X------------------------------E---------E---------------------------------------------------------
-------------------------------------------<>---------[]-------------------------[]--[]--X---------[]---------------------------------------------------X---------------------------XX-----------------------------<>---------E---------------------------------------------------------
-------EE-E--------------------------------[]---------[]-------------------------[]--[]------------[]-EE--------------------------E-----------------E---E------------EE------------XXX----------E------------------[]---------E-------------------------------------------------------E-
---XXXXXXXXXXXXXXXXXXXXXXXXXXXXXXXXXX-XXXXXXXXXXXXXXXXXXXXXXXXXXXXXXXXXXX--------XXXXXXXXXXXXXXXXXXXXXXXXXXXXXXXXXXXXXXXXXXXXXXXXXXXXXXX-XXXXXXXXXXXXXXXXXXX-----XXXXXXXXXXXXX---XXXXX-----XXXXXXXXXXXXXXXXXXXXXXXXXXXXXXXXXXXXXXXXXXXXXXXXXXXXXXXXX-----X-XXXXXXXX---XXXXXX---XXXXXXXXX
