----------------------------------------------------------------------------------------------------------------------------------------------------------------------------------------------------------------------------------------------------------------------------------------
----------------------------------------------------------------------------------------------------------------------------------------------------------------------------------------------------------------------------------------------------------------------------------------
-----------------------------------------------------------------------------------------S-SSSSS----------------------------------------------------------------------------------------------------------------------------------------------------------------------------------------
------E---------------------------------------------------------------------------------------------------------------------------------------------------------------------------------------------------------------------------------------------------------------------------------
--XXXXXXX-------------------------------------------------------------------------------------------------------------------------------------------------------------------------------------------------------------------------------------------------------------------------------
-----------------SSSS-------------------------X-----------SS--SSSSSS--------------S-----------------------------X--SSS??SS-------??SS------------------------------------------------S-----XXX-------SS---------------------------------------------------------------------------------
----------------------------------------------X-----------------------------------------------------XX----------------------------------------------------------------------------------------------------------------------------------------------------------------------------------
---------------------------------------------XX-----------------------------------------------------XXX---------------------------------------------------------------------------------------------------------------------------------------------------------------------------------
---------------------------SSS---------------XX-----------------------------------------------------XXX---------X-XX------------------------------------------------------XXXX---------------------------------------------E------------------------------------------------------------
-XXXX-------------XXXX------QQ--------------XXXX-------------SSSSSS-------------------------Q-X-----XX-----------------SS---XXX----------<>-QQQQ--------------XX--------------------XX--------------SS----------------X---<>----------------------SSSS-SS-SQ------------------------SSSS
------------------------X-XX--------------EXXXXX-------------------------------------------------XX-XX----X------------------------------[]---------------XXXXXXX-------------------------------XXXX------------------X---[]------------------------------------------------------------
------------------------------------------XXXXXX------------------------------------------------XXXXXX-----------------------------------[]-------X----------XXX----------------------------------------------------XXX---[]----XXX-----------------------------------------------------
---------------------XX-------------------XXXXXX--------------------------EE--------EE-E--------XXXXXX------------------------------E-E--[]----------------X---X---------------------------------------------------XXXX---[]-------------------------E-------------E-E------------------
----------------------------XXXXXXXX-XXXXXXXXXXXXXXXXXXXXXXXXXXXXXXXXXXXXXXXXXXXXXXXXXXXXXXXXXXXXXXXXXXXXXXXXXXXXXX--XXX--------XXXXXXXXXXXXXXXXXXXXXXXXXXXXXX-X----XXXX-----XXXXXX---XXXXXXXXXXXX--XXXXXXXXXXXXXXXXXX---XXXXXXX-------XXXX-XXXXXXXXXXXXXXXXXXXXXXXXXXXXXXXXXXXXXXXXXXXX
