----------------------------------------------------------------------------------------------------------------------------------------------------------------------------------------------------------------------------------------------------------------------------------------
----------------------------------------------------------------------------------------------------------------------------------------------------------------------------------------------------------------------------------------------------------------------------------------
----------------------------------------------------------------------------------------------------------------------------------------------------------------------------------------------------------------------------------------------------------------------------------------
----------------------------------------------------------------------------------------------------------------------------------------------------------------------------------------------------------------------------------------------------------------------------------------
---------------------------------------------------------------------------------------------------------------------------------------------------------------------------------------------------------------------------------------------------------------------XXX----------------
------------------------XXX------------------------------X---------------------------------------------------------SSSSSSSSS---S----S-----------------SS-S-----------S---------------------------------------------------------------------------------------------------QQ------------S
----------------------------------------------------------------------------------------------------------------------------------------------------------------------------------------------------------------------------------------------------------------------------------------
----------------------------------------------------------------------------------------------------------------------------------------------------------------------------------------------------------------------------------------------------------------------------------------
---------------------------------------------------------------------------------------------------------------------------------------E--?--XS------------------------------------------------------------------------------------------------------------------SSS--------------------
--------------XX----------------------------------SSSSSS------------------------------------------------SS-SSSSS----SSSSSS------------<>-----------S?--SSSS----------------------------------------------------------------S---------Q----------E----------------------QQQQQQQ----------
--------------XX----------------------E----------------------------------------E------------------------------------------------------[]-----------------------------------------------------------------E----------E--------------------------<>---------------------------------------
-------------XXX---------------------<>---------------------------------------<>------------------------------------------------------[]----------------------------------------------------------------<>---------<>--------------------------[]---------------------------------------
-----------EXXXX-------------------E-[]---------------------------------------[]-----------EE-----------------------------------------[]----------------------------------------------------------E-----[]---------[]---------------E----------[]---------------------------------------
-XXXX---XXXXXXXXXXXXXXX-XXXXXXXXXXXXXXXXXXXXXXXXXXXXXXXXXXXXXXXXXXXXXXXXXXXXXXXXXXXX---XXXXXXXXXXXXXXXXXXXXXXXXXXXXXXXXXX--XXXXXXXXXXXXXXXXXXXXXXXXXXXXXXX-XXXXXXXXX----XXXXXXXXXXXXXXXXXXXXXXXXXXXXXXXXXXXXXXXXXXXXXXXXXXXXXXXXXXXXXXXXXXXXXXXXXXXXXXXX-XXXXXXXXXXXXXXXXXXXXXXXX--XXXXX
