----------------------------------------------------------------------------------------------------------------X-----------------------------------------------------------------------------------------------------------------------------------------------------------------------
----------------------------------------------------------------------------------------------------------------------------------------------------------------------------------------------------------------------------------------------------------------------------------------
----------------------------------------------------------------------------------------------------------------SSSSSSSSSSSSSSSSSSSSSSSSSSSS--------------------------------------------------------------------------------------------------------------------------------------------
----------------------------------------------------------------------------------------------------------------SSSSSSSSSSSSSS---------S--SS-------------------------------------------X-------------------------------------------------------X----------------------------------------
----------------------------------------------------------------------------------------------------------------SSSSSSSSSSSSSS------------S---------------------------------------------------------------------------------------------------------------------------------------------
--------------------------------------------------------X---SS--QQSS----------------X---SSSSSSSS------SS---------SSSSSSSSSS--S------------SS----------------------SSSSSS---------------X-------------------------------------------------------X--------------------------------------XX
-------------------------------------------------------------------------------------------------------------------S------------------------------------------------------------------XXX-----------------------------------------------------XX----------------------------------------
--------------------------------------------------------------------------------------------------------------------------S----------------------------------------------------------XXXX-----------------------------------------------------XX----------------------------------------
---------------------------------E----------E-------------X-----------------------E-X-X-----------------------------?-----S------------SS-------------------------------------------XXXXXX--------------------------------------------------XXXX----------------------------------------
----------------E-----<>--------<>---------<>------------------S?S-SSSS----------<>--------SS---?SS----------<>-SSSSSSSSSSSS--------E------X------------Q--------------------------XXXXXX-----------------------X--------------------------XXXX-----------------------------------------
---------------<>-----[]--------[]---------[]------------------------------------[]--------------------------[]-SSSSSSSSSSS--------<>------X--------------------------------------XXXXXXX----X-----------------XXX------------------------XXXXXX----------------------------------------
---------------[]-----[]--------[]---------[]------------------------------------[]--------------------------[]-SSSSSSSSSSS--------[]------X-------------------------------------XXXXXXXX----X-----------------XXX-----------------------XXXXXXX----------------------------------------
---------------[]-----[]--------[]---E-----[]------------------------------EE-E--[]--------------------EE-E--[]-SSSSSSSSSSS--------[]------X----------------------------EE-E----XXXXXXXXXX---X-----X--------EXXXXX----------EE-E-E------XXXXXXXX--------E--E----------------------------
XXXXXXXXXXXXXXXXXXXXXXXXXXXX-XXXXXXXXXXXXXXXXXXXXX-XXXXXXXXXXXXXXXXXXXXXXXXXXXXXXXXX--XXXXXXX---XXXXXXXXXXXXXXXXXXXXXXXXXXXXXXXXXXXXXXXXXXXXXXXXXXXXXXXXXXXXXXXXXXXXXXXXXXXXXXXXXXXXXXXXXXXXXXXXXXXXXXXXXXXXXXXXXXXXXXXX-XXXXXXXXXXXXXXXXXXXXXXXXXXXXXXXXXXXXXXXXXXXXXXXXXXXXXXXXXXXXXXX
