----------------------------------------------------------------------------------------------------------------------------------------------------------------------------------------------------------------------------------------------------------------------------------------
----------------------------------------------------------------------------------------------------------------------------------------------------------------------------------------------------------------------------------------------------------------------------------------
----------------------------------------------------------------------------------------------------------------------------------------------------------------------------------------------------------------------------------------------------------------------------------------
----------------------------------------------------------------------------------------------------------------------------------------------------------------------------------------------------------------------------------------------------------------------------------------
----------------------------------------------------------------------------------------------------------------------------------------------------------------------------------------------------------------------------------------------------------------------------------------
---------------------------------------------------------------------------------------------------------------------------------E----------------------XX--------------------------------X---------------------------------------------------------------------------------------------
--------------------------------------------------------------------------------------------------------------------------------XXXX------------------------XXXXXX-----------------------XX---------------------------------------------------------------------------------X-----------
---------------------------------------------------------------------------------------------------------------------------------------------------------------------------------------XXXX---------------------------------------------------------------------------------------------
----------------------------------------------------------------------------------------------------------------------------------------------------------------------XE--------------XXXXX---------------------------------------------------------------------------------------------
-----------------------------X---------------------SSSSS-------------XXXXX-----------------------------------------------------------------Q-X----------------------S-SS-------------XXXXXX------------------------------------------------------X---------------------------------SSSSS
---------------------------------------------------------------------------------------------------------------------------------------------X---------------------------------------XXXXXX---------------------XX------------------------------XXXX------------------------------------
----------------------------------------------------------------------------------------------------------------XXXX------------------------XXX-----------------------------------XXXXXXXXX--------------------XXX-----------------------------XXXXX---------X--------------------------
-----------------------------X-----E-E---------------------------------------------------------------------------------------E--------------XX-----E------------------------------XXXXXXXXX-----E------------XXXXX----------E-EE--------------XXXXXX----------------E------------E-E----
XXXXXXXX------XXXXXXXXXXXXXX---XXXXXXXXXXXXXXXXXXXXXXXXXXXXXXX--XXXXX---------------XXXXXXXXX-----XXXXXXXXXXXXXXXXX-XXXXXXXXXXXXXXX-XXXXXXXXX---XXXXXXXXXXXXXXX--XXXXXXXXXXXXXX---XXXXX--XXXXXXXXXXXXXXXXXXX--XXXX-X-XXXXXXXXXXXXXXXXXXXXXXXXXXXXXXXXXXXXXXX-----XXXXXXXXXXXXXXXXXXXXXXX
