----------------------------------------------------------------------------------------------------------------------------------------------------------------------------------------------------------------------------------------------------------------------------------------
----------------------------------------------------------------------------------------------------------------------------------------------------------------------------------------------------------------------------------------------------------------------------------------
----------------------------------------------------------------------------------------------------------------------------------------------------------------------------------------------------------------------------------------------------------------------------------------
----------------------------------------------------------------------------------------------------------------------E-----------------------------------------------------------------------------------------------------------------------------------------------------------------
------------------------------------------------------------------------------------------------------------------XXXXXXX----------------------------------------------------------------------------------------------------------------------------------------X----------------------
-------------S-----------------S-------------------------------------------------------------------------------------------------XXXX------------------------XX----------SSS----S-------------------SSSS----S------------------------------------SSSS-----------------------------XXXX--
------------------------------------------------------------------------------------------------------------------------------------------------------------XXX-------------------------------------------------------------------------------------------------------------------------
------------------------------------------------------------------------------------------------------------------------------------------------------------XXX-------------------------------------------------------------------------------------------------------------------------
-XSSS---------------------E------------------------E---------------------------------------------------------------XXXX--------------------S---------------XXXX--------------------------------E----------------------------------------------------------------------------------------
-----------SSSS----------<>-----------------------<>-----------------------------------------------XX-------------XXX-------XXX-----XX----------------X-----XXX------------S-----Q------------<>-------S-------------------------XXXX--------------X--------X-Q---------------XX--------
-------------------------[]-----------------------[]--------------------E---------------------------------------------------------------XXXX-------------XXXXXX-------------------------------[]----------------------X--------------------------------------------------XXX------------
-------------------------[]-----------------------[]-------------------<>-------------------------------------------------------------------------------XXXXXXX---------------------------X---[]--------------------XXXX----------------------------------------------------------------
-------------------E-----[]-----------------------[]--------EE---------[]----------E-------------------------------------------------XX-----E--E-------XXXXXXXX-------------------------------[]--------------------XXX--------X--------------------------------------------------------
XXXXXXXXXX--XXXXXXXXXXXXXXXXXXXXXXXXX-XXXXXXXXXXXXXXXXXXXXXXXXXXX-XXXXXXXXXXXXXXXXXX---X----XXXXXXX--XXXXXXXXXXX----------------------------XXXXXXXXXXXXXXXXXXXXX--XXXXXXXXXXXXXXXXXXXXXXXXXXXXXXXXXXXXXXXXXXXXXXXXXXXXX---X--XXXXX-----X----------XXXX--XXX---------XX-----------------
