----------------------------------------------------------------------------------------------------------------------------------------------------------------------------------------------------------------------------------------------------------------------------------------
----------------------------------------------------------------------------------------------------------------------------------------------------------------------------------------------------------------------------------------------------------------------------------------
-----------------------------------------------------------------------------------------------S----------------------------------------------------------------------------------------------------------------------------------------------------------------------------------------
----------------------------------------------------------------------------------------------------------------------------------------------------------------------------------------------------------------------------------------------------------------------------------------
----------------------------------------------------------------------------------------------------------------------------------------------------------------------------------------------------------------------------------------------------------------------------------------
--------------------------------------------------------------SSSSSSS----------SSSSS--S----SS-------------------------------QQQ-------------SSSSSSSSSSS---SS-----------S----------------------------------------------------X-XX--------------------------XX-XXX------------------------
----------------------------------------------------------------------------------------------------------------------------------------------------------------------------------------------------------------------------------------------------------------------------------------
----------------------------------------------------------------------------------------------------------------------------------------------------------------------------------------------------------------------------------------------------------------------------------------
------------------------------------------------------------------------------------------------------------------SSSSSSS---------------------------------------------------------------E-------------------------------------------------------E---------------------------------------
-----------------------S-S---------------XXXXX------------E--SSSSSSS----------------SSSSS-------------XX------XX-----------SSQSQ---------<>----SSSSSSS---------------------------------<>------------------------------------------------------<>---------------------------------------
---------------------------------------------------------<>--------------------------------E----------XX---------------------------------[]--------------------------------------------[]---------E--------------------------------------------[]---------------------------------------
---------------------------------------------------------[]-------------------------------<>--------XXXX---------------------------------[]-------------------X------------------------[]--------<>--------------------------------------------[]---------------------------------------
-------E-------------------------------------------------[]---------------EE--------------[]-------XXXXXX------X-------------------E-----[]-------------------X------------------------[]--------[]---------------------------------E----------[]-------------------------------------E-
XXXXXXXXXX-XXXXXXXXXXXXXXXXXXXXXXXX--XXXXX-----XXXXXXXXXXXXXXXXXXXXXXXXXXXXXXXXXXXXXXXXXXXXXXXXXXXXXXXXXXXXXXXXXXXXXXXXXXXXXXXXXXXXXXXXXXXXXXXXXXXXXXXXXXX--X-----------XXXXXXXXX-XXXXXXXXXXXXXXXXXXXXXXXXXXXXXXXXXXXXXXXXXXXXXXXXXXXXXXX-XXXXXXXXXXX----XXXXXXXXXXXXXXXXXXXX--------XX-
