----------------------------------------------------------------------------------------------------------------------------------------------------------------------------------------------------------------------------------------------------------------------------------------
----------------------------------------------------------------------------------------------------------------------------------------------------------------------------------------------------------------------------------------------------------------------------------------
----------------------------------------------------------------------------------------------------------------------------------------------------------------------------------------------------------------------------------------------------------------------------------------
----------------------------------------------------------------------------------------------------------------------------------------------------------------------------------------------------------------------------------------------------------------------------------------
----------------------------------------------------------------------------------------------------------------------------------------------------------------------------------------------------------------------------------------------------------------------------------------
----------------------------X---S???SSS------??S------------------------------------------------------------------------SS------------------------------?S----------------------------------------------------------------------X---S---SSSS--------------------------------X-----------
-----------------------------------------------------------------------------------------------------XXX--------------------------------------------------------------------------------------------------------------------------------------------------------------------X-----------
----------------------------------------------------------------------------------------------------------------------------------------------------------------------------------------------------------------------------------------------------------------------------X-----------
-----E----------E-----------X-X---------------------------------------------------------------------------------------------------------------SSSSSSS-----------------E-----------------------------------------------------------X-----------------------E-----------------XX----------
----<>---------<>----------E-------SS---XXX----------XX------------------------------X------------------------SS--------------------------E-------------S?-----------<>-------S-------------------------------QQQ--QQ------------------SS---SSS----------<>--E----------XX--X-----------
----[]---------[]---------<>-------------------------XX------------------------------X---------------------------------------------------<>--------------------------[]----------------------------------------------------------------------------------[]-<>-------X--XXXXX----XX----E
----[]---------[]---------[]-------------------------XX-----------------------------XXX--------------------------------------------------[]--------------------------[]----------------------------------------------------------------------------------[]-[]-------X--XXXXXX---XX---<>
----[]---------[]---------[]-------------------EE-E--XX-------------EE-------E------XX------------------------------------------------E--[]--------E-E---------------[]-------------------E---------------------------------------------------------E-E--[]-[]--E-------XXXXX----XX---[]
XXXXXXXXXXXXXXXXXXXXXXXXXXXX------XX-----X-XXXXXXXXXXXXX------XXXXXXXXXXXXXXXXXXXXXXXXXXXXXXXX---XXXXXXXXXXXXXXXXXXXXXXX---XXXXXXXXXXXXXXXXX---XXXXXXXXXXXXXXXX-XXXXXXXXXXXXXXXXXXXXXXXXXXXXXXXXXXXXXXXXXXXXXXXXXXXXXXXXXXXXXXXXXXXXXXXXXXXXX-----X-XXXXXXXXXXXXXXXXXXXX---XX---XXXXXXXX
