----------------------------------------------------------------------------------------------------------------------------------------------------------------------------------------------------------------------------------------------------------------------------------------
----------------------------------------------------------------------------------------------------------------------------------------------------------------------------------------------------------------------------------------------------------------------------------------
----------------------------SSSSSSSSSSSSSSSSSSSSSSSSSSSS--------------------------------------------------------------------------------------------------------------------------------------------------------------------------------------------------------------------------------
----------------------------------------------------------------------------------------------------------------------------------------------------------------------------------------------------------------------------------------------------------------------------------------
-----------------------------------------------------------------------------------------------------------------------------------------------------------------------------------------------------------------------------------------XXX--------------------------------------------
-----------------------------------------------------------------------------------------------------XX---------X-----------SSS----------S-------------------------------------QQQQQQ-----------SSSS-------SQQSS-------------------------------------------------------------XX---------
---------------------------------------------------------------------------------------------------XXXX---------------------------------------------------------------------------------------------------------------------------------------------------------------------XXX---------
--------------------------------------------------------------------------------------------------XXXXX--------------------------------------------------------------------------------------------------------------------------------------------------------------------XXXX---------
--------------------------------------E----------------------------------------------------------XXXXXX---------XXXXX-----------------------------------------------------------------------------------------------------------------------------------------------------XXXXX---------
---------------X-----------E---S----SSS---------E-------------------X-------------------------X--XXXXX-----------------S?---SSS---------------------------XXX----------------QQ---QQQ--?------------------SSS--SSSS----------<>----------------Q----------E-----------X--XXXXXX---------
---------------X----------<>---------S---------<>------X-----------XXX------------------------XXXXXXXX----------------------------------XXXX-------------XX--------------<>--------------------------------------------------[]-----------E--------------<>-----------X-EXXXXXX---------
--------------XXX---------[]---------S---------[]------------------XXX-----------------------XXXXXXXXXX--------------------------------------------------XX--------------[]--------------------------------------------------[]----------<>--------------[]-----------XXXXXXXXX---------
-----------E--XX----------[]------E--S---------[]---------------EXXXXX----------EE-E---------XXXXXXXXXX-----E------------------------------------------X------------E-EE-[]---------------EE---------------------------EE-E--[]----------[]--------------[]-----------XXXXXXXXX---------
XXXXXXXX--XXXXXXXXXXXXXXXXXXXXXXXXXXXXXXXXXXXXXXXXXXXXXXXXXXXXXXXXXXXX-X--XXXXXXXXXXXXXXX---XXXXXXXXXXXXXXXXXXXX----XXXXXXX----XXXXXXXXXX---XXXXXXX---XXXXX---XXXXXXXXXXXXXXXXXXXXXXXXXXXXXXXXXX-XXXXXXXXXXXX---XXXXXXXXXXXXXXXXXXXXXXXXXXXXXXXXXXXXXXXXXXXXXXXXXX--XXXXXXXXXXXXXX-XXXXX
