----------------------------------------------------------------------------------------------------------------------------------------------------------------------------------------------------------------------------------------------------------------------------------------
----------------------------------------------------------------------------------------------------------------------------------------------------------------------------------------------------------------------------------------------------------------------------------------
----------------------------------------------------------------------------------------------------------------------------------------------------------------------------------------------------------------------------------------------------------------------------------------
----------------------------------------------------------------------------------------------------------------------------------------------------------------------------------------------------------------------------------------------------------------------------------------
-------------------------------------XXX------------------------------------------------------------------------------------------------------------------------------------------------------------------------------------------------------------------------------------------------
-XXX----------------------------------------------------------------------------XXXX-----------------------------------------------------------------------------------------------------------SS----------Q--QQ------------------------------------------------------------------------
----------------------------------------------------------------------------------------------------------------------------------------------------------------------------------------------------------------------------------------------------------------------------------------
----------------------------------------------------------------------------------------------------------------------------------------------------------------------------------------------------------------------------------------------------------------------------------------
---------------------------------S------------------------------------------------------------------------------------------------------------------------------------------------------------------------------------------------------------------------------------------------------
---------------------------------------QQQQQQQ--------E-------------------------S--------------------------------------------------------------------------------------------------------XX---------------Q---QQQQQQ----------E--------------X------------------------------------------
-----------------------------------------------------<>-----------------------------------------------------------------------------------------------------X----------E---------------XXXXX---------------------------------<>-------------XX--------------------------X---------------
-----------------------------------------------------[]--------------------------------------------XXX--------XX------------------------------------------XXXX--------XX---------------XXXXX---------------------------------[]------------XXX--------------------------X---------------
------------E----------------------------------E-----[]-------------------------------------------X-XX--------XX----------------------------EE-----------XXXXX--------XX--------------XXXXXX---------------------------E--E--[]------------XXX-------EE-E---------------XE-------E-E----
XXXXXXXXXXXXXXXXXXXXXXXXXXXXXXXXXXXXXXXXXXXXXXXXXXXXXXXXXXXXXXXXXXXXXXXXXXXXXXXXXXXXXXXXXXXXXXXXXXXXXX----XX--XXXXXXXXXXXXXXXXXXXXXXXXXXXXXXXXXXXXXXXXXXXXXXXXXX--XXXXXXXXXXXXXXXXXXXXXXXXXXXXXXXXXXXXXXXXXXXXXXXXXXXXXXXXXXXXXXXXXXXXXXXXXXXX---XXXXXXXXXXX----XXXXXXXXXXXXXXXXXXXXXXXX
