----------------------------------------------------------------------------------------------------------------------------------------------------------------------------------------------------------------------------------------------------------------------------------------
----------------------------------------------------------------------------------------------------------------------------------------------------------------------------------------------------------------------------------------------------------------------------------------
----------------------------------------------------------------------------------------------------------------------------------------------------------------------------------------------------------------------------------------------------------------------------------------
----------------------------------------------------------------------------------------------------------------------------------------------------------------------------------------------------------------------------------------------------------------------------------------
-----------------------------------------------------------------------------------------------------------------------------------------------------------------------------------------------------------------------------------------XX---------------------------------------------
X--SSSSSSSSSS-SS-----S--SSSSSSS-----------------------------------------------SSSSS-----------------------------------------------------------------------------------XX---------------------------------------------------------------------Q---------------XXX------------------------
----------------------------------------------------------------------------------------------------------------------------------------------------------------------------------------XXXX--------------------------------------------------------------------------------------------
X---------------------------------------------------------------------------------------------------------------------------------------------------------------------------------------------------------------------------------------------------------------------------------------
---------------------------------------------------E---------------------------SS-----------------------------------------------------------------------------------------------------------------------S---------------------------SSSSS-----------------------------------------------
----SSSSSS--?SS----------X--SSSQ--------------XX--<>----SSSSS--------------X---------------------------------------------------X---------------------------------SSSSS----------------------------SS------------SSS-------------------------QQQQ----------E-----------------------------
-----------------------------------E---------XXX--[]-----------E----------XX--------------------------------------------------------------E-----------E------------------E-------------------------------------------------------------------------------<>-----------------------------
----------------------------------<>--------XXXX--[]----------<>--------XXXX------------------------XX--------XX-------------------------<>----------<>-----------------XXX------------------------------------------------------------------------------[]-----------------------------
--------------------E-------------[]-------XXXXX--[]---X------[]-------XXXXX------------------------XX--------XX-------------------------[]--------E-[]-----------------XX---------------------------------------------------------------E---------------[]-------------E-------------E-
XXXXXXXXXXXXXXXXXXXXXXXXXXXXXXXXXXXXXXXXXXXXXXXXXXXXXXXXXXXXXXXXXXXXXXXXXXXXXXXXXXXXXXXXXXXXXXXXXXXXXXX---XXXXXXXXXXXXX---XXXXX----XXXXXXXXXXXXXXXXXXXXXXXXXXXXXXXXXXXXXXXXXXXXXXXX-XXXXXXXXXXXXXXXX---XXXXXXXXXXXXXXXXXX-XXXX--XXXXXXXXXXXXXXXXXXXXXXXXXXXXXXXXXXXXXXXXXXXXXX---XXXXXXX
