----------------------------------------------------------------------------------------------------------------------------------------------------------------------------------------------------------------------------------------------------------------------------------------
----------------------------------------------------------------------------------------------------------------------------------------------------------------------------------------------------------------------------------------------------------------------------------------
S-SSSSSSSSSSSSSSSSSSSSSSSSS--------------------------------------------------------------------------------------------------------------------SSSSSSSSS-----------S--SS----------------------------------------------------------------------------------------------------------------
-----------------------------------------------------------------------------------------------------------------------------------------------S---SS-----------------------------------------------------------------------------------------------------------------------------------
-----------------------------------------------------------------------------------------------------------------------------------------------S---SS-----------------S-----------------------------------------------------------------------------------------------------------------
-SSS---SSS-----------------------------------------XXXX-------------SS-----------------------------------------X------------------S----------SSSSSSSSS---SSS----------SS------------------------------------------------------------------------------------------------------------XXXX
-----------------------------------------------------------------------------------------------------------------------------------------------------------------------------------------------------------------------------------------------X----------------------------------------
----------------------------------------------------------------------------------------------------------------------------------X-----------------------------------------------------------------------------------------------------------XXX---------------------------------------
-----------------------E---------------------------------XXXX---------------------------------------------------------------------X------------E----------------------------------------------------------------------------------------------XX----------------------------------------
-SSSS--SSSS-----------<>------------------XXX-----------------------SSS----------X-------------------------S-------------------X--X----------SSSSSSSSS---------E------X-------Q----QQ--QQ-----------------------------------------------------XX-----------------------------------SS---
---S----S---------<>--[]--------------------------------------------------------XXX-------------------------------------------EXXXX-------------SSSSS---------<>-------------------------------------------------------------------------------X-----E----------------------------------
---S--------------[]--[]---X--------------------------------------------------------------------------------------------------XXXX-------------SSSSS--------X-[]------------------------------------------------------------------------------XX-----X----------------------------------
------E-----------[]--[]---X------------------------------------------------------------------E---------------------------------------------------------------[]E----------------------------------------------------------------E--E------E--XX----------------------------------------
XXXXXXXXXXXXXXXXXXXXXXXXXXXXXXXXXX---XXXXXX--XXXXXXXXXXXXXXXXXXXXX--XXXXXXXXXXXXXX----XXXXXXXXXXXXXXXXXXXXXXXXXXXXXXXX---XXXXXX----XXXXXXXXXXXXXXXXXXXXXXXXXXXXXXXXXXXXXXXXXXXXXXXXXXXXXXXXXX--XXXXXXXXXXXXX------XXXXXXXXXXXXXXXXXXXXXXXXXXXXXXXXXXXX-XXXXX---XXXXXXXXXXXXXXXXXXXX--XXX
