----------------------------------------------------------------------------------------------------------------------------------------------------------------------------------------------------------------------------------------------------------------------------------------
----------------------------------------------------------------------------------------------------------------------------------------------------------------------------------------------------------------------------------------------------------------------------------------
----------------------------------------------------------------------------------------------------------------------------------------------------------------------------------------------------------------------------------------------------------------------------------------
XE--------------------------------------------------------------------------------------------------------------------------------------------------------------------------------------------------------------------------------------------------------------------------------------
-XXXXXXX--------------------------------------------------------------------------------------------------------------------------------------------------------------------------------------------------------------------------------------------------------------------------------
S---------------------SSSS----SSSSSSSS----SS-----------S--------------------------------------------------SSSS--------------------------------------------------------------------------------------------------------S---XXX------------------------------------------------XX---------
------------------------------------------------------------------------XX--------------------------------------------------------------------------------------------------------------------X------------------------------------------------------------------------------XX---------
----------------------------------------------------------------------------------------------------------------------------------------------------------------------------------------------------------------------X-----------------------------------------------------XXX---------
-------------------------------E--------------------------------------------------------------------------------------------------------------------------------------------------------------------S-----------------X-------------------------------------SS-------------XXXX---------
XQQQ-------------XEXXX---------SSSSSS-----------------------------------------SSSSSSQQQQ--------------XXXX------------------XX------------------------------X---------------------------XX----------X----------------XEX----------------------------------S-X------------XXXXXX---------
-----------E-XXXXXXXX----------------------------------------------------------------------E-----XXX-XXXX------------------XXX-----------------------------XX----------E----------------------------X-------------EXXXXX------------------------------------X------------XXXXXXX--------
------X>-----------XX-------------------------X>--------XXXX------------------------------<>---------XXXX-----------------XXXX----------------------------XXX---------<>----------------------------]-------------X-XX--------------------------------------]-----------XXXXXXX---------
------[]-----------X--------------------------[-E-E-------------E---EE-------E-E----------[]-------XXXXX----------------XXXXXX-E------E-E----E-E-------E-XXXX---------[]-------------E--------------]----------------------------------E--------------------]---------XXXXXXXXX---------
XXX--X--XXXXXXXXXXXXXXXXXXXXXXXXXXXXXXXXXXXXXXXXXXXXXXXXXXX-XXXXXXXXXXXXXXXXXXXXXXXXXXXXXXXXXXXXX--XXXXXXX----XXXXXXXXXXXXXXXXXXXXXXXXXXXXXXXXXXXXXXXXXXXXXXXXXXXXXXXXXX--------XXX-XXXXX---XXXXXXXXXXXXXX--XXXXXXX----X-----XXXXXXXXXXXXXXX-XXXXXXXXXXXXXXXXXXXXXX--XXXXXX-XXXX----XXXX
