----------------------------------------------------------------------------------------------------------------------------------------------------------------------------------------------------------------------------------------------------------------------------------------
----------------------------------------------------------------------------------------------------------------------------------------------------------------------------------------------------------------------------------------------------------------------------------------
------------------------------------------------------------------------------------SSSSSSSSSSSSSSSSSSSSSSSSSS--------------------------------------------------------------------------------------SSSSSSSSSSSSSSSSSSSSSSSSSSSS-------------------SSSSSSSSS---SSSSSSSSS--SS----SS------
--------------------------------------------------------------------------------------------------------------------------------------------------------------------------------------------------------------------------------------------------------------SSSSSSSSSSSSSS----S------S
---------------------------------------------------------------------------------------------------------------------------------------------------------------------------------------------------------------------------------------------------------------SSSSSSS----SS-----S----SS
----------------------------------------------------------------------------------------------------X------------XXX-------------------------------QQSSS-----------------------------S-----X----------------S-----------------------------------------------S-SSSSSSSSS--SSS----S-------
----------------------------------------------------------------------------------------------------X-----------------------------------------------------------------------------------------------------------------------------------------------------------------------------------
--------------------------------------------XXXX----------------------------------------------------XX----------------------------------------------------------------------------------------------------------------------------------------------------------------------------------
----------------------------------------------------------------------------------------------------XX-S-----------------------------------------------------------------XXXXX--------------------E---------------------------------------E---------------------E------------------E--?-
Q-----------------XX----------------------------------------------------------------<>---------XXX--X-----X---------------------------SSSSSS-----SQ---S-----------<-----------------XX-----------<--SSSSS---S----------------------------<>--------------------?SSSSSS---------E--<>----
--------------EXXX-------------------------------------------------XXX--------------[]-------X--XXX-X----XX----E---------------------------------------------------E-----------------------------[]--------S-----------XX----------------[]---------E-----------SSSS----------<>--[]----
-------------------------------------------------------------------XXX--------------[]-------X--XXXXXX---XX---<>--------------------------------------------------[]-----------------------------X]-------<>--------XXXXX----------------[]--------<>----------SSSS-----------[]--[]----
------------------------------E---E-E-EEE-E-------E-EE-E--------EXXXX-EE--------EE-E[]--E-------XXXXXX---XX---[]-----EEEE---E--------E-E----------------------E---[]--------------------------------------[]--------[X-XX----------------[]--------[]-------------------------[]E-[]----
XXXX----XXXXXXX---------XXXXXXXXXXXXXXXXXXXXXXXXXXXXXXXXXXXXXXXXXXXXXXXXXXXXXXXXXXXXXXXXXXXXXXXX---XX---XXXXXXXXX--XXXXXXXXXXXXXXXXXXXXXXXXXXXXXXXXXXXXXXXXXXXXXXXXXXXXX----XXXXX-------XXXXXXXXXXX-XXXXXXXXXXXXXXXXXXXXXXXXXXXXXXXXXXXXXXXXXXXXXXXXXXXXXXXXXXXXXXXXX-XXXX-XXXXXXXXXXXXX
