----------------------------------------------------------------------------------------------------------------------------------------------------------------------------------------------------------------------------------------------------------------------------------------
------------------------------------------------------------------------------------X---------------------------------------------------------------------------------------------------------------------------------------------------------------------------------------------------
----------------------------------------------------------------------------------------------------------------------------------------------------------------------------------------------------------------------------------------------------------------------------------------
----------------------------------------------------------------------------------------------------------------------------------------------------------------------------------------------------------------------------------------------------------------------------------------
-------------------------------EE----------------E---------------------------------------------------------------------------------------------------------------------------------------------------------------------------------------------------------S----------------------------
-------------------------------SS--------------SSSSSSSS---------------------------XX---------------------------------------------------------------------------------------------------------------------------------------------------S---------SSS-------------------------SSS--------
-------------------------------------------------------------------------------------------------------------------------------X--------------------------------------------------------------------------------------------------------------------------------------------------------
------------------------------------------------------------------------------------------------------------------------------XX--------------------------------------------------------------------------------------------------------------------------------------------------------
------------------------------EX--------------------------------------------------------------E------------E-----------------XXX------------------------------------------------------------------------------E-------------------------------------------------------------------------
-----------------------------XXXX--------EE----XXX---------------------------------------E---<>-----E-----<>---E-------------XXX------------X---------------XXXX---------------------X-XX----------------E---<>-----E-----------SXXXX-------------XX------XXSQQXX-------------XX--<>----
---------------XXX-----------------E---EXX----------------------------------------------<>---[]----<>-----[]--<>----------XXXXXX--------------------------XX------------------------XX-----------------------[]----<>---E--E---E-------E---EX-----XX------------------------------[]----
---------------XXX----------------XX--------X-------------------------------------------[]---[]----[]-----[]--[]---------XXXXXXX----------------------------------------------------XX-----------------------[]----[]--<>-<>--XX------<>----------XX------X-------------------X---[]----
---------------XXXX-------------------------X-------------------------------------------[]---[]----[]-----[]--[]--------XXXXXXXX--------E------------------------------------------XXX-------E--E------------[]----[]--[]-[]--XX------[]-------XX-XXX-E--XXX----------------------[]----
XXXXX--XXXXXXXXXXXXXXX--XXXXX------XXXX----XXXXXXXX--XXXXXXXXXXXXXXXXXXXXXXXXXXXXXXX-XXXXXXXXXXXXXXXXXXXXXXXXXXXXXXXX-XXXXXXXXXXXXXXXXXXXXXXXX-------XXX----------------XXXXXXX-XXXXXXXXXXXXXXXXXXXXXXXXXXXXXXXXXXXXXXXXXXXXXXXXXXX--XXXXXXXX--XXXXXXXXXXXXXXXXXXXXX---XX--XXXXXXXXXXXXX
