----------------------------------------------------------------------------------------------------------------------------------------------------------------------------------------------------------------------------------------------------------------------------------------
----------------------------------------------------------------------------------------------------------------------------------------------------------------------------------------------------------------------------------------------------------------------------------------
----------------------------------------------------------------------------------------------------------------------------------------------------------------------------------------------------------------------------------------------------------------------------------------
----------------------------------------------------------------------------------------------------------------------------------------------------------------------------------------------------------------------------------------------------------------------------------------
----------------------------------------------------------------------------------------------------------------------------------------------------------------------------------------------------------------------------------------------------------------------------------------
------------------------XXXX-----------------------------------------------------------------------------------------------------------SS-------------------XXX----------------Q--QQ---------------------------------------------------------------------------------------E------------
-----------------------------------------------------------------------------------------------------------------------------------------------------------XXXX-----------------------------------------------------------------------------------------------------------E-------------
-----------------------------------------------------------------------------------------------------------------------------------------------------------XXXX--------------------------------------------------XX-XXXX---------------------------------------------------XXXXX--------
----------------------------------------------------------------------------------------------------------------------------------------------------------XXXXX---------------------------------------------------------------------------------------------------------X---------------
------------------------S--------------------------------------------------------------------------------------------------------XX-------------------XX-XXXXXX---X-----------Q---QQQQQQ----------E-----------------------SS-----------------X--------------------------X---------------
----------------------------------------------------------------------------------------------------X----------E---------------XXXXX-------->---------X-EXXXXXX---X----E-------------------------<>-----------------E----E------------------XX-------------------------XXX-------E------
-------------------------------------------XXX--------XX------------------------------------------XXXX--------XX---------------XXXXX--------]--------XXXXXXXXXX---X---<>-------------------------[]----------------<>----------------------XXX------------------------XXX?------<-------
------------------------------------------X-XX--------XX----------------------------EE-----------XXXXX--------XX--------------XXXXXX--------]--E-----XXXXXXXXXX---X-E-[]-------------------E--E--[]---E-EE----E----[]-----E--E-E-----------XXX-------EE-E----EE-EEE-XXXXX-EE-----]E-E--E
XXXXXXXXXXXXXXXXXXXXXXXXXXXXXXXXXXXXXXXXXXXXXX----XX--XXXXXXXXXXXXXXXXXXXXXXXXXXXXXXXXXXXXXXXXXXXXXXXXXX--XXXXXXXXXXXXXXXXXXXXXXXXXXXXXXXXXXXXXXXXXX--XXXXXXXXX--XXXX-XXXXXXXXXXXXXXXXXXXXXXXXXXXXXXXXXXXXXXXXXXXXXXXXXXXXXXXXXXXXXXXXXXXXXXXX---XXXXXXXXXXXXXXXXXXXXXXXXXXXXXXXXXXXXXXX
