----------------------------------------------------------------------------------------------------------------------------------------------------------------------------------------------------------------------------------------------------------------------------------------
----------------------------------------------------------------------------------------------------------------------------------------------------------------------------------------------------------------------------------------------------------------------------------------
---SSSSSS-------------------SSSSSSSSSSSSSSSSSSSSSSSSSS------------------------------SSSSSSSSSSSSSSSSSSSSSSSSSSSS------------------------------------------------------------------------------------------------------------------------------------------------------------------------
--SSSSSSSSSSS--------------------------------------------------------------------------------------------------------------------------------------------------------------E-----------------------------------------------------------------------------------------------------SSSSSSS
---SSSSSSSS-S------------------------------------------------------------------------------------------------------------------------------------------------------------XXXXX---------------------------------------------------------------------------------EE----------------SSSSSSS
--SSSSSSSSSSSSSS----S------S----------------------------X--SSSSSSSSSS-SS-----------S---------------------------------------SS---------------Q---------------------------S----------------SSS--------------------------------------------------------------X----SSSSSS-----SS---SSSSSSSSS
EE----------------------------------------------------------------------------------------------------------------------------------------------XX-----------------------------------------------------------------X--------------------------------------------------------------------
---------------------------------------------S----------X---------------------------------------------------------------------------------------------------------------------------------------------------------XX--------------------------------------------------------------------
----E------------------E--------------------XSSS--------X-------------------------------------E---------------------------------E--------------------------------------------------------------------------------XXXX-----------------------------------------EX------------------------
---?SSSSSSSS----------<>----<>-------E------------X----------SSSSS--?SS------------------S---<>----------------------E---------<>------------------------XXXXXXX--------XXXXX-------------XXXX----X--------------XXX------------------------X---------------SXSXSSS-------E----X-X----XX
--E---------------<>--[]----[]-------E-----------XX----E--------------------------X----------[]---------E------X----<>---------[]---E------------------------------------------E---EXXX-----------------------XXXXXXX-----------------------XX--------------------SS---EX---------------
-----X------------[]--[]----[]----------XXX-<>---XX---<>-------------------------XX-S--------[]--------<>->---XX----[]---------[]---------------------------------------------XX-----------------XX----------XXXXXXXX----------------------XXX-------------------SSS--------X-X---------
------------------[]--[]----[]----------XXX-[]---XX---[]--------------------X-X-----S--------[]--------[]-E---XX----[]---------[]------------------------E-------E--E---------[]-------XX---XXX--XX----------XXXXXXXX-------------------EX-XXX-------EE-EE------------------X-X-E-------
XXXXXXXXXXXXXXXXXXXXXXXXXXXXXXXXXXXXXXXX--XXX---XXXXXXXXXXXXXXXXXXXXXX--XXX-XXX--X--XXXXXXXXXXXXXXXXXXXXXXXXXXXX--XXXXXXXXXXXXXXXXXXXXXXXXXX---------XXXXXX---XXXXXXXXXXXX----------------------XXX-XXXXXXXXXXXXXXXXXXXXXXXXXXXXXXXXXXXXXXXXXXXXXXXXXXXXXXXXXXX--XXXXXXXXXXXXXXXXXXXXXXX
