------------------------------------------------------------------------------------------------------------------------------------------------------------------------X---------------------------------------------------------------------------------------------------------------
------------------------------------------------------------------------------------------------------------------------------------------------------------------------X------------------------------------------E----SS-----S--------------------------------------------------------
-----------------------------------------------------------------------------------------------------------------------------------------------------------SSSSSS-------SSSSSSSSSS--SSSSSSSSSSSSSSSS---------------------S----SS--------------------------------------------------------
----------------------------------------------------------------------------------------------------------------------------------------------------------------------------------------------------XEEE----------------SSS-SSSS--------------------------------------------------------
---------------------------------------------------------------------------------------------------------------------------------------------------------------------------------SS----------------->XXX?XXXX-----------SS--SSSS--------------------------------------------------------
-----------------------XX--------------------SSSS--------XX------------------------------------------------XXXX-------------------E---------------------------------------------SS?SS-------------S-?----------------??SSSS-----X-------QQSSSS------------------------------------------
----------------------------------------------------------------------------------------------------------------------------------------------------------------------------------------------------------------------------------------------------------------------------------------
------------------------------------------------------------------------------------------------------------------------------------------------------------------------X---------S-----------------------------------------------------------------------------------------------------
---------------------------------------------------E---------------------------------------------------------------------------------------------------------S-------------------?S----------------------------------------------XX-----------------------------------------------------
-------------XXX------------XXXXX-------------XX--<>--X------------------------------------------XXXX-------------------------XXXX------------------Q---------------------E--SS--[]S----E----------XXXXXX]--------E---XXXX---XXX-------S?--SSSSS---------<>---------------XXXX----------
-------------XXXX------------------E---EXX--------[]---------------------------------------------XX---------------------------XXXX---------------------------X-----------<>------[]----<----E------X-------X---EXX------------XX-------------------------[]-----------------------------
-----------XXXXXX-----------------XX--------------[]-[-----------------------------------------XXXX--------------------------XXXXX------------------------XXXX----------S[]--X---[]--------<>------X-----XXX---------------------------------------------[]-----------------------------
----------XXXXXX---------------------------X------[]-[----------------------------------------XXXX----------E-----------------XXXX----------------E------XXXXX-----------[]------[]--------[]----XXX---------------XX---XXX------------------------E-----[]-----------------------------
XXXXXX--XXXXXX---XXX--------XXXXXXXX---X---XXXXXXXXXXXXX---XXXXXXXXXX-XXXX------XXXXXXXXXX---XXXXXX--XXXXXXXXXXXXXXXXX---XXXXX----------X---XXXXXXXXXXXXXXXXXXXX--XXXXXXXXXXXXXXXXXXXXXXXXXXXXXXXXXXX---------------------------XXXXXXXXXXXXXXXXXXXXXXXXXXX-XX--X------X----------------
