----------------------------------------------------------------------------------------------------------------------------------------------------------------------------------------------------------------------------------------------------------------------------------------
----------------------------------------------------------------------------------------------------------------------------------------------------------------------------------------------------------------------------------------------------------------------------------------
--------------------------------------------------------SSSSSSSSSSSSSSSSSSSSSSSSSS------------------------------------------------------------------------------------------------------------------------------------------------------------------------------------------------------
----------------------------------------------------------------------------------------------------------------------------------------------------------------------------------------------------------------------------------------------------------------------------------------
----------------------------------------------------------------------------------------------------------------------------------------------------------------------------------------------------------------------------------------------------------------------------------------
----------QQQ---------------------------------------XXXX---------------------------------------------------------S------------------------------------------XS----------------------------X----XX---X--------------------------------------------------------XXXX-----------------------
-----------------------------------------------------------------------------------------------------------------------------------------------------------XX----------------------------XX---------------------------------------------------------------------------------------------
-------------------------------------------------------------------------S-------------------------------------------------------------------------------XXXX----E-----------------------XX---------------------------------------------------------------------------------------------
------------------------------------------------------------------------XSSS----------------------------------------------------------------------------XXXXXE----------SS--------------XXX--------------E----------E-------------------------------------------------------------------
------Q---QQQQQQQQ-----------X------------------SSSSSSSS<>------Q--------X----X---------------------------------------------------X----------E---------XXXXXX----------EX---------------XXX-------------<>---------<>----------------------------------------------------------------S--
-------------------------<------------------------------[]-------E-------]----X-----------------------X------------------------XXXX---------<>---E---XXXXXXXX----X----<>X------------XXXXXX-------------[]---------[]------E--E---------------------------------------------------------
-------------------------[------------------------------[]----------XXXXXX---XX----X----------------X-X------------------------XXXX--------X[]--<>---X-XXXXXX----XX---[]]------------XXXXXX-------------[]---------[]-----<>--------------------------------------------X---------------
-------------------E-----[]--------E-E------------------[]----------XXX-XX----X----X----------------XXX-----------------------XXXXX-------XX[]--[]------XXXXX----X----[]]----------X-XXXXXX-------------[]---------[]-----[]-------------------------------------EEEE---E----------E-EE-
XXXXXXXXXXXXXXXXXXXXXXXXXXXX---XXXXXXXXXXXXXXXXXXXXXXXXXXXXXXXXXXXXXXXXXXX--XXXXXXXXXXXXXXXXXXXXXXXXXXXXXXXXXXXXXXXXXXXXXXXXXXXXXXXXXXXXXXXXXXXXXXXXXXXX---XX---XXXXX-XXXXXXX---XXXXXXX--------------XXXXXXXXXXXXXXXXXXXXXXXXXXXXXXXXXXXX--XXXXXXXXXXXXX-XXXXXXXXXXXXXXXXXXXXX--XXXXXXXX
