----------------------------------------------------------------------------------------------------------------------------------------------------------------------------------------------------------------------------------------------------------------------------------------
----------------------------------------------------------------------------------------------------------------------------------------------------------------------------------------------------------------------------------------------------------------------------------------
----------------------------------------------------------------------------------------------------------------------------------------------------------------------------------------------------------------------------------------------------------------------------------------
----------------------------------------------------------------------------------------------------------------------------------------------------------------------------------------------------------------------------------------------------------------------------------------
---------------------------------------------------------------------------------------------------------------------------------------------------------------------------------------------------------------X------------------------------------------------------------------------
--------------------------------------------SSS---------------SSQSSSS-------S-------X---S---QQSSSSS------------------SSSSSSSS----------------------QQQQQ-----------------------------S---------------------------------------------S--------------------------XX------------------------
------------------------------------------------E---------------------------------------------------------------------------------------------------------------------------------------------------------------------------------------------------------------------------------------
--------------------------------------------E-----------X---------------------------]----------------------------------------------------------------------------------------------------------------------------------------------------------------------------------------XXX--------
---------------------------------E---------<>----------------------------------E----XXX------------------------------------------------E---------------------------E-----XSSS---------------------E------E----------E----------------------------------E--------------------------------
-----------------------------E--<>---------[]-------------E--QQ--SSS----------<>-----------S?S-SSSSS---------X-------SSSSSSS----------<>----------Q---QQQ---------<>---------------SSSS----------<>----------------<>---------------------------------<>--------------------------------
--------------------------E-<>--[]---------[]----X-----E-<>-------------------[]-----------------------------XXX-<>-------------------[]--------------------------[]--E--------------------------[]----------------[]---------E-----------------------[]--------------------------------
-------------------------<>-[]--[]---------[]---<>----<>X[]--X----------------[]-----------------------------XX--[]-------------------[]--------------------------[]-<---------------------------[]----------------[]--------<>-----------------------[]--------------------------------
-------------------------[]-[]--[]-----E-E-[]---[]----[]-[]---------------EE--[]-----------------------EE----X---[]---------------E---[]--------------------------[]-----------------------E-----[]-----EE---E-----[]--------[]-----------------------[]------E-----E-E-E------------EE-
XXXXXXXXXXXXXXXXXXX-XXXXXXXXXXXXXXXXXXXX--XXX---XXXXXXXXXXXXXXXXXXXXXXXXXXXXXXXXXXXX---XXXXXX---XXXXXXXXXXXXXXX-XXXXXXXXXXXXXXXXXXXXXXXXXXXXXXXXXXXXXXXXXXXXX---XXXXXXXXXXXXXXXXXX--XXXXXXXXXXXXXXXXXXXXXXXXXXXXXXXXXXX---XXXXXXXXXXXXXXX-XXXXXXXXXXXXXXXXXXXXXXXXXXXXXXXXXXX----XXXXXXX
