----------------------------------------------------------------------------------------------------------------------------------------------------------------------------------------------------------------------------------------------------------------------------------------
----------------------------------------------------------------------------------------------------------------------------------------------------------------------------------------------------------------------------------------------------------------------------------------
----------------------------------------------------------------------------------------------------------------------------------------------------------------------------------------------------------------------------------------------------------------------------------------
----------------------------------------------------------------------------------------------------------------------------------------------------------------------------------------------------------------------------------------------------------------------------------------
----------------------------------------------------------------------------------------------------------------------------------------------------------------------------------------------------------------------------------------------------------------------------------------
----------------SSS----------SSSSSSSSSS--SSS--------SSSS----------------------------------SSSSSS----------------SSSSSSSSSS-----S---S--------SS--------------------------?-SS-------------SSS-----------------------------------X----------------S-----------------------------X---------
-----------------------------------------------------------------------------------------------------------------------------------------------------------------------------------------------------------------------------------------------------------------------------XX---------
------------------------------------------------------------------------------------------------------------------------------------------------------------------------------------------------------------------------------------------------X----------------------------XX---------
----------------XE------------------------------------------------------XE---------------------------------E------EE-----------------------------------------X------------EX-------------------------------------------------------------------XX-----------SS--------------XXX---------
<E---E----------X--------------SSSSSSS-------------------E--------------X-------------E--SS--SSS----------<>------SSS--------------X----------------Q-------XX------------XXX--------XX----------XX----------------Q-------S-----E-------------XX-----------XQ--------------XXXX--------
<>--<>---X-----XX----X-----E----------------------------<>-------E-----XX----X-------<>-------------------[]-----------E---------------E--------------------XX---------E-------E----X------------XX-----------------------------<>-------X----XXX----X------X-------------XXXXXXX-X-----
[]--[]------XXXXX----XX---<>------------------<>--------[]----------XXXXX----XX------[]-------------------[]----------------------X---<>------------------XXXXX-------XX-------X--------X--------XX-----------------------------[]------------XXX----X------]-------------XXXXXX--------
[]--[]------XXXXX----XX---[]------------------[]E-------[]----------XXXXX----X-------[]---------------E---[]----------------------X-E-[]-X----------------XXXXX-------XX--------------------XXX--XX----------E------------------[]-EE------E-XXXX----X------]-------------XXXXXX--------
XXXXXXXXXXXX---XX---XXXXXXXXXXXXXXXXXXXXXXXXXXXXXXXXXXXXXXXXXXXXXXXXXXXXXX-XXXXXXXXXXXXXXXXXXXXXXXXXXXXXXXXXXXXXXXXXXXXXXXXXXX-XXXXXXXXXXXXXXXXXXXXX-XXXXXXXXX----XXXXXXX-----XX-----------------XX-XXXXXXXXXXXXXXXXXXXXXXXXXXXXXXXXXXXXXXXXXXXXXXXX---XXXXXXXXXXXXX-XXXXXXX-X-X----X---
