----------------------------------------------------------------------------------------------------------------------------------------------------------------------------------------------------------------------------------------------------------------------------------------
-------------------------------------------------------------------------------------------------------------------------------E----SS-----S------------------------------------------------S-------------------------------------------------------------------------------------------
-------------------------------------------------------------------------------------------------------------------SSSSSSSSS--<>----SS----SS------------------------------------------------SS----SS------------------------------------------------------------------------------------
-------------------------------------------------------------------------------------------------------------------SSSSSSSSSSSSS----SS---SSS----------------------------------SSSSSSSS------S-----SS------------------------------------------------------------------------------------
-------------------------------------------------------------------------------------------------------------------SSSSSSS----SS----SSS-SSSS-----------------------------------SSSSSS--------S----SS------------------------------------------------------------------------------------
------------------------------------------------------------SSSSSSSS-----------------XXX------------------------?--SSSSSSSS--SSS----SS----SS---------------------------------SSSSSSSS--S----S-----SS------------------------------------------------------------------------------------
-----------------------------------------------------------------------------------------------------------------E------------------------------------------------------E---------------------------------------------------------------------------------------------------------------
------------------------------------------------------------------------------------------------------------------------------------------------------------------------X---------------------------------------------------------------------------------------------------------------
----------------E---------------------------------------------------------------------------------------------------E---------------------------------------------------------------------------------------------------------------------E---------------------------------------------
---------------<>----------E---------------------------S------SSS---Q----------------------------------------------?SSSSSS----E----E-----XX---------------XX--------------E--SSSSSSS---------------------S---QQ----------------------Q---<>-----E----------------E----------E----------E
---------------[]---------<>---------------------------------------------------E-------------------------------------SSS---------------------------------XXX-------------<>--------------------E-----------------------------------------[]----<>---E-----------<>---------<>---E--E--<>
---------------[]---------[]--------------------------------------------------<>-X-----------------------------------S------------<]-----XX--------------XXXX------------[]--X----------------<>-------------------------------X---------[-----[]--<>-----------[]---------[]-----<>--[]
----E----------[]---------[]-------E-E----------------------------------------[]-X------------E----E----------E-------------------[]E-E--XX-----------XXXXXX-------------[]------E--------EEE-[]-----------------------------X-X---------[-----[]--[]-----------[]---------[]-----[]--[]
XXXXXXXXXXXXXXXXXXXXXXXXXXXXXXXXXXXXXXXXXXXXXXX----XXXXXXXXXXXXXXXXXXX--XX--XXXXXXXXXXXXXXXXXXXXXXXXXXXXXXXXXXXXXXXXXXXXXXXXXXXXXXXXXXXXXXXXXXXXXX---XXXXXXXXXXXXXXXX-XXXXXXXXXXXXXXXXXXXXXXXXXXXXXXXXXXXXXXXXXXXXXXXXXXXXXXXXXXXXXXXXXXXXXXXXXXXXXXXXXXXXXX--XXXXXXXXXX-X-XXXXXXXXXXXXX
