----------------------------------------------------------------------------------------------------------------------------------------------------------------------------------------------------------------------------------------------------------------------------------------
----------------------------------------------------------------------------------------------------------------------------------------------------------------------------------------------------------------------------------------------------------------------------------------
----------------------------------------------------------------------------------------------------------------------------------------------------------------------------------------------------------------------------------------------------------------------------------------
----------------------------------------------------------------------------------------------------------------XE----------------------------------------------------------------------------------------------------------------------------------------------------------------------
---------------------------------------------------------------------------------------------------------------->XXXXXX-----------------------------------------------------------------------------------------------------------------------------------------------------------------
------------------------------------------------------------------------------------SSSSS--SS--------------SSS--S-----------------------------XX------------------------------------------------------------------------------XX-------------------------XXX-----------?SSS-----XXX-----
----------------------------------------------------------------------------------------------------------------------------------------------------------------------------------------------------------------------------------------------------------------------------------------
----------------------------------------------------------------------------------------------------------------------------------------------------------------------------------------------------------------------------------------------------------------------------------------
-------------------------------------------------------------------------------------------------------------------------------------------------------------------------------------------------------------------------------------------------------------XXXXX--------------------XX
---------------X----------------------------E----------------E----------E-------------SSS-----------------------XQQQ--------------EXXX----XX----------------------SSSSSS--------------------------------------------------SS-------------------Q-------SS---------------SS--------------
---------------X---------------------------<>------E--E-----<>---------<>---E-------------------------X----------------E-----XXXXXXXX----------------------------------------------------------E--E------E----------E----E-----------------------------------X----------------------X--S
--------------XX---------------------------[]-----<>--------[]---------[]---------XX----------------X-X---------------<>----------XXX-----XX-XX---------X-------------------------------------<>-<-----------------<>-------------------------------------------------------------------
-----------E--XX---------------------------[]-----[]--------[]---------[]---------XX------------------X---------------[]-------X---XX------X-----EEEE---X--------EEE--------------------------[]--]-----EE----E----[]-----E--------------E------------------XX--------------------------
XXXXXXXXXXXXXXXXXXXXXX--XXXXXXXXXXXXXXXXXXXXXXXXXXXXXXXXXXXXXXXXXXXXXXXXXXXXXXXXXXXXXXXX--XXXXXXXXXXXXXXX----XXXXXX--XXXXXXX----------------XXXXXXXXXXXXXXXXXXXXXXXXXXXXXXXXXXXXX--XXXXXXXXXXXXXXXXXXXXXXXXXXXXXXXXXXXXXXXXXXXXXXXXXXXXXXXXXXXXXXXXXXXXXXXXX------XX-XX-----------------
