----------------------------------------------------------------------------------------------------------------------------------------------------------------------------------------------------------------------------------------------------------------------------------------
----------------------------------------------------------------------------------------------------------------------------------------------------------------------------------------------------------------------------------------------------------------------------------------
----------------------------SSSSSSSSSSSSSSSSSSSSSSSSSSSSSSSSSSSSSSSSSSSSSSSSSSSSSSSS----------------------------------------------------------------------------------------------------------------------------------------------------------------------------------------------------
-------------------------------------------------------------------------------------------------------------------------------------------------------------------------------------------------------------------X--------------------------------------------------------------------
------------------------------------------------------------------------------------------------------------------------------------------------XX-----------------------------------------------------------------X--------------------------------------------XXXX--------------------
Q---------------------------SSS--------------------------SSS----S-------------------------------------------------------------------------------------------------SXXX---------------------------------------------X-S----------------------------XXX----S-------------------------X----
-----------------------------------------------------------------------------------------------------------------------------------------------------------------------------------------<>-----------------------XX--------------------------------------------------------------------
---------------------------------------------------------------------------------------------------------------------------------------------------------------------------------------XXX------------------------XX--------------------------------------------------------------------
---------------------------------------------------SS--------------------------------------------------------------------------------------------------------------------------------XXXXX----------------------X-XX---------------XX---------------------------------------------------
-------------XXXXX----------SSSS---------------XX------XSSSS---SSSS---------E----------------------XX-------------------------XXX-----------XQQ---------------EXXX-------------------XXXXX---------------------XX-X--------------------------X--------------XXQQ------------XXXXXX------
-----------------------------------E---------XXXX------X-------------------<>----------------------XX----------------------------------------------------XXXXXXXX-----------------XXXXXXXX--------------------XXXXXX-----E-----------------------------------------------XXXX-----------
-------------X--------------------<>--------XXXXX------X----------------<>-XX----------------------XX----------------------------------------------------------------------------XXXXXXXXX--------------------XXXXXX----<>-----[--------------------------------------------------------
----------------------------------[]-------XXXXXX------XE-----E---------[]-XX----------------------X-----------------------------------------------------------------------------XXXXXXXXX------E--E-E--EE--XXXXX-XX----[]-----E--------------------------------------------------------
---XX----XXXXX--------------XXXXXXXXXXXXXXXXXXXX---XXXXXXXXXXXXXXXXXXXXXXXXX--XXXXXXXXXXXXXXXXXXXXXXXXXX---XXXXX---X----XXXXX---------------XX-------XXXX------XXX---XXXXXXXXX---XXXXXX--XXXXXXXX-X-XXXXXXXXXXXXXXXXXXXXXXXXXXXXXXX----XXX----------------------------------------------
