----------------------------------------------------------------------------------------------------------------------------------------------------------------------------------------------------------------------------------------------------------------------------------------
----------------------------------------------------------------------------------------------------------------------------------------------------------------------------------------------------------------------------------------------------------------------------------------
---------------------------------------------------S--------------------------------------------------------------------------------------------------------------------SSSSSSSSSSSSSSSSSSSSSSSSSSSS----------------------------SSSSSSSSSSSSSSSSSSSSSSSSSSSS----------------------------
-------------------------------------------------------------------------------------------------------------------------------------------------------------------------------------------------------------E------------------S-------------------------------------------------------
-------------------------------------------------------------------------------------------------------------------------------------------------------------------------------------------------------------XXX-------------------------S?---------------------------------------------
---------------X---------------S-SSSSSSS--------------SS-----------------X------------------------------------XX--------------------------------------------------------SSS--------------------SS---------------------------------------------------------------------------------------
---------------XX------------------------------------------------------XXX--------------------------------------------------------------------------------------------------------------------------------------------------------------------------------------------------XXX---------
--------------XXX-----------------------------------------------------XXXX----------------------------------------------------XX-----------------------------------------------------------------------------------------------------------------------E--------------------XXX---------
-------------XXXX----------------------------------------------------XXXXX---------------------------------------------------XXX---------------------------------------------------------------SS--------SS---------------------E---------E-----------<>--------------------XXX---------
-------------XXXX---------------SSSSSSS------------------------------XXXXX---------E----------------------SSSSSS-------------XXX---------------------------------S--S---SSSS---------------XX------------------E--QQQ---------E->--S-----[]---------E-[]---X--------Q-X-----XXX---X-----
----------XXXXXXX----------E--E-----------------------------------X-XXXXXX--------<>--------------------------------------XXXXXX-----------<-----------------------------------E---------X-XX--------------------------------<>-SSSSS----[]--------<>-[]---X-------------XX-XXX---X-----
---------XXXXXXXX---------<[------------------->-----------------XXXXXXXXX--------[]-------------------------------------XXXXXXX-----------[----------------------------------<>--------XXXXX--------------------------------[]-SS?SS----[]--------[]-[]---X------------XXXXXXX---X-----
-E-E----XXXXXXXXX---------[[---------E--------E]-----------E-----XXXXXXXXX--------[]-------E-EE-------------------------XXXXXXXX--------E--[----------------------------]-----[]-------XXXXXX----------------E---------------[]-SSSS--ES-[]--------[]-[]--XXEE-E--------XXXXXXX---X-----
XXXXXXXXXXXXXXXXXX-----XX--XXXXXXXXXXXXXXXXXXXXXXXXXXXXXXXXXXXXXXXXXXXXXXXX--XXXX-XXX-XXXXXXXXXXXXXXXXXXXXXXXXXXXXXXXXXXXXXXXXXXXXXXXXXXXXXX-------XXXX--XXXXXXXXXXXXXXXXXXXXXXXXXXXXXXXXXXX----XXXXXXXXXXXXXXXXXXXXXXXXXXXXXXXXXXXXXXXXXXXXXXXXXXXXXXXXXXXXXXXXXXXXXXXXXXXXXXXXXXXXXXXX
