----------------------------------------------------------------------------------------------------------------------------------------------------------------------------------------------------------------------------------------------------------------------------------------
X---------------------------------------------------------------------------------------------------------------------------------------------------------------------------------------------------------------------------------------------------------------------------------------
------------------------------------------------------------------------------------------------------------------------------SSSSSS--SSSS----------------------------------------------------------------------------------------------------------------------------------------------
----------------------------------------------------------------------------------------------------------------------------------------------------------------------------------------------------------------------------------------------------------------------------------------
------------------------------------------------------------------------------------------------------------------------------------------------------------------------------------------------------------X---------------------------------------------------------------------------
--------------------------------------------XXX------------------------------------------------?SSS-------------S---------------------SSS-------------------------------------------------S---------X-------E--------XXS------------------QQQQQ---------SSSS--X-------------------------
-------------------------------------------XXXX-------------------------XXX-------------------------------------------------------------------------------------------------------------------------------------------------------------------------------------------------------------
------------------------------------------XXXXX-----------------------------------------------------------------------------------------------------------------------------------------------------------------------------------------------------------------------------------------
----------------E------------------------XXXXXX--------------------------------------XSSSSSSS-----------------E------------------------SS-----------------------------------------------------------X-XXXX------------------------------------------------------------------------------
-----E---------<>---------------------XX-XXXXX----X------------------------------QQ------------SSSSS---------<>-SQQQ--------------XXX----------------------X------------QQQ---------------XX--------------------XXX----------X--------Q---QQQQQQQQ--------------------------------------
----<>---------[]----X----------------XXXXXXXX----X----------------------------------------------------------[]--------E---------XXXX----------------------X--------------------------XXX-----------------------------------XXXX------------------------------------------------------E-
----[]---------[]----<>----->--------XXXXXXXXX----X-----XXX--------------------------------------------------[]-------<>--------XXXXX--------------------XXX-----------------------------------------------------------------XX------------------------------------------------------<>-
EE--[]-----E-E-[]----[]-----EE-E-----XXXXXXXXX----------XX-----EE--------------E-EE--------------------------[]-------[]-------XXXXXX-----------------XXXXXX--------------------------------------------------------------E-----------------------------------------E---E------------[]-
XXXXXXXXXXXXXXXXX--XXXXXXXXXXXXXXXXXXXXXXXXXXXX---------XXXXXXXXXXXXXXXXX---XXXXXXXX---XXXXXX---XXXXXXXXXXXXXXXXXXXXXXXXXXXXXXXXXXXXX---XXXXXXXXX--XXXXXXXXXXXXXXX--XXXXXXXXXXX---XXXXXXXXXXXXXXXXXX-------X--------XXXXXXXXXX--XXXXXXXXXXXXXXXXXXX---------XXXXXXXXX-XXXXXXXXXXXXXXXXXX
