----------------------------------------------------------------------------------------------------------------------------------------------------------------------------------------------------------------------------------------------------------------------------------------
-------------------------------------------------------------------------------------------------------------------------------E-----------S--------------------------------------------------------------------------------------------------------------------------------------------
--SSSSSSS-----S-----SSSS--SS--------------------------------------------------------------------------------------------------->-----S-----S----------------------------------------------------------------------------------------------------------------SSSSSSSSSSSSSSSSSSSSSSSSSSSS
--SSSSSSSSSSSSS-----S-----SS--------------------------------------------------------------------------------------------------[]-----S---S-S------E-------<>----------------------------------------------------------------------------------------------------------------------------
---SSSSSSSSSSSS-----SS----SS---------------------------------------------------------------------------------------EE---------[]-----S---SSS-------XX-----[]---------------------------------------------------------E------------------------------------------------------------------
---SSSSSSSSSSSSS----------SS--XX-------------------------------------------------XXX----------------------------?--SSS??S--------??SSS------X------------SS---XXXXX---------------------------------------------XXX---------------------------------------------------------------------
EE-------------------------------------------------------------------------------------------------------------------------------------------------------------------------------------------------------------------XXXXXXXX-----------------------------------------------------------
-------------------------------------------------------------------------------------------------------------------E---------------------------------------------------------------------------------------------------------------------------------------------------------S----------
----E-------------------------------------------------------------------------------------------------------------EX------------------------XXXXXXX--------------------S------------------------------------------------------XX--------------------------------------------XSSS--------
--E-SSSSSSSS-----------------------------------------------------------------SSSSSS------QQ--ES-----E------------XXXXS-------XX----X-X---XXX------------XXX------------------------------------------------------------------------------Q------E-----------<>------SQS------X----X-----
--E--------------------E---------------------------------------------------------------------------<>-----------------SE---EX------------XX-------------------------XXXX-----------------------------XX----------------------------------------<>-----------[]---------------]----X----E
-SS--X----------------<>---------------------------------------------------------------------------[]----------------SSX--------X--------XX---------------------------------------------------------XXXX---------------------------------------[]---------XX[]----------XXXX[]-X--X---<>
-[]------E--------EEE-[]------E-------E-E------------E---------E-----------------------------------[]-E-------------------------X---X-X--XX---------------------------------------------------------XXXX---------------------------------------[]---------XX[]----E-----XXX-[]----X---[]
XXXXXXXXXXXXXXXXXXXXXXXXXXXXXXXXXXXXXXXXXXXXXXXXXXXXXXXXXXXXXXXXXXXXXXXXXXXXXXXXXXXXXXXXXXXXXXXXXXXXXXXXXXXXXXXXXX----XXX-------XXXXXXXXXXX-----------------XXXXXXX-----XXXXXXXXXXXX--XXXXXXXXXXXXXXX------XXXX-----------------XXXXXXXXXXXXXXXXXXXXXXXXXXXXXXXXXXXXXXXXXXXXXX----XXXXXX
