----------------------------------------------------------------------------------------------------------------------------------------------------------------------------------------------------------------------------------------------------------------------------------------
----------------------------------------------------------------------------------------------------------------------------------------------------------------------------------------------------------------------------------------------------------------------------------------
----------------------------------------------------------------------------------------------------------------------------------------------------------------------------------------------------SSSSSSSSSSSSSSSSSSSSSSSSSSSS--------------------------------------------------------
----------------------------------------------------------------------------------------------------------------------------------------------------------------------------------------------------------------------------------------------------------------------------------------
----------------------------------------------------------------------------------------------------------------------------------------------------------------------------------------------------------------------------------------------------------------------------------------
--------------------------------------------------------------------------X---------------------------------------X----------------------------------------------------------------------------XX-----------------------------------------------------------X---------------------------
-------------------------------------------------------------------------XX----------------------------------------------------------------------------------------------------------------------------------------------------------------------XXX------------------------------------
-----------------------------------------------------------------------XXXX-------------------------------------------------------------------------------------------------------------------------------------------------------------------------------------------------------------
----------------------------------------------------------------------XXXXX---------------------------------------------------------------------------E---------------------------------------------------------------------------------------------------E-----------------E-----------
--------------------------------------------------SS------------------XXXXX-------------------------------------------------X--------------------S---<>-----E-------------------------XXX--------------S----SQS------------------X-----------------------QQS-----E---------<>----------E
--------------------------------------E-----E------------------------XXXXXX------------------------------------------------XXX-----------------------------<>---E------------------------------------------------------X---------X------------------------------<>---------[]------E--<>
-------------------------------------<>-----------------------------XXXXXXX------------------------------------------------XXX-----------------------[-----[]--<>---------------------------------------------------<>-XX-------XXXX----------------------------[]---------[]-----<>--[]
---------E-----------------------E---[]---------------------------XXXXXXXXX-------------------------------------------E-EXXXX---------E-EE-E---------E-----[]--[]----X-X----------------------------E-----E---------[]-X--------XXXX----------------------------[]---------[]-----[]--[]
XXXXXXXXXXXXXXXXXXXXXXXXXXXXXXXXXXXXXXXXXXXXXXXXXXXXXXXXXXXXXX-XXXXXXXXXXXXX----XXXXXXXXXXXXXXXXXXXXXX----------XXXXXXXXXXXXXXXXXXXXXXXXXXXXXXXXXXXXXXXXXXXXXXXXXXXXXXXXXXXXXX--XXXXXX-----X-----XXXXXXXXXXXXXXXXXXXXXXXXXXXXXXXXXXXXXXXXXX--XXXXXXXXXXXXXXX-XXXXXXXXXXXXXXXXXXXXXXXXXXX
