----------------------------------------------------------------------------------------------------------------------------------------------------------------------------------------------------------------------------------------------------------------------------------------
----------------------------------------------------------------------------------------------------------------------------------------------------------------------------------------------------------------------------------------------------------------------------------------
----------------------------------------------------------------------------------------------------------------------------------------------------------------------------------------------------------------------------------------------------------------------------------------
----------------------------------------------------------------------------------------------------------------------------------------------------------------------------------------------------------------------------------------------------------------------------------------
-----------------------------------------------------------------------------------------------------------------------------------------------------------------------------------------------------------------------------------------XXX--------------------------------------------
-SSSSSSSSSSS-------------------------------------------------------------XX---------X-----------SSS----------S--S---------------------SSS--------------------------------------QQQQQQ-----------SSSS-------SQQSS-------------------------------------------------------------XX---------
-----------------------------------------------------------------------XXXX-------------------------------------------------------------------------------------------------------------------------------------------------------------------------------------------------XXX---------
----------------------------------------------------------------------XXXXX------------------------------------------------------------------------------------------------------------------------------------------------------------------------------------------------XXXX---------
-----------------------E---------------------------------------------XXXXXX---------XXXXX---------------------------------------------------------------------------------------------------------------------------------------------------------------------------------XXXXX---------
----SSSSSSS-----------<>----------------X-------------------------X--XXXXX-----------------S?---SSS-------------QQQQ--------------XXX---------------------XXX----------------QQ---QQQ--?------------------SSS--SSSS----------<>----------------Q----------E-----------X--XXXXXX---------
--E-------------------[]---------------XXX------------------------XXXXXXXX----------------------------------XXXX-------E------XXXXXXX--------------------XX--------------<>--------------------------------------------------[]-----------E--------------<>-----------X-EXXXXXX---------
------------------X---[]---------------XXX-----------------------XXXXXXXXXX-------------------------------------------<>--------XXXXX--------------------XX--------------[]--------------------------------------------------[]----------<>--------------[]-----------XXXXXXXXX---------
------------------E---[]------------EXXXXX----------EE-E---------XXXXXXXXXX-----E-------------------------------]-----[]-------XXXXXX------------------X------------E-EE-[]---------------EE---------------------------EE-E--[]----------[]--------------[]-----------XXXXXXXXX---------
XXXXXXXXXXXXXXXXXXXXXXXXXXXXXXXXXXXXXXXXXX-X--XXXXXXXXXXXXXXX---XXXXXXXXXXXXXXXXXXXX----XXXXXXX----XXXXXXXXXX---XXXXXXXXXXXXXXXXXXXX----XXXXXXXXXXX---XXXXX---XXXXXXXXXXXXXXXXXXXXXXXXXXXXXXXXXX-XXXXXXXXXXXX---XXXXXXXXXXXXXXXXXXXXXXXXXXXXXXXXXXXXXXXXXXXXXXXXXX--XXXXXXXXXXXXXX-XXXXX
