----------------------------------------------------------------------------------------------------------------------------------------------------------------------------------------------------------------------------------------------------------------------------------------
----------------------------------------------------------------------------------------------------------------------------------------------------------------------------------------------------------------------------------------------------------------------------------------
----------------------------------------------------------------------------------------------------------------------------------------------------------------------------------------------------------------------------------------------------------------------------------------
----------------------------------------------------------------------------------------------------------------------------------------------------------------------------------------------------------------------------------------------------------------------------------------
-----X----------------------------------------------------------------------------------------------------------------------------------------------------------------------------------------------------------------------------------------------------------------------------------
----------------------XXXX-----------------------------X------------------------XXX-------------------------------------------------------------------------------------------SQQQQQQ-------------------------------------SSSS--------------------E------------SSS-SS-----SS-----SSSSSSS
-------------------------------------------------------------------------------------------------------------------------------------------------------------------------------------------------------------------------------------------------<>-------------------------------------
-------------------------------------------------------------------------------------------------------------------------------X-----------------------------------------------------------------------------------------------------------------XX-------------------------------------
-----------------------------------------------------------------------------------------------------------E------------------XX-----------------E----------E----------------------------------E-----------------------------------------------XXXX-----------EE------------------------
X-Q---------------XX---------------------------------------------------X-----------------QQ---------E-----<>-------------------------------E----<>---------<>-------------E--QQ--SQQQ---------<>------Q---------------XX----------------------XXXXX----------?SSSS--------E-------------
-------------XXX-----------------------------------------------------------------------------------<>-----[]--E------------XXXXX----------<>----[]---------[]----X-----E-<>-------------------[]---------------------------------------------XXXXXX----------------E--------------------
---------------------------------------------------------------------X-----------------------------[]-----[]--------------XXXX-X-----------[----[]---------[]----<>----X-[]-------------------[]---------------------------------------------XXXXXX-------------------------X-X---------
-------------------------------------------------------------------EEX-----------------------------[]-----[]------------XXXXXXXX--------E-[[-E--[]-----E-E-[]----[]----X-[]----------------E--[]------------------------------------------XXXXXXXXX-----E---------------------X---------
---------XX-------------------XXXXXXXXXXXXXXXXXX----XX-XXXXXXX--XXXXXXX---XXXXXXXXXXXXXXXXXXXXXXXXXXXXX-XXXXXXXXXXXXXXXXXXXXXXXXXXXXXXXXXXXXXXXXXXXXXXXX-XXXX---XXXXXXXXXXXXXXXXXXXXXXXXXXXXXXXXXXXX--------XXXX---XXXXXX-----XXXXXXXXX--XXXXXX--XXXXXXXXXXXXXXX-XXXXXXXXXXXXXXXXXXXXXXX
