----------------------------------------------------------------------------------------------------------------------------------------------------------------------------------------------------------------------------------------------------------------------------------------
------------------------------------------------------------------------------S---------------------------------------------------------------------------------------------------------------------------------------------------------------------------------------------------------
--------------------------------------------------------SSSSSSSSSSSSSSSSSSSSSSSSSSSS----------------------------------------------------------------------------------------------------------------------------------------------------------------------------------------------------
--------------------------------------------------------SSSSSSSSSSSSS--------SSSS-SS----------------------------------------------------------------------------------------------------------------------------------------------------------------------------------------------------
--------------------------------------------------------SSSSSSSSSS?-----------SSS-SS---------------------------------------------------------------------------------------------XXX----------------------------------------------------------------------------------------------------
------------------SS-------------------SS---------------SSSSS-SSSS---S------------S--------------------------------------------E------------------------------------------------------------------------------------XXX---------SS----------------X--------------SSQQQQQQQQ------------S
------------------------------------------------------------------------------------------------------------------------------E------------------------------------------------------------------------------------XXXX--------------------------XX-------------------------------------
------------------------------------------------------------------------------------------------------------------------------XXXXXX-------------------------------------------------------------------------------XXXX--------------------------XX-------------------------------------
--XXX----------------------------------------------------?---------------------SS-------------------------------------------X-------------------------------------------------S-S---------------------------------XXXXX---------SS-------------XXXX-------------------------------------
------------XXX---------------E--QQ--S?-----E-----------SSSSSSSSSSS--------E?------X---------------------------------------XX------------------------------X--------------------------QQ----------------------X--XXXXXX-------------------------XXX---------------SS?-QSSSQQ------------
-----------------------------<>------------<>---E-------X--SSSSSSS--------<>X------X----------------E----------------------XXX-------E------------------XX------------------------E---------------------------X-EXXXXXX-----------------------XXXXX-------------------------------------
-----------------------------[]--X---------[]------------]SSSSSSSSS-----<X[]X------X---------------<>---------------------XSS-------<>-----[-----------XXX-----------------------<>----------------->---------XXXXXXXXX-------XX]------------XXXXXX-------------------------------------
-----------------------------[]------------[]-EE--------ESSSSSSSSS------[][]X----XXX----EE----E----[]------------EE-EEE-XXXXX-EE----[]--EE-[-----------XXX----------E------------[]-----------------EE-E------XXXXXXXXX-------XX]-----------XXXXXXX----------------------------E--------
XXX---XXXX-X--XXXXXXXXXXXXXXXXXXXXXXXXXXXXXXXXXXXXXXXXXXXXXXXXXXXXXXXXXXXXXXXXXXXXXXXXXXXXXXXXXXXXXXXXXX--XXXXXXXXXXXXXXXXXXXXXXXXXXXXXXXXXXXXXXXXX---XXXXX---XXXXXXXXXXXXXXXXXXXXXXXXXXXXX------X-XXXXXXXXXXXXXXXXXX------X----XXXXXXXX-XXXXXX-------------XXXXXXXXXXXXXXXXXXXXXXXXXX--
