----------------------------------------------------------------------------------------------------------------------------------------------------------------------------------------------------------------------------------------------------------------------------------------
----------------------------------------------------------------------------------------------------------------------------------------------------------------------------------------------------------------------------------------------------------------------------------------
----------------------------SSSSSSSSSSSSSSSSSSSSSSSSSSSS------------------------------------------------------------------------------------SSSSSSSSSSSSSSSSSSSSSSSSSSSS----------------------------------------------------------------------------------------------------------------
---------------------------------------------------------------------------------------------------------------------------------------------------------------------------------------------------------------------------------------------------------------------------X------------
---------------------------------------------------------------------------------------------------------------------------------------------------------------------------------------------------------------------------------------------------------------------------X------------
-----------------------------S-------------------------------------?SSS----------------------------------------------------------------------------------------------------------------------------------------------S-----------------------------------------------------X------------
--------------------------------------------------------------------------------------------------------------------------------------------------------------------------------------------------------------------------------------------------------------------------XX------------
---------------X-------------S-------------------------------------------------------------------------------------------------------------------------------S-----------------------------------------------------XX----------------------------------------------------XXX------------
--------------XX----------------------------------------XXXXXX--------------------XX-------------------------------------------------------------------------XXS-----------------------------------------E---------X-----------------E----------E-----------------------XXXX------------
--------------XXX-----------SSSS----S-S------X-XX------X--------?---SSS----------X-----------------------------------------------SSSS-------SS------Q-S------X--------------------------------S-------------------------------------<>---------<>----------E-----------XXXXX------------
-------------XXXX-----------[----------------X-XX-X----X------------------------XXXX-----------------XXX------------------------------------[----------------X-X------------------------E----------------E----------E----E-----<----[]---------[]---------<>----------XXXXXX-----E------
-----------XXXXXX--------------------------XXXXXX------X-------------------------------------------XXXXX-------X----------------------------]-------------XX[X-XX----------------------<>---------------<>---------<>---<>-----[----[]---------[]---------[]---------XXXXXXX-----X------
---E------XXXXXXX-----------]-----E-------XXXX-XX------X----------------------------------E-------XXXXXX------XX----------------------------E-----E------XXX[X-X----------E-EE----E----[]----------E-E--[]-----E--E[]---[]-----[----[]---------[]---------[]-E-EE---XXXXXXXX-----X--E---
XXXXX--XXXXXXXXXXXXXXX--XXXXXXXXXXXXXXXXXXXXXXXXX-XXXXXX----XXXX-----XXXXXXXXXXXXX--XXXXXXXXXXXXXXXXXXX---XX--XX-------XXXXX-XXXXXXXXXXXXXXXXXXXXXXXXXXXXXXXXXXXX--XXXXXXXXXXXXXXXXXXXXXXXXXXXXXXXXXXXXXXXXXXXXX-XXXXXXXXXXXXXXX-XXXXXXXXXXX-X-XX-XXXXXXXXXXXXXXXXXXXXXXXXXXXXXXXXXXXXXX
