----------------------------------------------------------------------------------------------------------------------------------------------------------------------------------------------------------------------------------------------------------------------------------------
------------------------------------------------------------------------------------------------------------------------------------------------------------------S---------------------------------------------------------------------------------------------------------------------
--------------------------------------------------------------------------------------------------------------------------------------------SSSSSSSSSSSSSSSSSSSSSSSSSSSS--------------------------------------------------------SSSSSSSSSSSSSSSSSSSSSSSSSSSS----------------------------
--------------------------------------------------------------------------------------------------------------------------------------------SSSSSSSSSSSSSSSS----SSSSSSSS------------------------------------------<-------------S------SS-----------------------------------------------
--------------------------------------------------------------------------------------------------------------------------------------------SSSSSSSSSSSSSSS-----SSSSSSSS------------------------------------------[]------------S------SSS?---------------------------------------------
---------------------------------------------S-----------------------------------------------------------XXXXXXX-----------??SS-------------SSSSSSSSSS---SSS------SSS-SS----------------------------X--SS???ES-------??SSS------SSS----SS-----------------------------------------------
----------------------------------------------------------------------------------------------------------------------------------------------------------------------------------------------------------------------------------------------------------------------------------------
--------------------------------------------E----------------------------------------------------------------------------------------------------------------------------------------------------------E--------------------------------------------------------------------------------
---------------------------------E---------<>----------------------------------E-----------------------------------SS---------------------E--?EE-------------------S?-------------------XX----------X-XX-----------------------------------------------SS-------------------------------
--------------------------------<>---------[]----------------E----------E-----<>---E--------------------SS--S----X----------S------------<>-SSSSSSSSSS---------E?----XXX---------------XXX-------------XX-------XXX----------XX-SSSSS--SSSS--------XX------X----------------------------
------------X-------------------[]---------[]----E----------<>---------<>-----[]--E------------------------------X-----------------------[]----SSSSSSS--------<>----------------------XXXX----------------------------------XXXX-------SS--------X-XX------X----------------------------
------------X-------------------[]---------[]---<>---------------------[]-----[]--------------------------------XXE----------------------[]---SSSSSSSS------XX[]X--------------------XXXXX-----------------------------------X-----S--SSS-------<XXXX------X----------------------------
------------X--------E--E----E--[]-----E---[]---[]-----E----E----------[]-----[]--------------------------------XXX----------------------[]----SSSSSSS------X-[]X--------------------XXXXX------------------------------E-E-----]--E--SS--------[X-XX------X----------------------------
---XXXXXXXXXXXXXXXXXXXXXXXXXXXXXXXXXXXXX-XXXX-XXXXXXXXXXXXXXXXXXXXXXXX-XXXXXXXXXXXXX-------XXXXX-XXXXXXXXXXXXXXX-XXXXXXXX----XXXXXXXXXXXXXXXXXXX-XXXXXXXXXXXXXXXXXXXXXXXXXXXX--XXXXXXXX-------------XX----XXXXXX---XXXXXXXXXXXX-XXXXXXXXXXXXXXXXXXXX--XXXXXX---XXXXX------XXXXXXXXXXXXXX
