----------------------------------------------------------------------------------------------------------------------------------------------------------------------------------------------------------------------------------------------------------------------------------------
------------------------------------------------------------------------------S-------------------------------------------------------------------------------------------------------------------------------------------------------------------------------------------------S-------
----------------------------SSSSSSSSSSSSSSSSSSSSSSSSSSSSSSSSSSSSSSSSSSSSSSSSSSSSSSSS--------------------------------------------------------SSSSSSSSSSSSSSSSSSSSSSSSSSSS--------------------------------------------------------------------------------------------------------SS------
------------------------------S----SSSS-----------------SSSSSSSSSS-SS--------SSSSSSS-----------------------------------------------------------------------------------------------------------------------------------------------------------------------------SSSSSSSSSSS----S------S
-----------------------------------SSSS-----------------SSSSSSSSSS?---------SSSSSSSS---------------------------------------------------------------------------------------E--------------------S-S--------------------------------------------------------------SSSSSSSS--S-----S----SS
-----------------XXX-----------S--SSSSSS--------------SSSSSSSSSSSS---SS--------S--SS----------QQQQQ------XSSSSSS----------------------------------------------------------SSSSSSSS---SSS------SSS-SS------------------------------------------------------------SSSSSSSSSSSS----SS-----S
------------------------------------------------------------------------------------------------------------------------------------------------------------------------------------------------------------------------------------------------------------E---------------------------
--------------------------------------S---------------------------------------------------------------------------------------------------------------------------------------------------------------------------------------------------------------------X---------------------------
----XXX-------------------E-----E-----S------------SS----?-E-------------------SS-----S----SS---------------------------------------------------------E-------------------EE-------------------------------------------------------------------------------------------------------E--?-
-X-----------------------<>----S-SS--SS----------------XSSSSSSSSS----------E?------X-----------SSSSQ--------S---SQQX--------------XX-----------S-----<>-----------------SSSSSS-S-----------E------XX------------------------S------------------------------------SSSSSSSQ---------<>----
-------------------------[]--SE------SS--------<E------X----SSSSSS--------<>-------------------------------------------E----XXX----------------------[]--------<>------X----S-SSS---------<>------------------------------------------------------------------>-------------------[]----
-------------------------[]-SS?S-S---SS--------[]----------SSSSSS-------XX[]X-----------------------------------------XX--------------------SS-------[]--------[]------------SSS--------X-[]-----------------------------------------------------------------[]--X----------------[]----
--X----------------------[]--[]------SS--------[]------X---SSSSSS-------XX[]X------X-------------------------------------------X------------S--------[]--------[]------X------S---------X-[]E-------------------------------------E-------E--------------EE--[]----------------EE-[]----
XXX--XXX---------XXXXXXXXXXXXXXXXXXXXXXXXXXXXXXXXXXXXXXXXXXXXXXXXXXXXXXXXXXXXXXXXXXXXXXXXXXXXXXXXXXXXXXXXX-X---XXXXX-----XXX---XXX--XXX-XXX-XXXXXXXXXXXXXXXXXXXXXXXXXXXXXXXXXXXXXXXXXXXXXXXXXXXXXXXXXXXXXXXXX---XXXXXXXXXXXXXXXXXXXXXXXXXXXXXXXXXXXXXXXXXXXXXXXXXXXXXXXXXXXXXXXXXXXXXXXX
