------------------------------------------------------------------------------------------------------------------------------------------------------------------------X---------------------------------------------------------------------------------------------------------------
---------------------------------------------------------------------------------------------------------------------------------------------------------------------------------------------------S------------------------------------------------------------------------------------
------------------------------------------------------------------------------------------------------------------------------------------------------------------------SSSSSSSSSSSSSSSSSSSSSSSSSSSS------------------------------------------------------------------------------------
------------------------------------------------------------------------------------------------------------------------------------------------------------------------SSSSSSSSSSSSSSSS----SSSS-SSS------------------------------------------------------------------------------------
----------------------------------------------------------------------------------------XX-------------------------E-----------------E-----S----------------------------S-SSSSSSSSSSSSSS----SSSSSSSS------------------------------------------------------------------------------------
-----------------XXXX--------------QQ-SS------------------------------------------------------------------SSSS--?--SSSSSSS-------??S---------------------------------------SSSSSSSSSSSSS----S-----SSX---S?--QQSSSSS------------------------------------------------Q--QQQ---------------
------------------------------------------------------------------------------------------------------------------------------------------------------------------------EE-S------------------------------------------------------------------------------------------------------------
----------------------------------------------------------------------------------------------------------------------------------------------------------------------------------S------------E----E-----------------------------------------------------------------------------------
---XXXX--------------------------------------------E--------------------------------------------------------------EX--------------------------------------------------------E-----S-----------<>----XXX---------------------------------------------------------------------------------
-------------------------X-------SS--SSQ----------<>--------------------------------XQQ---------------EXXX--------XXXS-------EX----------XX---------------------------SS---SSSSSSSSS-------E--[]-----------S?S-SSSSS---------<>--------------------------SSS----E-Q---QQQQ-?QQ----------
-------------------------XXX-<>-------------------[]---------------------------------------------XXXXXXXX-------------SE----X-------------X-------------------------------E--S----S-------<>--[]-----------------------------[]---------------------------------------------------------
-----------------------------[]-------------------[]---------------------------------------------------X--------------X---------X--------XX--XX--------------------------SSSSSS--SS-------[]--[]-----------------------------[]------------------------------------------------------X--
-----------------------------[]---------------E---[]-----EE-------EEE-EE------E-------------------------------------------------X---XXX---X--------------E---------------S]------ES-------[]--[]-----------------------EE-E--[]--------EE--------------E-----------------------E-----[]-
XXX----X--------XXXXXXXXXX--XXXXXXXXXXXXXXXXXXXXXXXXXXXXXXXXXXXXXXXXXXXXXXXXXXXXXXXXXXX----XXXXXX----XXXXX---XXXXX----XXX-------------------X----XXXXX--XXXXXXXXXXXXXXXXXXXXXXXXXXXXXXXXXXXXXXXXXXXX--XXXXXXXXX-XXXXXXXXXXXXXXX-XXXXXXXXXXXXXXXXXXXXXXXXXXXXXXXXXXXXXXXXXXXXXXXXXXXXXXXX
