----------------------------------------------------------------------------------------------------------------------------------------------------------------------------------------------------------------------------------------------------------------------------------------
----------------------------------------------------------------------------------------------------------------------------------------------------------------------------------------------------------------------------------------------------------------------------------------
----------------------------------------------------------------------------------------------------------------------------------------------------------------------------------------------------------------------------------------------------------------------------------------
-------------------------------------------------------------------------------------------------------------------------------------------------------------------------------------------------------------------X--------------------------------------------------------------------
----------------------------------------------------------------------E--------------------------------------------------------------------------------------------------------------------------------------------X--------------------------------------------------------------------
-----------------------------------------------XXXXSSS--------E----------E-----------------------S--------------------------------------------------QQQQQQQ---------SSSS-----SSSSSSSS------------------------------X-S------------------------------------------------------S-----------
-----------------------------------------------------------XXXXXX------------XXXXX--------------------------------------------------------------------------------------------------------------------------------XX--------------------------------------------------------------------
-----------------------------------------------------------------------------------------------------------------------------------------------------------------------------------------------------------------XXX--------------------------------------------------------------------
------------------------------XXXX----------------------------------------------------SSS------------------------------------------------------------------------------------------------------E----------------XXXX--------------------------------------------------------E-----------
----------------------------------------XXX---------------------------XXXXXSS------Q------------SS-----------------------------------------S-------S?-QSSSQQ-----------------SSSSSSS----------<>---------------XXXXX----------------------------X----------------E---------<>----------E
--------------------------------------------------------------------------------------------------------------------------------------------------------------------------?-------------------[]--------------XXXXXX-----E-----<---------E-----XX---------------[]---------[]-----[]--<>
------------X-------------------------------------------XXXX-----------------------------------------------------XX------------------------------------------------------SS-------------------[]--------------XXXXXX-----X-----[--------------XXX-----X---------[]---------[]-----[]--[]
--------E-XXX-----------EE-E-----------------------------------------E-------------------------------------------------------E---------E-----------------------E--------------------------E---[]-----E-EE---XXXXXXXX-----X-----[EE-----------XXXX------------E--[]-----E-E-[]-----[]--[]
XXXXXXXXXXXXXXXXXXXXXXXXXXXX------XXXXX-----XXXXXXXX----------------XX-----XXXXXXXXXXXXXXXXXX---XXXXXXXXXXXXXX--XX---XXXXX--XXXX----XXXXXXXXXXXXXXXXXXXXXXXXXXXXXXXXXX--XXXXXXXXXXXXXXXXXXXXXXXXXXXXXXXXXXXXXXXXXXXXXXXXXXXXXXXXXXXXXXXXXXXXXXXXX--XXXXXXXXXXXXXXXXXX-XX---XX-XXXXXXXXXX
