----------------------------------------------------------------------------------------------------------------------------------------------------------------------------------------------------------------------------------------------------------------------------------------
-----------------------------------------------------------------------E----------------------------------------------------------------------------------------------------------------------------------------------------------------------------------------------------------------
----------------------------------------------------------------------<>-----------------------S--S-------------------------------------------------------------------------------------------------------------------------------------------------------------------------------------
----------------------------------------------------------------------[]-----------S----------------------------------------------------------------------------------------------------------------------------------------------------------------------------------------------------
-----------------------------------------------------------EE---------[]-----E-----S----------------------------------------------------------------------------------------------------------------------------------------------------------------------------------------------------
---------------XXS--------------------------------------X--SS???E--------??SSS------S-S----S-----S---------S------------------------------------------------------XXXX------------S----------------------------SSSS---------------------------------------------------------------------
--------------XXX----------------------------X----------------------------------------------------------------------------------------------------------------------------------------------------------------------------------------------------XX------------------------------------
-------------XXXX---------------------------XXX------------E----------------------------------------------------------------------------------------------------------------------------------------------------------------------------------------------------------------XXXX--------
------------XXXXXE-------------------------XXXX---------X-XX-----------------------------------------------------------------------------------------------------------------------------------E-----XSSS-------------------------------------------------------------------------------
-----------XXXXXX----------E--------------XXXXX----------XXXXS-------XX----X-X---XX-SSSSS-------------XXX-----------------------------------------------------X---------------S---------E-----<>-----------S?--SSSSS-------------X----------------------S?SS----------------------------
---------XXXXXXXX----X----<>-------------XXXXXX---------------SE---EX------------XXX-------E----------XX------------------E-----E---------E----------------X---------------------------<>-----[]-----------------------------E---X------------------------------------------------------
---------XXXXXXXX----X----[]-------------XXXXXX--------------SSX--------X--------XX-------<>--------XXXX------------------E--------------->--------------------------------------------[]-----[]--------------------------------XX-----------------------------------------------------[
EE-EE----XXXXXXXX----X----[]----------XXXXXXXXX--------X----------------X---XXX--XX-------[]-------XXXXXX------------E---E]--------------E]--------------------------------------------[]-E---[]--------------------------------XXX----E----------------------E-----E-EEE-EE--------E-E[
XXXXXXXXXXXXXXXXXXXX-XXXXXXXXXXXXXX---XXXXX----XXXXXX-XX-------X--------XXXXXXXXXXX-XXXX-XXXXXXXXXXXXXXXXXXXXXXXXXXXXXXXXXXXXXXXXXXXXXXXXXXXXX--XX----XXX---------------XXXXXXXXXXXXXXXXXXXXXXXXXXXX---XXXXXX---XXXXXXXXX-------XXXXXXXXXXX-XXXXXXXXXXXXXXXXXXXXXXXXXXXXXXXXXXXXXXXXXXXX
