----------------------------------------------------------------------------------------------------------------------------------------------------------------------------------------------------------------------------------------------------------------------------------------
----------------------------------------------------------------------------------------------------------------------------------------------------------------------------------------------------------------------------------------------------------------------------------------
----------------------------SS----------------------------------------------------------------------------------------------------------------------------------------------------------------------------------------------------------------------------------------------------------
---------------------------------------------------------------------------------------------------------------------------------------------------------------------------------------X------------------------------------------------------------------------------------------------
---------------X-----------------------------------------------------------------------------------------------------------------------------------------------------------------------X------------------------------------------------------------------------------------------------
---------------X-S----------------------------------------------------------------------------------------------------------------------XXXX-------------------------------------------X----------------------QQ------------------------------------------------------------------------
--------------XX-----------------------------------------------------------------------------------X----------------------------------------------------------------------------------XX------------------------------------------------------------------------------------------------
-------------XXX----------------------------------------------------------------------------------XXX--------------------------------------------------------------------------------XXX-----------------------------------------------------XX---XX------------------------------------
------------XXXX----------------------E------------E----------------------------------------------XX--------------------------------------------------------------------------------XXXX------------------------------------------------------------------------------------------------
-----------XXXXX-----------------S---<>-----E-----<>----------------------------------------------XX-----------------------------------SS------------------------------------------XXXXX-----------------QQ---QQ---?Q---------------------------------SS-----------------------------QQ-
----------XXXXXX-----E---------------[]----<>---E-[]---E-------------------------------------------X-----E------------------------------------------------------------------------XXXXXX-----E-----<--------------------------------------E-----E---------------------------------------
---------XXXXXXX----<>-----[---------[]----[]--<>-[]--<>------------------------------------------XX-----X-----------------------------------------------------------------------XXXXXXX-----X-----[--------------------------------------E----<>---------------------------------------
-E-EE---XXXXXXXX----[]-----[---------[]----[]--[]-[]--[]-----------------------------E--E------E--XX----------------------------------------------------E------------EE--E-EE---XXXXXXXX-----X--E--[------------------E-------------EE----S----[]-----E--E-EXX-----E-E----------------E-
XXXXXXXXXXXX-XXXX-XXXXXXXXXXXXXXXXXXXXXXXXXXXXXXXXXXXXXXXXXXXXXX------XXXXXXXXXXXXXXXXXXXXXXXXXXXXXXXXXXXX-XXXXX---XXXXXXXXXXXXXXXXXXXX--XXXXXXXXXXXXXXXXXXXXX-XXXXXXXXXXXXXXXXXXXXXXXXXXXXXXXXXXXXXXXXXXXXXXXXXXXXXXXXXXXXXXXXXXXXXXXXXXXXXXXXXXXXX-XXXXXXXXXXXXXXXXXXXXXXXXX-----XXXXX
