----------------------------------------------------------------------------------------------------------------------------------------------------------------------------------------------------------------------------------------------------------------------------------------
X---------------------------------------------------------------------------------------------------------------------------------------------------------------------------------------------------------------------------------------------------------------------------------------
------------------------------------------------------------------------------------------------------------------------------------------------------------------------------------------------------SS------------------------SSSSSSSSSSSSSSSSSSSSSSSSSSSS----------------------------
XE-----------------------------------------------------------------------------------------------------------------------------------------------------------------------------------------------------------SS-------------------------------------------------------------------------
>XXXXXX------------------------------------------------------------------------------------------------------------------------------------------------------------------------------------------------------SSSS-----------------------------------------------------------------------
S---------------------SSS-------------------------------SSS-----------------------------------------------SSSSS------------------------------------------------------------------------X------------------SSSSSSS-----------------------------------------------------------------------
--------------------------------------------------------------------------------------------------------------------------------------------------------------------------------------XX------------------------------------------------------------------------------------------------
-------------------------------------------XX-----------------------------------------------------------------------------------------------------------------------------------------XXX-----------X---------S-------------------------------------------------------------------------
-----------------------S-------------------------------------------------------E---------------------------SS-----------------------------------------------------------------------X-XX----------------------S------------E--------------E---------------------------------------------
XQQQ--------------EXXX-----------------------------S----SSSQ--------------XX--<>----SSSSS--------------X-------------------------------------------------XXXX----------------------X------------------E--SS--SSS----------<>---->--S-----<>--------------------------------X------------
-------X---EXXXXXXXXX-----------------------E----E-------------E---------XXX--[]-----------E----------XX------------------------------------------------XXX------------------------XXXX------E-----<-<>-------S-----------[]-------S-----[]--------<>---------------------------------E-
------<>-----------XX----------------------<>---<>------------<>--------XXXX--[]----------<>--------XXXX------------------------XX--------XX-----------XXXX----------------------------X----<>-----[X[]--X----S-----------[]----S--S-----[]--------[]--------------------------------<>-
------[]-------X-------------EE-EE----EE--E[]---[]E-----------[]-------XXXXX--[]---X------[]-------XXXXX------------------------XX--------XX----------XXXX----------E----E--EE--XXXE--EX----[]-----[-[]------E--------EE--[]----S-----E--[]--------[]--------------------------------[]-
XXX----XXXXX----------------XXXXXXXXXXXXXXXXXXXXXXXXXXXXXXXXXXXXXXXXXXXXXXXXXXXXXXXXXXXXXXXXXXXXXXXXXXXXXXXXXXXXXXXXXXXXXXXXXXXXXXX---XXXXXXXXXXXX--XXXXXX----XXXX--X-X-XXXXXXXXXXXXXXXXXXXXXXXXXXXXXXXXXXXXXXXXXXXXXXXXXXXXXXXXXXXXXXXXXXXXXXXXXXXXX--XXXXXXXXXXXX---XXXXX----XXXXXXXXX
