----------------------------------------------------------------------------------------------------------------------------------------------------------------------------------------------------------------------------------------------------------------------------------------
----------------------------------------------------------------------------------------------------------------------------------------------------------------------------------------------------------------------------------------------------------------------------------------
----------------------------------------------------------------------------------------------------------------------------------------------------------------------------------------------------------------------------------------------------------------------------------------
----------------------------------------------------------------------------------------------------------------------------------------------------------------------------------------------------------------------------------------------------------------------------------------
--------------------------------------------------------------------------------------------------------------------------XX------------------------------------------------------------------------------------------------------------------E--------------------XX-------------------
------SQQQQQQ-----------------------------------------------------------------------X---SSSSSSSSS--S-----------S----------------------------SS------------------------------------------------------X-------QQSSSSS-------------E----------------E----------------------SSS----XXXX-----
-----------------------------------------------------------------------------------------------------------------------------------------------------------------------------------------------------------------------------------XXXXX-------------XXXXX------------------------------
------------------------------------------------------------------------------------X---------------------------------------------------------------------------------------------------------------E-----------------------------------------------------------------------------------
-----------------------E----------------------X---------------SSS-----------------------------------------------------------------------------------------------------------------------------------XXX-----------------------E-----------------------------XXXXXXX-------------------XX
--E--QQ--SQQQ---------<>----QQQ--------------XXX---------------------QQQ-----------------SSSSSSSQQ--------<--X-----------------Q------------QQ----------------X------------------------<>------------------S?S-SSSSS---------<---------------XXXXXX---------------------XX-----------X--
-<>-------------------[]--E---------------EXXXXX-----------------------------------------------------------E-X----------------------------E---------------EXXXXX-----------------------[]------------------------------------[]-----------------------------------------------------XXXS
-[]-------------------[]-------------------XXXXX------XX--------------------------------------------------[]-X---------------------------<>----------------X-XX-------X----------------[]------------------------------------[]---------------------------------------------------------
-[]----------------E--[]-------------------XXXXX-----XXX---------E-------------------------------------EE-[]-X-----------E---------------[]--------------------------XXX---------------[]------------------------------E-----[]---------------------------------------------------------
XXXXXXXXXXXXXXXXXXXXXXXXXXXXXXXXXXXX--XXXXXXXXXXXXXXXXXXXXXXXXXXXXXXXXXXXXX------X--XXXXXXXXXXXXXXXXXXXXXXXXXXXXXXXXXXXXXXXXXXXXXXXXXXXXXXXXXXXXXXXXXXXXXXXX-------XXXX-XXXXXXXXXXXXXXXXXXXX---XXXXX---XXXXXXXX-XXXXXXXXXX-----------X--------------------------------------XXXXXXXXX---
