----------------------------------------------------------------------------------------------------------------------------------------------------------------------------------------------------------------------------------------------------------------------------------------
----------------------------------------------------------------------------------------------------------------------------------------------------------------------------------------------------------------------------------------------------------------------------------------
----------------------------------------------------------------------------------------------------------------------------------------------------------------------------------------------------------------------------------------------------------------------------------------
----------------------------------------------------------------------------------------------------------------------------------------------------------------------------------------------------------------------------------------------------------------------------------------
----------------------------------------------------------------------------------------------------------------------------------------------------------------------------------------------------------------------------------------------------------------------------------------
------------------S---------------------------------------------SSSS-----------------XXXX------------------------------------------------------------------------------------------------E-------------------------X--------------------------------------------------------S-----------
-------------------------------------------------------------------------------------------------------------------------------------------------------------XXX-----------XXXXX-------------XXXXX-----------------X--------------------------------------------------------------------
------------------X-----------------------------------------------------------------------------------------------------------------------------------------------------------------------------------------------XX----------------------------E---------------------------------------
-----------------XX---------------------------------------X-------------------------------------------------------------------------------------------------------------------------------------------------------XX-----------------E---------->----------------E----------E-----------
X----------------XXX---------------------XXXX------------------S?---SSS----------X------------------------S------------------------------SQ---------------------------SS--------------XXXXXX-------------------X--XX---------------------------[]----------E----<>---------<>----------E
X-------------EXXXXX---------------------XX--------------------------------------XX-------------X-------------------------E------------------------------------------------------------------------------------XXXXX-----------<-----E---------[]---------<>----[]---------[]---------<>
X-------------XXXXX-------XX-------------XX--------------------------------------X--------------X-------------------------------------------XXX----------------------------------------------------------------XXXXX-----------[----<]---------[]---------[]----[]---------[]---------[]
]------------------------XXX------------------------------------------------E-E-------E--EE-E---X--------EEE-E-E-------E-EE------------E-EE--X-------------------------------------------------------E-E----XXXXXXXX-----------[----[]---------[]---------[]-E--[]-----E-E-[]----E]---[]
XXXXXXX---XXXXX----X-XXXXXXXXXXXXXX--XXXXX-------X--X-XXXXXXXXXXXXXXXXXXXXXXXXXXXXX-XXXXXXXXXXXXXXXXXXXXXXXXXXXXXXXXXXXXXXXXXXXXXXXXXXXXXXXXXXXXXXXXXXX----X--------XXX----------X------------------XXXXXXXXXXXXXXXXXXXXXXXXXXXXXXXXXXXXXXXXXXXXXXXXXXXXXXXXXXXXXXXXXXXX---XX---XXXXXXXX
