----------------------------------------------------------------------------------------------------------------------------------------------------------------------------------------------------------------------------------------------------------------------------------------
----------------------------------------------------------------------------------------------------------------------------------------------------------------------------------------------------------------------------------------------------------------------------------------
----------------------------------------------------------------------------------------------------------------------------------------------------------------------------------------------------------------------------------------------------------------------------------------
----------------------------------------------------------------------------------------------------------------------------------------------------------------------------------------------------------------------------------------------------------------------------------------
---------------------------------------------------------------------------------------XXXXX--------------------------------------------------------------E-----------------------------------------------------------------------------------------------------------------------------
--------------------------------SSSSSSSSS--------------S--------SS------------------E----------------SSSS----------------------------------------------------E--------------------------------------------------------------------------------------------------------------------------
------------------------------------------------------------------------------------------------------------------------------------------------------------XXX-------------------------------------------------------------------------------------------------------------------------
----------------------------X-----------------------------------------------------------------------------------------------------------------------------------------------------------------------------------------------------------------------------------------------------------
----------------E-------------------------------------------------E------------E-----------------------------------------------------------------------------------------------------------------------------------------------------E----------E---------------------------------------
-----E---------<>----------------SSSSSSSQ------------------S-----QS-----------<>----XXXXX------------XXXXX------------Q---------E----------------------------S-------SSS--------------S--------------------------------------QQ-----<>---------<>---------------------------------------
----<>---------[]-------------------------------------------------------------[]---------------E-XX-----------X----------------<>-----------------------------------------------------------------------------E---------------------[]---------[]---------------------------------------
----[]---------[]----<-------------------------------X------------------------[]-----------------------------XX----------------[]-----------XXXX------------------------------------------------------------------------------]-----[]---------[]---------------------------------------
-E--[]-----E-E-[]----[-------------------------EE-E--X------------------------[]-------------------------XX--------------------[]-E----------------------E---------E-----------E-E-------------------------E-EE--------------EE-----[]---------[]----------------------EE--E------------
XXXXXXXXXXXXXXXXXXXXX--XXXXXXXXXXXXXXXXXXXXXXXXXXXXXXXXXXXXXXXXXXXXXXXXXXXXXXXXXXXXXX---------------------------XXXXXXXXXXXXXXXXXXXXX----XXXXX---XXXXX--XXXXXXXXXXXXXXXXXXXXXXXXXXXXXXXXXXX-----XX-XXXXXXXXXXXXXXXXXXXXXXXXXXXXX-XXXXXXXXXXXXXXXXXXX---XXXXXXXXXXXXXXXXXXXXXXXXXXXXXXXXX
