----------------------------------------------------------------------------------------------------------------------------------------------------------------------------------------------------------------------------------------------------------------------------------------
----------------------------------------------------------------------------------------------------------------------------------------------------------------------------------------------------------------------------------------------------------------------------------------
----------------------------SSSSSSSSSSSSSSSSSSSSSSSSSSSS------------------------------------------------------------------------------------SSSSSSSSSSSSSSSSSSSSSSSSSSSSSSSSSSSSSSSSSSSSSSSSSSSSSSSS----------------------------------------------SSSSSSSSSS----------------------------
-------------------------------------------------------------------------------------------------------------------------------------------------------------------------------------------------------------E--------------------------------------------------------------------------
-------------------------------------------------------------------------------------------------------------------------------------------------------------------------------------------------------------XXX------------------------------------------------------------------------
------SQQQQQQ--------------S----------------X---------------------------------------------SSSSSSS--------------S-------------E-----------------------------------------------------------------------------------------------------------------------------------------?SSS-------------
--------------------------------------------X-------------------------------------------------------------------------------------------------------------------------------------------------------------------------------------------------------------------------------------------
--------------------------------------------XS---------------------------------------------------------------------------------------------------------------S--------------------S-----------------------------------------------------------------------------------------------------
--------------------------------------------XXXS-----------------------------------------------------------E-------------------------------------------------SSS------------------E-------------------------S-----------------------------E------------------XSSSS--------------------E-
--E--SSS-SQSQ---------------<>------Q---X----X----X-----------------------------------E--SSS-SSS----------<>---------------------SS---------SS-S----SQS---------X------X-----S---[]----------------X--------------Q----------QQ----------<>-----------------------------SS-----------<--
-<>--------------------E----[]--------------XX---XX----------------------------------<>-------------------[]-----EX-------------------------[------------------XX-X----X-<E------[]---------E------X------E---E--------------->----------[]------------------------------------------E]-
-[]-------------------<>-X--[]----------XXXXXX---XX----X-----------------------------[]-------------------[]-----XXX------------------------[---------------<>-XX------XSS?------[]--------<>------X---------<>---------------]----------[]--------<X------X----------------------------
-[]----------------EE-[]-X--[]----------XXXXXX---XX----X------------------E----------[]---------------EE--[]--------------------------------E-----E------EX-[]-XX------XS[]------[]--------[]------X---------[]--------------[]----------[]----------------X----------------------------
XXXXXXXXXXXXXXXXXXXXXXXXXXXXXXXXXXXXXXXXXXXXXX---XXXXXXXXXXXXXXXX--XXXXXXXXXXXXXXXXXXXXXXXXXXXXXXXXXXXXXXXXXXXXX-------------------XXXXXXXXXXXXXXXXXXXXXXXXXXXXXXXXXXXXXXXXXXXXXXXXXXXXXXXXXXXXXXXXXXXXXXXXXXXXXXXXXXXXXXXXXXXXXXXXXXXXXXXXXXXXXXXXXX-XXXXXX---XXXXXX----XXXXXXXXXXXXXX-
