----------------------------------------------------------------------------------------------------------------------------------------------------------------------------------------------------------------------------------------------------------------------------------------
----------------------------------------------------------------------------------------------------------------------------------------------------------------------------------------------------------------------------------------------------------------------------------------
------------------------------------------------------------------------------------SSSSSSSSSSSSSSSSSSSSSSSSSSSS--------------------------------------------------------SSSSSSSSSSSSSSSSSSSSSSSSSSSS------------------------------------------------------------------------------------
------------------------------------------------------------------------------------SSSSSSSSSSSSSSS------SSS--SS------------------------------------------------------------------------------------------------------------------------------------------------------------------------
------------------------------------------------------------------------------------SSSSSSSSSSSSSSS------S-S--SS------------------------------------------------------------------------------------------------------------------------------------------------------------------------
-------------------------------------------------------------------------------------SSSSSSSSSS--SSS----------SS----------------------------------------------------------------------------------------------QQS--------------------------------------------XXX------------------------
-------------------------------------------------------------------------------------S-S------------------------------------------------------------------------------------------------------------------------------------------------------------------------------------------------
------------------------------------------------------------------------E---------------------S------------E-----------------------------------------------------------------------------SX---------------------------------------------------------------------------------------------
-----------------------------------------------------------------------X----------------E-----S-----------<>----------------------------------------------------------------------------XXXS-------------------------------E--------------------E---------------------------------------
----------------E------------------------------------QQ--------------------------------SSSSSSSSS-------E--[]--------------------------S---------------------E-----------<>------QQS------X-X--X-------E--QQ---??---<>-----<>---------E---------<>----------E----------------------------
---------------<>--------------------------------------------E----------E----E-----E-SSSSSSSSSS-------<>--[]--------------E-----E---------------------------------------[]---------------]----X----X-<>------------[]-----[]--E-----<>---------[]---------<>--------------------------E-
---------------[]-------------------------------------------<>---------<>---<>-----[SSSSSSSSSSS-------[]--[]-------------<>----<>---------------------------E---------XX[]----------XXXX[]-X--X---XX-[]--X---------[]-----[]--------[]---------[]----<>---[]------------X------------<>-
-------------E-[]------------------E-----------------EE-----[]---------[]---[]----E[SSSSSSSSSSS-------[]--[]--------EE---[]----[]--------EE---------------------------XX[]----E-----XXX-[X-X--X---XX-[]------------[]-----[]--------[]-----E-E-[]----[]---[]------------X------------[]-
XXXXXXXXXXXXXXXXXXXXXXXXXXXXXXXXXXXXXXXX--XX------XXXXXXXXXXXXXXX-XX-XXXX-XXXXXXXXXXXXXXXXXXXXXXXXXXXXXXXXXXXXXXXXXXXXXXXXXXXXXXXXXXXXXXXXXXXXXXXXXXXXXXXXXXXXXXXXXXXXXXXXXXXXXXXXXXXXXXXX----XXXXXXXXXXXXXXXXXXXXXXXXXXXXXXXXXXXXXXXXXXXXXXXXXXXXXX-XXXXXXXXXXXXXXX--XXXXXX----XXXXXXXX
