----------------------------------------------------------------------------------------------------------------------------------------------------------------------------------------------------------------------------------------------------------------------------------------
----------------------------------------------------------------------------SS-----S----------------------------------------------------------------------------------------------------------------------------------------------------------------------------------------------------
-----------------------------------------------------------SSSSSSSSS--<>----SS----SS----------------------------------------------------------------------------------------------------------------------------------------------------------------------------------------------------
-----------------------------------------------------------SSSSSS-----[]----SS---SSS----------------------------------------------------------------------------------------------------------------------------------------------------------------------------------------------------
-----------------------------------------------------------SSSSSS-----[]----SSS-SSSS----------------------------------------------------------------------------------------------------------------------------------------------------------------------------------------------------
-----------------XXXX-----------------------------------?-SSSSSSS----SSS---SS------S--------------------------------------------------------------------------E----XX----------------------------------------------------------------SSSSSSSS--S-----------S----------------------------
-------------------------------------------------------------------------------------------------------------------------------------------------------------->-------------------------------------------------------------------------------------------------------------XX----------
------------------------------------------------------------------------------------------------------------------------------XXXXXX--------------------------------------------------------------------------------------------X-------------------------------------------------------
---XXXX---------------------------------------------------EE----------------------------------------------------------------------------------------------------------------------------------------------------------------------------------------------------------------------------
------------XX----------------------------------------SSSXS?SSSS------E----E-----XX-----------------X----------------------------------------------------XXXXX-------------------------------------------E----------E----------------SSSSSSSQ-----------------------------------------SS
------------------------------------------------------------SSSSS--EX-----<------------------E-----XX----------------E---------------E-------------------XXXXX---------------------------X--------------<>---------<>-------------------------------------------------------------------
----------------------------XX------------------------------SSSS--------X-[]------X---------------XXX---------------<>---------X----<>-----[------------XXXXXX-------------------------XXXXX------------[----------[]----------------------------------------X--------------------------
--------------------------------------------------------------SS--------X-[]E-E--XX-EE-----------XXXX------------E--[]----EE--EE----[]---E-E----------XXXXXXXX-------------------------XXXXX------------E]-----E-E-[]------------------------------EE-E--X----------E-------------------
--------------------------------XXXXXXXX-XXXXXXXXXXXXXXXXXX--XXXXXXXX---XXXXXXXXXXXXXXXXXXXXXXXXXXXXX--XXXXXXXXXXXXXXXXXXXXXXXXXXXXXXXXXXXXXXXXXX---XXXXXXX--XXX--------XXXXXXXXXXXXXXXXXXXXXXXXXXXXXXXXXXXXXXXXXXXXXXXXX---XXXXXXXXXXXXXXXXXXXXXXXXXXXXXXXX-----XXXXXXXXXXXXX---XXXXXXX
