----------------------------------------------------------------------------------------------------------------------------------------------------------------------------------------------------------------------------------------------------------------------------------------
----------------------------------------------------------------------------------------------------------------------------------------------------------------------------------------------------------------------------------------------------------------------------------------
----------------------------------------------------------------------------------------------------------------------------------------------------------------------------------------------------------------------------------------------------------------------------------------
-------------------------------------------X-------------------------------------------------------------------------------------------------------------------------------E------------------------------------------------------------------------------------------------------------
-------------------------------------------X-----------------------------------------------------------------------------------------------------------------------------XXXXXXX-----------------------------XXX------------------------------------------------------------------------
-------------------------------------------X---------------------------X------------SSSS---SSS---------------------------------------------------------------SSS--------?----------------SSSSSS------------------------------------------------------XXXXXX------------S----------------
------------------------------------------XX---------------------------X----------------------------------------------------------------------------------------------------------------------------------------------------------------------------------------------------------------
-----------------------------------------XXX--------------------------XX----------------------------------------------------------X-----------------------------------------------------------------------------------------------------------------------------------------------------
----------------------------------------XXXX--------------------------XX-----------------------------------E---------------------XX-----------XXX--------------------------------------------------------E----------E-------------------------------------------------------E-----------
---------------------------------------XXXXX-----------------------X--XX------------SSSSS-------------XX--<>--------------------X-X---------------------XXX----------X--XXXXX-------------XXXX----XX---------------<>-----SS----------------------XX-------------E---------<>-----------
-----E----------E----------E----------XXXXXX-----E-----<-----------XXXXX-----------E-------E----------XX--[]------------------EXXXX----------------------------------XX--------X---EXX-------------------E---------[]--------------------------X----------------<>---------[]-----------
---------------<>----------[---------XXXXXXX-----X-----[-----------XXXXX-----------[------<>--------XXX]--[]------------------XXXXX----------------------------------XX-------XX------------------------<>---E-----[]-------------------------------------------[]---------[]-----------
----EE---------[]---------E[-E-EE---XXXXXXXX-----X--E--[-E-EE----XXXXXXX----------E[------[]-------XXXX]--[]------------------XXXXX-----------------------------E-E--X-----------------XX---XXX---------[]---E-----[]-------------------------------------------[]---------[]-----------
XXXXXXXXXXXX-XXXXXXXXXXXXXXXXXXXXXXXXXXXXXXXXXXX-XXXXXXXXXXXXXXXXXXXXXXXX-XXXXXXXXXXXXXXXXXXX-XXXXXXXXXXXXXXXXXXXXXXXX-XXXXXX---------------XXX---XXXXXX---XXXXXXXXXXXXXX-----------------------------XXXXXXXXXXXXXXXXXXX--XXXXX--------XXXXXXXXXXXXXXXXXXXXXXXXXXXXXXXXXXXXXXXX-XXX-XXX
