--------------------------------------------------------------------------------------------------------------------------------------------X-------------------------------------------------------------------------------------------------------------------------------------------
----------------------------------------------------------------------------------------------------------------------------------------------------------------S------S----------------------------------------------------------------------------------------------------------------
--------------------------------------------------------SSSSSSSSSSSSSSSSSSSSSSSSSSSS--------------------------------------------------------S-SSSSSSSSSSSSSSS---SSSS-SSS----------------------------------------------------------------------------------------------------------------
----------------------------------------------------------------------------------------------------------------------------------------------SSSSSSSSSSSSSS----SS---SSS----------------------------------------------------------------------------------------------------------------
--------------------------------------------------------------------------------------XXXXXXX--------------------------------------------------SSSSSSSSSSSSS----SSS--SSS----------------------------------------------------------------------------------------------------------------
--------------------------X-------------------S------------------------------------------------------SSSSSSSSS---------------------------------SSSSSSSSSSSSS----SS----SS----------------------------------------------------------------------------------------------------------------
--------------------------------------------------------------------------------------------------------------------------------------------EE-S----------------------------------------------------------------------------------------------------------------------------------------
----------------X----------------------------XX-------------------------------------------------------------------------------------------------------S---------------------------------------------------------------------------------------------------------------------------------
--------------------------------------------XXX-------------------E-----------------------------------------------------------------------------E-----S------------E----------------------------------------------------------------------E----------------------------------XX---------
-----------------------S--------------S-----XXX---X----------S---<]------------------XXXX---------X-----XX--------------------XXXXXX----------E-SSSSSSSS----------<>---------------------------------------------------------QQ------Q---<>-----E-------------------Q-------XX----------
------------X-------------------------------XXX---X------<>------[]---------E------X----------------------------------------------------------E-------------------[]--------------------E------------------------------------------------[]----<>---E-----------------------XX----------
------------X-----------------------------XXXXX-------XXS[?------[]--------<>------X---------------------------------------------------------SS--X------------[---[]-------------------<>------------------------------------------------[]----[]--<>-----XX--------------XXXXX---------
--E---E-E-EEX-E------EE-EE--]------------XXXXXX-------XX-[]------[]--------[]----------------------X-----------------------------------------[]------E--------[]E-[]--------EE----EE---[]----------E-------E-E---------------EE----------[]----[]--[]-----XX-------------XXXXXX---------
XXXXXXXXXXXXXXXXXXXXXXXXXXXXXXXXXXXXXXXXXXXXXXX---XX----XXXXXXXXXXXXXXXXXXXXXXXXXXXX--------XXX-----------------XXXXXXX-------X----XXXXXXXXXXXXXXXXXXXXXXXXXXXXXXXXXXXXXXXXXXXXXXXXXXXXXXXXXXXXXXXXXXXXXXXXXXXXXXXXXXXX--XXXXXXX-XXXXXXXXXXXXXXXXXXXXXXXXXXXXXXXXXXX-XXXXXXXXX-XXXXXXXXX
