----------------------------------------------------------------------------------------------------------------------------------------------------------------------------------------------------------------------------------------------------------------------------------------
----------------------------------------------------------------------------------------------------------------------------------------------------------------------------------------------------------------------------------------------------------------------------------------
----------------------------------------------------------------------------------------------------------------------------------------------------------------------------------------------------------------------------------------------------------------------------------------
---------------------------------------------------------EEE--E-------------------------------------------------------------------------------------------------------------------------------------------------------------------------------------------------------------------------
---------------------------------------------------------XXXXXXXX-----------------------------------------------------------------------------------------------------------------------------------------------------------------------------------------------------------------------
-----------------E----------X---S---S?SS------SS--------?----------------SSSS-----------------------------------------------?SS---------------------------------------X-----------------S-S---------------------------------------------------------------------------------------------
------XX--------XXXXXXX---------------------------------------------------------------------------------------------------------------------------------------------------------------------E-------------------------------------------------------------------------------------------
----------------------------------------------------------------------------------------------------------------------------------------------------------------------------------------------------------------------------------------------------------------------------------------
----------------------------X-XX----------------------E-----------------------------------------------------------------------------------XE--------------------------------------------E-----------------------------------------------------XX----------------------------------------
-----------------S---------S-------S?---XXX----------<>-XXXXX-------------XXXX---------------------XXXXX---------X----------------------S--S------------X----------------E---E---------<>-------------------------------------E-------------XXXX---------------------------X------------
-----------------------------------------------------[]--------X---EXXX-----------XX-----------------------------X-------------------------------------XXX--------------<]--<>---E-----[]----X-----E-------------------------<>-----------XXXXXX-----------<---------------X------------
XXXX-------------------------------------------------[]-------XX------------------------------------------------X-------------------------------------XXXX--------------[]--[]---------[]----XX----X-------------------------[]----------XXXXXXX-----------[---------------X------------
------------------------------------------------E-E--[]----------------X-----XX---------------------------------XX-----E-E------------------------E-XXXXXX-E-----EE-E---[]--[]-----E-XX[]----[]----X-------E-----------------[]---------XXXXXXXX--------E--[---------------X------------
--------XX--XXXX----XXXXXXXXX----XXXX-------XXX-XXXXXXXX-------------------------------------XXXX-XXXXXXXXXXXXXX---XXXXXXXXXXXXXXXXXXXXXXX-XXXXXXXXXXXXXXXXXXXXXXXXXXXXXXXXXXXXXXXXX--XXX----XXXXXXXXXXXXXXXXX---XXXXXXXXXXXXXXXXXXXXXX---XXXX----XXXXXXXXXXXXXXXXXXXXXXXXXXXXXXXXXXXXXX
