----------------------------------------------------------------------------------------------------------------------------------------------------------------------------------------------------------------------------------------------------------------------------------------
------------------------------------------------------------------------------------X---------------------------------------------------------------------------------------------------------------------------------------------------------------------------------------------------
------------------------------------------------------------------------------------------------------------------------------------------------------------------------SSSSSSSSSSSSSSSSSSSSSSSSSSSS------------------------------------------------------------------------------------
------------------------------------------------------------------------------------------------------------------------------------------------------------------------SSSSSSSSSS-----------SSSS--S------------------------------------------------------------------------------------
-----------------------------------------------------------E------------------------------------------------------------------------------------------------------------SSSSSSSSSS?-----------SSS-SS------------------------------------------------------------------------------------
----------------X---------------------------------------SSSSSSSSSS-------?SS------------------?SS----------------------------------S------------------------------------SSSSSS-SS----SS--------S---------------------------SS-----------------------------XX----------------------------
----------------X-----------------------------------------------------------------------------------------------------------------------------------------------------------------------------------------------------------------------------------------------------------------------
----------------XX----------------------------------------------------------------------------------------------------------------------------------------------------------------------------------------------------------------------------------------------------------------------
----------------XX------------------------------------E---EE-------------------E-------------?E------------E-----------------------------------------------------------------------------------SS---------------------------------------------------------------------------------------
---------------XXX---------------------------------------SS?SSS-----------XX--<>------E--E---S?-----E-----<>------XXX---------------------------------------------------SSSSSSSSSS---------EX------XX------------------------------------------------S-SSSS-------------XX--------------
---------X--EXXXXX---------E----------------------------------SS----X-----X---[]-----<>-<>---------<>---E-[]----------------------------------------------------------------S-SSSS--------<>X------XX-------------XXXXXX-----------------------------------------------XXX--------------
------------XXXXXX----X---<>---------------------------------SSS--------X-X---[]-----[]-[]---------[]--<--[]--------------------------------------------X------------------SSSSSS-------XX[]X-------------------------------------------------------------------------XXXX--------------
EE-E--------XXXXXX----X---[]--------------------------------------------X-X-E-[]-----[]-[]---E-----[]--[]-[]----------------------------------------E---EE---------E-EE----SSSSSS-------XX[]X------X-----------------------------------EE---------------------------XXXXXX-E------E-EE-E
XXXXXXXXXXXXXXXXX---XXXXX-XX------XX-X----XXXX-----XXX--XXXX-XXXX-XX----X---XXXXXXXX--XXXXXXXXXXXXXXXXXXXXXXXXXXXXXXXXXXXXXXX--XXXXXXXXXXXXXXXXXXXXXXX--XXXXXXXXXXXXXXXXXXXXXXXXXXXXXXXXXXXXXXXXXXXXXXXXXX-XXXXXX---------------XXXXXXXXXXXXXXXXXXXXXXXXXXXXXXXXXXXXXXXXXXXXXXXXXXXXXXXX
