----------------------------------------------------------------------------------------------------------------------------------------------------------------------------------------------------------------------------------------------------------------------------------------
------------------------------------------------------------------------------------------------------------------------------------------------------------------------------------------------------------------------------------------------------------X---------------------------
-----------------------------------------------------------S-----------------------------------------------------------------------------------------------------------------------------------------------------------------------------------------------------------------------SSSS-
-----------------------------------------------------------S----------------------------------------------------------------------------------------------------------------------------------------------------------------------------------------------------------------------------
-----------------------------------------------------------SS---------------------------------------------------------------------------------------------------------------------------------------------------------------------------------------------------------------------------
--------------------------------------------------------SSSSSSSSSS----SS-?-S-----------------------------------------------------------------------------------------------------------------------------------------E-------------------------------------------------SS---------------
----------------------------------------------------------------------------------------------------------------------------------------------------------------------------------------------------------XX-----------XXX--------------------------------------------------------------
----------------------------------------------------------------------------------------------------------------------------------------------------------------------------------------E------------------------------------------------------XX---------------------------------------
----------------------------------------------------------EE-------------------E---------E----------E------------------------------------------------------------------------E---------<>-------------------------------------XX--------------------------------------E-----------------
-------------------------SSS-SS--------------------------SS?SSSS-----------E--<>--------->---------<>-------------------------XXXX------------------------------------------<>---------[]----------E----------------XSSSS------S---------------------------------E---<>-----E-----------
----------E----------------------------------XXX-------------SSS----------<---[]--------[]---------[]-------------------------------------------------------E---------------[]---------[]----E----<>-EXX-----------------------------E----------E----E----------<>---[]----<>---E-------
---------<>--------------------------------XXXXX-------------SSS--------X-X---[]--------[]---------[]------------------------------------------------------<>---------------[]---------[]---<>----[]XXXX----------------------------<>---------<>---<>----------[]---[]----[]--<><>---XX
-------E-[]------------E--E----------------XXXXX-------X----------------X-X-E-[]-X------[]---------[]------------------------------------------------------[]---------------[]---------[]---[]----[]---X-------------------------E--[]-----E---[]---[]-----E----[]---[]----[]--[][]--XXX
XXXXXXXXXXXXXXXXXXXXXXXXXXXXXXXXXXXXXXXXXXXXXXXXXXXXXXXXXXXX-XXXXXXXX--XXX--XXXXXXXXXXXXXXXXXXXXXXXXXXXXXX-XXXXXXXXXXX--XXXXXX-------X--X-XXXXXXXXXXX-XXXXXXXXXXXXXXXXXXXXXXXXXXXXXX-XXXXXXXXXXXXXXXXXX--XX------XX---XXXXXXXXXXXXXXXXXXXXXXXXXXXXXXXXXXXXXX-XXXXXXXXXXXXXXXXXXXXXXXXXXX
