----------------------------------------------------------------------------------------------------------------------------------------------------------------------------------------------------------------------------------------------------------------------------------------
----------------------------------------------------------------------------------------------------------------------------------------------------------------------------------------------------------------------------------------------------------------------------------------
----------------------------------------------------------------------------------------------------------------------------------------------------------------------------------------------------------------------------------------------------------------------------------------
----------------------------------------------------------------------------------------------------------------------------------------------------------------------------------------------------------------------------------------------------------------------------------------
-----------------------------------------------------------------------------------------------------------------------------------------------------X----------------------------------------------------------------------------------------------------------------------------------
-----------------XX-----------------------------------------------------------------------------------S--------------------------------------------------QQ-------------SSSSSSSSSS----------------------SSSSSSSSS-SS--------SSSS---------------X----------------------------------------
----------------XXX---------------------------------------------------------------------------------------------------------------------------------------------------------------------------------------------------------------------------XX----------------------------------------
---------------XXXX-----------------------------------------------------------------------------------X---------------------------------------------------------------------------------------------X----------------------------------------XXX-----------------------------XX---------
SS------------XXXXX-----------------------------------------------------E------------S---------------XX--------------E----------E---------------SSSSS---------------------------------------------------------------------------------------XXXX----------------------------XXX---------
E---------X--XXXXXX-------------------------E----------------E---------<>-----------QQQ-------------XXXX------------<>---------<>----------E------------EQSQ--------S-----SSS----------------------------SSSSSSSQ--------------------------XXXXX---------------------------XXXX--------E
>---------X-EXXXXXX------------------------->---------------<>---------[]-------------------------EXXXXX------------[]---------[]---------E>---------------------------------------------------------->-----------------------------------XXXXXX-----E--------------------EXXXX-------<>
]---------XXXXXXXXX------------------------[]---------------[]---------[]-----------]-------------XXXXXX------------[]---------[]---------[----------------------------------------------------------[]----------------------------------XXXXXXX-----X-------------------EXXXXX-------[]
]---------XXXXXXXXX------------------------[]---------------[]---------[]---------XX]-------------XXXXXX------------[]---------[]---------[----------E-----------------------------------------------[----------------EEE--------E-EE---XXXXXXXX-----X-----E-------------XXXXXX-------[]
XXXXXXXXXXXXXXXXXXXXXX--XXXXXXXXXXXXXXXXXXXXXXXXXXXXXXXX-XXXXXXXXXXXXXXXXXXX---X-XXXXXXXXXXXXXXXXXXXXXXX---XXXXXXXXXXXXXXXXXXXXXXXXXXXXXXXXXX-XXXXXXXXXXXXXXXXXXX-XXXX-XXXXXXXXXXXXXXX-XXXXXX----XXXXXXXXXXXXXXXXXXXXXXXXXXXXXXXXXXXXXXXXXXXXXXXXXXXXXXXXXXXXXXXXXXX--XXXXXXXXX---XXXXXX
