----------------------------------------------------------------------------------------------------------------------------------------------------------------------------------------------------------------------------------------------------------------------------------------
--------------------------------------------------------X-------------------------------------------------------------------------------------------------------------------------------------------------------------------------------------------------------------------------------
----------------------------------------------------------------------------------------------------------------------------------------------------------------------------------------------------------------------------------------------------------------------------------------
-----------------------------------------------------------------------------------------------------------------------------------------------------------------------------------------------------------------------------------------E----------------------------------------------
------------------------------------------------------------------------------------------------------------------------------------------------------------------------------------------------------XXXXXXX----------------------------XXX--------------------------------------------
----------------------------------------------------------------------------------------------------------------------------SS-----------------------------E------------X---SSSSSSSSS--------------------------------SSSSSS------------------QQ---------XSXX----------------------------
----------------XXXX--------------------------------------------------------------------------------------------------------------------------------------------------------------------------------------------------------------------------------------------------------------------
-------------------------------------------------------------E----------E---------------------------------------------------------------------------------XX------------X---------------------------------------------------------------------------------------------------------------
--------------------------E----------------------------------E---------<>------------------------------------------XXXX-------------------XX--------------XX-------------------------------------------------------------------------SSS------------------------------------------------
-X-----------------------QQS------Q---------E---------------<>---------[]-----------------------------------------------------------S-------------------X-X-------------------SSSS--?SS----------X---XXXX------------XXXXX-----------------E-QQQQ------SSS------------------------------
-X-----------------------------------------<>---------------[]---------[]----E-----------------------------------X------------------------------------XXXXXX-------------------------------------XX------------E------------------------------------------------------------------------
XXXX---------------------------------------[]---------------[]---------[]---<>-------------------X----------------------------------------------------XXXXXX-------------------------------------XX-------------------------------------------------------------------------------------
XXXX---------------------------------------[]-E-------------[]---------[]---[]------------------E---------------XXX---------------------------------XXXXXXXX--------E--E--------------------E-E--XX--------------------------------------E--------E-------------------------------------
XXXXXXXXXXX--XXXXXXXXXXXXXXXXXXXXXXXXXXXXXXXXXXXXXXXXXXX-XXXXXXXXXXXXXXXXXXXXXXXXXXXXXXXXXX-XXXXXXXXXXXXXXXXXXXX------XXXXX---XXXXXXXXXXX---XXXXXXXXXXXXXXXXXXXXXXXXXXXXXXXXXXXXXXXXXX--XXXXXXXXXXX----------------XXXXXXXXXXXXXXXXXXXXXXXXXXXXXXXXX---XXXXX---XXXXXXXXXXXXXXXXXXXXXXXXX
