----------------------------------------------------------------------------------------------------------------------------------------------------------------------------------------------------------------------------------------------------------------------------------------
X---------------------------------------------------------------------------------------------------------------------------------------------------------------------------------------------------------------------------------------------------------------------------------------
--------------------------------------------------------------------------------------------------------------------------------------------------------------------------SSSSSSSSSSSSSSS---SSSSSSSS------------------------------------------------------------------------------------
--------------------------------------------------------------------------------------------------------------------------------------------------------------------------SSSSSSSSSSS-S------S----SS------------------------------------------------------------------------------------
--------------------------------------------------------------------------------------------------------------------------------------------------------------------------SSSSSSSSS-S-------SS----SS------------------------------------------------------------------------------------
-----------------S----------------------------X--------------------------SSS--------------------?S----------------XXX----------------------X--------SS------------------SSSSSSSSSSSS-SSS----------SS---------------------------------------------E----------------------------------SSSS
--------------------E-------------------------X---------------------------------------------------------------------------------------------------------------------------------------------------------------------------------------XX------------------------------------------------
--------------XXX--X-E-----------------------XX------------------------------------------------------------------------------XX-XXXX-----------------------------------------------------------------------------XX---XX----------------------------------------------------------------
-----E-----------------------S--------------XXX----------------------------------------SS---------------------E--------------X----------------------------------------------E-----------------------------------------------------------------------------------------------------------
----<>--------------------------------------XXX-------------------------------------------------S------------<>-----------------------SS-S---------------------------------SSSSSSSS---------------------------------------SS-------------------XXXX---------------------SS--------------
----[]----------E----E-----<---------------XXXXX-------------------------------------X-----------------------[]-----------------------------------------------------------E---------------<>------------------------E-------------------------------------------------------------------
----[]---------<>---<>-----[--------------XXXXX--------X-----------------------------------------------------[]------------------------------------------------------------S-X------------[>--------------------------------------XX----------------------------------------------------
-E--[]-----E---[]---[]-----[--------------XXXXX--------X----------------------------XXX----------------------[]---E--EEEE-E-E--------EEE-E--------------------E--------X------------------[]E---------E-EE----E-----------E--E-E--------------------------------------------------------
XXXXXXXXXXXX-XXXXXXXXXXXXXXXXXXXXXXXXXXXXXXXXXXX--XXX--XXXXXXXXXXXXX----XX-XXXXXXXXXXXXXXXXXXXXXXXXXXXX-XXXXXXXXXXXXXXXXXXXXXXXXXXXXXXXXXXXXXXXXXXXXXXXXXXXXXXXXXXXXXXXXXXXXXXXXXXXXXXXXXXXXXXXXXXXXXXXXXXXXXXXXXXXXXXXXXXXXXXXXXX----------XXX-----XXXXXXXXXXXXXXXXXXXXXXXXXXXXXXXX-XXX
