----------------------------------------------------------------------------------------------------------------------------------------------------------------------------------------------------------------------------------------------------------------------------------------
X-----------------------------------------------------------------------------------------------------------------------------------------------------------------------------------------------------------------------------------------------------------X---------------------------
-------------------------------------SSSSSSSSSSSS-SSSSS---------------------------------------------------------------------------------------------------------------------------------------------SSSSSSSSSSSSSSSSSSSSSSSSS-----------------------------------------------------------
----------------------------------------------------------------------------------------------------------------------------------------------------------------------------------------------------------------------------------------------------------------------------------------
----------------------------------------------------------------------------------------------------------------------------------------------------------------------------------------------------------------------------------------------------------------------------------------
------------S--------------------------------------S-------------------------------------------------------------------------------------------------------------------------------------SSS---------SSSS--SSS--------------------------------------------------------------------------
----------------------------------------------------------------------------------------------------------------------------------------------------------------------------------------------------------------------------------------------------------------------------------------
---------------------------------------------------------------------XX----X-----------------------------------------------------XX------------------------------------------------------------------------------------------------------------X----------------------------------------
-----E----------E----------------------------------SS---------------------------------------------------------------------------XXX----------------------------------------------------------------------------------------E------------------XX-------------------------------S--------
----<>---------<>-----------SSSQ--------------XXX---------------------------------------------------------S---------------------XXX------------------------XX---------------------------------------SSSSS--SS----------E--<>------------------XX------------<>---E---E------E-----------
----[]---------[]------------------E---------XXXX-----------------E----------------------E----------E-------------------------XXXXX------------------------------------------------------------------------SS---------<>--[]-----------------XXX------------[]--<>---E-----<>----X-----E
----[]---------[]----<>-----------<>--------XXXXX-----------------E---------------------<>---------<>------------------------XXXXXX--------------------------------------------------------------XX----S--SS--------XX[]X-[]---X-----------XXXXXX-----------[]--[]---------[]----<>---XX
----[]---E-----[]----[]-----------[]-------XXXXXX---------E--E-EE-S------------E-EE-----[]---------[]--------------E--------XXXXXXX-----------------------------------------------------------E--X--------XS--------[][]--[]---X----------XXXXXXXX------E--E[]--[]-----E-E-[]----[]----X
--XXXXXXXXXXXXXXXXXX-XXXXXXXXXXXXXXXXXXXXXXXXXXXXXXXXXXXXXXXXXXXXXXXXXXXXXXXXXXXXXXXXXXXXXXXXXXXXXXXXXXXXXXXXXXXXXXXXXXX-XXXXXXXXXXXXXXXXXXXXXXXXXX----XXXX----XXXXXXXXXXXXX--XXXXXX----XX-XXXXXXXXXXXXXXXXXXXXXXXXXXXXXXXXXXXXXXXXXXXXX--XXXXXXXXXXXXXXXXXXXXXXXXXXXXXX--XXXX--XXXXXXXX
