----------------------------------------------------------------------------------------------------------------------------------------------------------------------------------------------------------------------------------------------------------------------------------------
----------------------------X-----------------------------------------------------------------------------------------------------------------------------------------------------------------------------------------------------------------------------------------------------------
------------------------------------------------------------------------------------------------------------------------------------------------------------------------------------------------------------------------------------------------------------SSS------------SSSSSSSSSSSSS
----------------------------------------------------------------------------------------------------------------------------------------------------------------------------------------------------------------------------------------------------------------------------------------
----------------------------------------------------------XXXX-X------------------------------------------------------------------------------------------------------------------------------------------------------------------------------------------------------------------------
----------SS--------------S------------SS---------------?--SS???E--------??SS--------------------------------------SSSSSSSS---SS-----------S------------------------XXXX----------------------------------------------------XXXX--------------------------------------------------------
----------------------------------------------------------------------------------------------------------------------------------------------------------------------------------------------------------------------------------------------------------------------------------------
-----------------------------------------------------------E----------------------------------------------------------------------------------------------------------------------------------------------------------------------------------------------------------------------------
-------------------------------------?E-----------------X-XX-------------------------------------------------------------------------------------E----------E---------------------------------------------------------------------------------------------------------E-----------------
-----QQ--SS-----E----------------E---E?-----E------------XXXX--------XX----X-----XX----------------QQ---------------S-SSS-----------------------<>---------<>------SS---------Q---QQQ--Q-----------------------------------------X----------------------SSSS---S-----QQ-----------------
---------------<>---------------<>---------<>---E--------------E---EX------------XX------------------------E--E------------------------E--------[]---------[]----------------------------------E--E-------------------------------------------------------------------------------------
---------------[]---------------[]---------[]--<><>---XX------SX--------X--------XX-----------------------<>--------------------------<---------[]---------[]------------------------------------<-----------------------------------------------------------------------------XX-------
---------------[]-E-------------[]---------[]--[][]---XX----------------X---XXX--XX-----------------------[]----------------------E-E-[]-X------[]---E-----[]-E----------------------------------[------------E-E---------------XX-----E-E------------------------E------------[--------
XXXXXXXXXXXXXXXXXXXXXXXXXXXX--XXXXXXXXXXXXXXXXXXXXXXXXXXXXX--XXX------------XXXXXXXXXXXXXXXXXX-XXXXXXXXXXXXXXXXXXXXXXXXXXXXXXXXXXXXXXXXXXXXX--XXXXXXXXXXXXXXXXXXX--XXXXXXXXXXXXXXXXXXXXXXXXXXXXXXXXXXXXXXXXXXXXXXXXXXXXXXX--XXXXXXXXXXXXXXXXXXXXXXXXXXXXXXXXXXXXXXXXXXXXXXXXXXXXXXXXXXXX
