----------------------------------------------------------------------------------------------------------------------------------------------------------------------------------------------------------------------------------------------------------------------------------------
----------------------------------------------------------------------------------------------------------------------------------------------------------------------------------------------------------------------------------------------------------------------------------------
----------------------------------------------------------------------------------------------------------------------------------------------------------------------------------------------------------------------------------------------------------------------------------------
---------------------------------------------------------------------------------------E----------------SSSSSS--------------------------------------------------------------------------------------------------------------------------------------------------------------------------
-------------------------------------------------------------------------------------XXXX---------------SSSSS---------------------------------------------------------------------------------------------------------------------------------------------------------------------------
------------------XX------------------------------XXXX-------------------------------------S-----S-----SSSSSSS----XX-------------------------------------------------------------------X------------SSSSSSSSSS------------------------SQQQQQQ----------------------------------X--------
--------------------------------------------------------------------------------------------------------------------------------------------------------------------------------------EX----E-------------------------------------------------------------------------------------------
-------------------------------------------------------------------------------------------------------------------------------------------------------------------------------------XXXXXXX-E------------------------------------------------------------------------------------------
--XXXX--------------------------------------------------------------------------------E---------------------------------------------------------------------XSSS--------------------X------------------E-------------------E----------------------------------XXXXX---------------------
------------XXX----------X--------------------X-----------------------------------E-XXXXX-------------XXXX----XX-------------------------------------------------------------------X-----------------?SSS--SS-------------<>----------S--SQSQQ--------->----------------XX--------------
-------------------------XX---------------XX----------------------E--------------<>--------X---EXX----XX--------------------X------------------------E------------X----------E-----XXX-------E-----<-------S----------X---[]------>-------------------[]------------------------------X-
-------------------------X-------------------------------------------------------[]-------S>----------XX--------------------X---------------<>------------XXXX----X---------<>--------------<>-----[----------------X-X---[]-----[]-------------------[]--------------------------------
---------------------------------------------------------------E-EE--------------[]-------[]-------XX-XXX---------------E-XXX------------EEE[]-----------XXXXX----X------EE-[]----EE--EE----[]-----[------------------X---[]-----------------------EE-[]--------------------------------
-----XXX-------XXXXXXXXXXXX----------XXX----------------XXXXXXXXXXXXXXXXXXXXXXXXXXXXXXX--XXXXXXXXXXXXXXXXXXXXXXXXXXXXXXXXXXXXXXXXXXXXXXXXXXXXXXXXXXXXXXXXXXXX--XXXXXXXXXXXXXXXXXXXXX-XXXXXXXXXXXXXXXXXXXXXXXXXXXXX-XXXX-XXXXXXXXXXXXXXXXXXXXXXXXXXXXXXXXXXXX-------X----------XX--------
