----------------------------------------------------------------------------------------------------------------------------------------------------------------------------------------------------X-----------------------------------------------------------------------------------
------------------------------------------------------------------------------------------------------------------------------------------------------------------------X-------------------------------------------------S-------------------------------------------------------------
----------------------------------------------------------------------------------------------------------------------------------------------------------------------------------------------------SSSSSSSSSSSSSSSSSSSSSSSSSSSS--------------------------------------------------------
----------------------------------------------------------------------------------------------------------------------------------------------------------------------------------------------------SSSSSSSSSSSSSSSS----SSSSSSSS--------------------------------------------------------
------------------------------------------------------------------------------------------------------------------------------------------------------XX--------------------------------------------SSSSSSSSSSSSSSSS----SSSSSSSS--------------------------------------------------------
-------------S-----X---------------------------------------SSSSSSSSSSSSS-----------S---------------------------------------------E-----------------------------------------------------------X------SSSSSSSSSSSS-SSS--------S-SS------------------------------------------------------S-
--------------------------------------------------------------------------------------------------------------------------------XXXXX---------------------------------------------------------------SS-S--------------------------------------------------------------------------------
---------------------------------------------------------------------------------------------------X------------------------------------------------------------------------------------E--X------------------S-------------------------------------------------------------------------
-XXXXX--------------------E------------------------------------------------------------------------X--------------------------------------E----------------------------------E--------------------------E-----S------------??-----------------------------------------------------------
------------XX-----------<>---------------------------------SSSSSS--------------------------------XX-----------------------------S---------S---------------Q---------------------------------------E-SSSSSSSSSSS-------E------XX------------------X-------------------------E-----------
-------------------------[]-------------X----------------------------------------------------------X-------------E------------------------------------E----------------------E----------E----E----<>-SSSSSSSSSS-------<>----------------------EXXXX------------------------<>-----------
-------------------------[]-------------X-----------------------------------------X---------------EXX-----------XXXX---------------------------------<>---------------------<>---------<>---<>----[]SSSSSSSSSSS-------[]-----------------------XXXX------------------------[]-----------
-------------------------[]-------------X--------EEEEE-E--------------------E-E--XX--E-EE------E--XX-------------------------------------------------[]---------------------[]----E----[]---[]----[]SSSSSSSSSSS-------[]X----------------------X-XX------------------------[]-E---------
------XX---------XXXXXXXXXX-XXXXXXXXXXXXXXXXXXXXXXXXXXXXXXXXXXXXXXXXXX--XXX-XXX--XX-XXXXX--XXXXXXXXXXXXXXXXXXXXX--------------X-----XXXXXXXXXXXXXXXXXXXXXXXXXXX----XXXXXXXXXXXXXXXXXXXXXXXXXXXXXXXXXXXXXXXXXXXXXXXXXXXXXXXXXXXXXXXXXXX--XXXXXXXXX--XXXXXXXXXXXXXXXXXXXXXXXXXXXXXXXXXXXXX
