--------------------------------------------------------X-------------------------------------------------------------------------------------------------------------------------------------------------------------------------------------------------------------------------------
-----------------------------------------------------------------------------SS----S----------------------------------------------------------------------------------------------------------------------------------------------------------------------------------------------------
--------------------------------------------------------SSSSSSSSSSSSSSSSSSSSSSSSSSSS------------------------------------------------------------------------------------SSSSSSSSSSSSSSSSSSSSSSSSSSSS------------------------------------------------------------------------------------
--------------------------------------------------------?SSSSSSSSSSSSSSS----SSSSSSSS----------------------------------------------------------------------------------------------------------------------------------------------------------------------------------------------------
---------------------------------------X----------------SSSSSSSSSSSSSSSS----SSSSSSSS----------------------------------------------------------------------------------------------------------------------------------------------------------------------------------------------------
-------------E---E---------------------------------------SSSSSSSSSSSSSSS----S-----SS--XX------------------------------------------------------------------------------------------------------------------------XXX---------------------------------------------------------------------
------XX-------------XXXXX------------------------------ES-S-----------------------------------------------------------------------------------------------X----------------------------------------------------------------------------------------------------------------------------
------------------------------------------------------------------S---------------------------------------------------------------------------------------XX----------------------------------------------------------------------------------------------------------------------------
------------------------------------------------------------E-----S------------??------------------------------------------------------------------------XXX----------------------E---------------------S----------------------E--------------------------------------------------------
----------------XSS------------------------Q---------------SSSSSSSSS-------E--<>--XX----------------------S-SSSS-------------XXX--------------------------XX---------------S----S<>------------------X--------------------------------------------------------------------XXX-----------
-EXX----------------------------------E------------------SSSSSSSSSS-------<>--[]-------------------------------------------XXXXX----------------------XXXXXX---------------------[]------------------X------------------------------------E---------------E-----------------------------
XXXX---------------------------------<>-----------------SSSSSSSSSSS-------[]--[]------------------------------------------XXXXXX----------------------XXXXXX---------------------[]-----<>-XX--------------------------------------------<>--------------<>-----------------------------
-------------------------------------[]-----------------SSSSSSSSSSS-------[]E-[]--XX-----EEEE---E--------E-E-------------XXXXXXX--------E--E-E-E-----XXXXXXX--------E--EE-----E--[]-----[]----------XXX----------------------------------[]--------------[]-----------------------------
---------X------------------XXXXXXXXXXXXXXXXXX-------XXXXXXXXXXXXXXXXXXXXXXXXXXXXXXX-----XXXXXXXXXXXXXX-XXXXXXXXXXXXXXXXXXXXXXXXXXXXXXXXXXXXXXXXXXXXXXXXXXXXXXXXXXXXXXXXXXXXXXXXXXXXXXXXXXXXX--XXXXX------XXXXX----XXXXXXXXX----XXXXXXXXXXXXXXXXXXXXXXXXXXXXXXXXXXX---XXXXX----XXXXXXXXX
