----------------------------------------------------------------------------------------------------------------------------------------------------------------------------------------------------------------------------------------------------------------------------------------
-----------------------------------------------------------------------------------------------------------------------------------------------------------E----------------------------------------------------------------------------------------------------------------------------
--------------------------------------------------------------------------------------------------------------------SSSSSSSSSSSSSSSSSSSSSSSS--------------<>----------------------------------------------------------------------------------------------------------------------------
-------------------------------------------X--------------------------------------------------------------------------------------------------------------[]---------S-S-------------------------------------------X--------------------------------------------------------------------
-------------------------------------------X---------------------------------------------------------------------------------------------------EE---------[]-----E----SS-------------------------------------------X--------------------------------------------------------------------
-----------------SSS-----------------------X--------------------------------------------------------------------SS--------------------------?--SSS??S--------??SSS------E------------------------------------------X-------------------------------------------------------X------------
------------------------------------------XX-------------------------------------------------------------------------------------------------------------------------------XXXXX-------------XXXXX----------------XX------------------------------------------------------XXX-----------
-----------------------------------------XXX---------------------------------------------------------------------------------------------------------------------------------------------------------------------XXX-----------------------------------------------------XXXX-----------
----------------------------------------XXXX------------------------------------------------------------------------------------------------X-XX----------------------------------------------------------------XXXXXE-------------------------XX-----------------------XXXXXE----------
--------------------------E------------XXXX---------------------------------------------------------------------SSS--------------X-------------XXSSS-----XX----------XX--------------XXXXXXXS------------------XXXXX---------------------------XX----------E-----------XXXXXX-----------
-------------------------<>-----------XXXXXX-----E-----<-----E----------E----E--------------------------------------------------XXXX-------X------SS----X------------XX---------------------------------------XXXXXX-----E-----<---------------XX---------<>----------XXXXXXX----------<
-------------------------[]----------XXXXXXX-----------[----<>---------<>---<>-----[-------------------------------------------XXXXXX------X-----SS------------------XX--------------------------------------XXXXXXX-----X-----[---------------XX---------[]---------XXXXXXXX----X-----[
-------------------------[]---------XXXXXXXX--------EE-[----[]---------[]---[]-----[----------------------------]-----E-------XXXXXX-------X--------------------E-E--XX----------------------E-------E-EE---XXXXXXXX-----X-----[-E-EE------E-XXXX---------[]-E-E----XXXXXXXXX----X--E--[
XXXXXXXXXX-X--------XXXXXXXXXXXXXXXXXXXXXXXXXXXXXXXXXXXXXXXXXXXXXXXXXXXXXXXXXXXXXXXXXXXXXXXXXX--XXXXXXXXXXXXXXXXXXXXXXXXXXXXXXXXXX-----X---X------XX--------XXXXXXXXXXXXX----X------XXX---XXXXXXXXXXXXXXXXXXXXXXXXXXXXXXXXXXXXXXXXXXXXXXXXXXXXXXXX----XXXXXXXXXXXXXXXXXXXXXXXXXXXXXXXXXX
