----------------------------------------------------------------------------------------------------------------------------------------------------------------------------------------------------------------------------------------------------------------------------------------
----------------------------------------------------------------------------------------------------------------------------------------------------------------------------------------------------------------------------------------------------------------------------------------
-------------------------------------------------------------------------------------------SSSSSSSSSSSSSSSSSSSSSSSSSSSSSSSSSSSSSSSSSSSSSSSSS--------------------------------------------------------------------------------------------------------------------------------------------
----------------------------------------------------------------------------------------------------------------------------------------------------------------------------------------------------------------------------------------------------------------------------------------
----------------------------------------------------------------------------------------------------------------------------------------------------------------------------------------------------------------------------------------------------------------------------------------
----------------------XXXX--------SQQQQQQ-----------SSSS------------------------XXX--S-------------------------------------------------------------S---------SSS---------------------------------------X--------------------------------------------------------------------------------
----------------------------------------------------------------------------------------------------------------------------------------------------------------------------------------------------------------------------------------------------------------------------------------
---------------------------------------------------------------------------------------------------------------------------------S------------------------------------------------------------------------------------------------------------------------------------------------------
---------------------------------------------------------------------------------------------------------------------------------S-S-----------------------------------------E----------E--------------------------------------------E----------E---------------------------------------
X---------------XXXX----------E--SSS-SSSQ------------------------------X------------SS--------------------------SSSS----S-S------X-XX-X----XSXXXX-------------XX------------<>---------<>------------------------------------------------------<>---------------------------------------
--------------XXX------------<>----------------------------------------XX----------------------------X-X--------[----------------X-XX-X----X-------E---EX-----X----E--------[]---------[]--------------------------------------------E---------[]---------------------E-----------------
-----------------------------[]----------------------------------------XX--------------------------XXXXX--------]--------------X[]-XX-X----X------<X----------X---<>--------[]---------[]-------------------------------------------<>---------[]--------------------->-----------------
-----------------------------[]---------------EE-----------------------XX-----------------E-------XXXX-X--------]-----E-------X-[]-XX------X------[]-------XX-X-E-[]-X------[]---------[]----------X--------E---E--------E-E--------[]---E-----[]---------E----------[]--------------EE-
---------XXXX-------------XXXXXXXXXXXXXXXXXXXXXXXXXXXXXXXXXXX--XXXXXXXXXXXXXX----XXXXXXXXXXXXXXXXXXXXXXX---XXXXXXXXXXXXXXXXXXXXXXXXXXXXXXXXXXXXXXXXXXXXXXX-XXXXXXXXXXXXXXXXXXXXXXXXXXXXXX--XXXXXXXXXXX---XXXXXXXXXXXXXXXXXXXXXXXXXXXXXXXXXXXXXXXXXX----XXXXXXXXXXXXXXXXXXXXXXXXXXXXXXXXX
