----------------------------------------------------------------------------------------------------------------------------------------------------------------------------------------------------------------------------------------------------------------------------------------
----------------------------------------------------------------------------------------------------------------------------------------------------------------------------------------------------------------------------------------------------------------------------------------
----------------------------------------------------------------------------------------------------------------------------------------------------------------------------------------------------SSSSSSSSSSSSSSSSSSSSSSSSSSSS--------------------------------------------------------
----------------------------------------------------------------------------------------------------------------------------------------------------------------------------------------------------------------------------------------------------------------------------------------
--------------------------------------------------------------------------------------------------------------------------------------------------------------------------------------------------------------------------------------------------------------XXXXXX--------------------
---------------------------------------------------XXX------------------------SSS------S-------------------------------------------------------------------------XXXXXX---------------------------------------------------------------------------------XXXX-----------------SSSSSSSSS--
----------------------------------------------------------------------------------------------------------------------------------------------------------------------------------------------------------------------------------------------------------------------------------------
----------------------------------------------------------------------------------------------------------------------------------------------------------------------------------------------------------------------------------------------------------------------------------------
--------------------------------------------------------------------------------------------------------------------------------------------------------------------------------------------------------------E-------------------------------------------------------------------------
-------------------------------------------XXXXSSS------XQQQ--------------EXXX------------------------------------------------QQ----------E----------------XXXX----------------------XXXX--------------S----S<S--------------------------------------S-SS----XXXX---------X---XXXX------
----------------E----------------------------------------------------XXXXXXXX------------------------------------------------------------<>----------------------------------------XXXX----------------S-----S---------<>------------------------------------------E---EXX--------------
---------------<>----------------------------------------------------------X--------------------------X----------------------------------[]---------------------------------------XXXXX----------------S-----[]-----<>-[]------------------------------------------X--------------------
----EE----E----[]----------E--------------------------------------------------------------------------X------------------E---------------[]--------------------------------------XXXXXX---------E---E-----E--S------[]-[]--------------------------------------------------X------------
XXXXXXXXXXXXXXXXXXXXXXXXXXXXXXX-----XX--XXXXXXXXXXXXXXXXXXX-XX--XXXXX-------------XXXXXXXXXXXXXXXXXXXXXXXXXXXXXXXXXXXXXXXXXXXXXXXXX--XXXXXXX--------XX-------XXXXXX---XXXXXXXX---XXXXX-----X-X--X---XXXXXXXXXXXXXXXXXXXXXXXXXXXXXXXXXXXXXXXXXXXXXXXXXXXXXXXX---------------XXXXXXXXXXXXX
