----------------------------------------------------------------------------------------------------------------------------------------------------------------------------------------------------------------------------------------------------------------------------------------
-----------------------------------------------------------------------------------------------------------------------------------------------------------------------------------------------------------------------------------------------E----SS-----S----------------------------
-----------------------------------------------------------------------------------------------------------------------------------------------------------------------------------------------------------------------------------SSSSSS-----<>----SSS---SS----------------------------
-----------------------------------------------------------------------------------------------------------------------------------------------------------------------------------------------------------------------------------SSSSSSSSSSSSS----SS-SSSSS----------------------------
------------------------------------------------------------------------------------------------------------------------------E----------------------------------------------------------------------------------------------------SSSSSSS----SS----SSS-SSSS----------------------------
---------------------------------------?SSS---------------------------------------------------------------------E--E--E------E---E------------------Q-QSS--------------S--------------------------------------------------------?--SSSSSSSSSSSSS----SS----SS----------------------------
-----------------------------------------------------------------------------------------------------------------XXXXXXXX------------XXXXX---------------------------------------------------------------------------------------E------------------------------------------------------
--------------------------------------------------------------------------------------------------------------------------------------------------------------------------------------------------------------------------------]-------------------------------------------------------
--------------XX-------------XSSSSSSS-----------------E---------------------------------------------------------------------------------------------------------------------------------------------------------------------------------------------------------------------------------
------------XXXX------------------------SS-----------<>--------------XXX-------------------------XXXXX----------X------------XXXXXXSSS-----Q--E--QQ--SS?----E--------------------------<>------------------------------------------?SSSSSS---------------XXX-------------------------SSS
----------XXXXXX-------------X-----------------------[]-------------XXXX---------------------------------------------------------------------<>------------<>------E---------E---------[]-----------------------------------------------------------------------------E-----------------
---------XXXXXXX-------------------------------------[]-----------XXXXX--------------------------X--------------XXXX-------------------------[]--X---------[]-----<>--------<>---------[]----X---------------------------------------X--------------------------------------------------
--------XXXXXXXX--------E--EXX-----------------------[]----------XXXXXXX--------E--------------X-X----------E----------------E-------E-E-----[]------------[]-EE--[]-----E--[]-----E-E-[]----------------------------------------------------------EE-E------------E-EE-----------------
XXXXXXXXXXXXXXXXXXXXXXXXXXXX---XXXXXXXX--XXXXXXXXXXXXXXXXXXXXX---XXXXXX--XXXXXXXXXXXXXXXXXX---XXXX-----XXXXXXXXX------------XXX---XXXXXXXXXXXXXXXXXXXXXXXXXXXXXXXXXXXXXXXXXXXXXXXXXXXXXXXXXXXX-XXXXX-----X--XXXXXXXXX----XXXXXXXXXXXXXXXXXXXXXXXXXXXXXXXXXXXXXXXXXXXXXXXXXXXXX----XXXXXX
