----------------------------------------------------------------------------------------------------------------------------------------------------------------------------------------------------------------------------------------------------------------------------------------
----------------------------------------------------------------------------------------------------------------------------------------------------------------------------------------------------------------------------------------------------------------------------------------
----------------------------------------------------------------------------------------------------------------SSSSSSSSSSSSSSSSSSSSSSSSSSSS-----------------------------------------------------------SSSSSSSSS-SSS----------------------------------------SSSSSSSSSSSSSSSSSSSSSSSSS---
------------------------------------------------------------------------------------------------------------------------------------------------------------------------------------------------------S---SSSSS-------------------EE---------------------S-S----------------------------
-----------------------------------------------------------------------------------------------------------------------------------------------------------------------------------------------------------SSSS------------------XXXXX---------------E---SSS----------------------------
----------------------------X----SSSQQSSSSS-----------------------------------------Q-----------------E----X-----------------------------------------------------------------------------------------SSSSSSSSSS---SS----------SS?----------------SSSS-----------------------XXX---------
----X------------------X-X--------------------------------------------------------------E------------->---------------------------------------------------------------------------------------------------------------------------------------------------------------------XXX---------
----------------------------X----------------------------------------------------------------------------------------------------------------------------------------------------------------------------------------------------------------------------------------------XXXX---------
----------------------------X-------------------------?---------------------------------------------------------E---------E------------E---------E----------E--------------------------------------------------------------------------------------------------------------XXXX---------
-------------XXXXX----------------SSSSQSQQQ----------<]-----------------------SS----X------------XXEXX-------------S-----<>-----------[]--------<>---------<>--------------------------XX--------------SSSSSSSS--------E--------XXXXX---------E---XXXX---XXX--------Q-XX----XXX---X-----
---------------------------------------------------E-[]-----------------E-----------X------------XXXXXX-----------E------[]---------E-[]---X----[]---------[]----------E---------------XX----------E------------------<>---------------X---EXX-------------->-----------EXX-XXX---X-----
--------------------------------------------------[]-[]----------------<>-----------X------------XX-------------SS-S-----[]--------<>-[]---X----[]---------[]---------E---------------XXX---------<>------------------[]--------------XX-----------------XX-]---------X-XXXXXXX---X----X
-----------------------------------------------EE-[]-[]-----EE---E-----[]---------------------------------------S--------[]--------[]-[]---X----[]---------[]---------[]---E-------E-XXXX---------[]------------------[]--------------[]-------XX---XXX--XX-]E-E--------XXXXXXX---X----X
XXX-X----XXX----------------XXXXXXXXXX-XXXXXXXXXXXXXXXXXXXXXXXXXXXXXXXXXXXXXXXXXXXXXXXXXXX---XXXXX--------------XXXXXXXXXXXXXXXXXXXXXXXXXXXX-XXXXXXXXXXXXXXXXXXXXXXXXXXXXXXXX-XXXXXXXXXXXXX---XX--XXXXXXXXXXXXXXXXXXXXXXXXXXXXXXX-----XX-----------------XX-XXXXXXXXXXXXXXXXXX----XXX--X
