----------------------------------------------------------------------------------------------------------------------------------------------------------------------------------------------------------------------------------------------------------------------------------------
----------------------------------------------------------------------------------------------------------------------------------------------------------------------------------------------------------------------------------------------------------------------------------------
------------------------------------------------------------------------------------SSSSSSSSSSSSSSSSSSSSSSSSSSSS--------------------------------------------------------------------------------------------------------------------------------------------SSSSSSSSSSSSSSSSSSSSSSSSSSSS
------------------------------------------------------------------------------------SSSSSSSSSSSSS-------SSSSSSSS------------------------------------------------------------------------------------------------------------------------------------------------------------------------
------------------------------------------------------------------------------------SSSSSSSSSSS---------SSSSSSSS------------------------------------------------------------------------------------------------------------------------------------------------------------------------
-XXX--------------------------SSSSSSSS---SSS------SSSSSS----------------------------SSSSSSSSSS---SS-----------SS---------------------------------SSSSSSSS-----------SSSS-------------------------------------------------------------------------------------S-----SS-------------------
--------------------------------------------------------------------------------------------------------------------------------XXXX----------------------------------------------------------------------------------------------------------------------------------------------------
--------------------------------------------------------------------------------------------------------------------------------------------------------------------------------------XX------------------------------------------------------------------------------------------------
-------------------------------E-----------------------------------------------------?EE-------------------E------------------------------E------------------------------------------XXXX---------------------------E--------------------------------------------------------------E----
-------------------------SSS--SSSSSSSS---------E------------------------------------SSSSSSSSS----------EX-<>---X-X------------------------SS-----SSSSSSS-----------------------------XXX-----------------E---------<>----------ESQQQ--------------XXX-------SSSSS--SS----------XX-<>---X
-----------------------------------S----------<>------------------E---------------E-----SSSSSS--------<>--[]-----X----------------------------------------------------------------XXXXXXX---------------<>---------[]------E--<>-------E---------XXXX--------------S---------X-XX-[]---X
---------------------------------X------------[]-----------------<>--------------<>----SSSSSS-------XX[]--[]----XXX--------------------------------------------------------------XXXXXXXX---------------[]---------[]-----<>--[]------<>--------XXXXX-------------<>--------XXXXX-[]---X
-------EE--------------E----------------------[]-----------------[]--------------[]----SSSSSS-------XX[]X-[]---XXX--------------------------------------------EE----------------XXXXXXXXXX------E-------[]---------[]-----[]--[]------[]-------XXXXXX------X]-----[]-------XXXXXX-[]--XX
XX--XXXXXXXXXXXXX----XXXXXXXXXXXXXXXXXXXXXXXXXXXXXXXXXXXXXXXXXXXXXXXXXXXX-------XXXXXXXXXXXXXXXXXXXXXXXXXXXXXXXX-----XXXXXX---XX------XXXXXXXXXXXXXXXXXXXXXXXXXXXXXXXXXXXXXXXXXXXXXXXXXXXXXXXXXXXXXXXXXXXXXXXXXXXXXXXX----XXXXXXXXXXXXXXXXXXXXXXXXXXXXXXXXXXXXXXXXXXXXXXXXXXXXXXXXXXXXXX
