----------------------------------------------------------------------------------------------------------------------------------------------------------------------------------------------------------------------------------------------------------------------------------------
----------------------------------------------------------------------------------------------------------------------------------------------------------------------------------------------------------------------------------------------------------------------------------------
SSS-------------------------------------------------------------------------------------------------------------SSSSSSSSSSSSSSSSSSSSSSSSSSSS--------------------------------------------------------------------------------------------------------------------------------------------
-------------------------------------------X---------------------------------------------------------------------------SS---------------------------------------------------------------------------------------------------------------------------------------------------------------
-----------------------------------------------------------------------------------------------------------------------SSS--------------------------------------------------------------------------------------------------------------------------------------------------------------
----------S--------------------------------E----------------------------S-S--------------------------------X-----SSSS--SSS----------------S---------------------------------------------------------------------------------------------------------------------------------------------
------------------------------------------XX--------------------------------------------------------------------------------------------------------------------------------------------------------------------------------------------------------------------------------------------
------------------------------------------XX--------------------------------------------------------------------------------------------------------------------------------------------------------------------------------------------------------------------------------------------
----------E------------E----------------XXXX-------------------------------------------------------------------------------------------SS-----------------------------------------------------------------------------------------------------------------------------------------------
--E--S---<>-----------<>----------------XXXX-----------------E---------<>----------E--------------XXXXXX--------SSSSS--SS----------E----------------------------------------------------------------------------------------SSS------------------------------------------------------SSS
-<>------[]-----------[]--------------XXXXXX----------------<>---------[]------E--<>-----------------------------------SS---------<>--------------------------------------------------------------------------E-------------------------------------------------------------------------
-[]------[]-----------[]-------------XXXXXXX----------------[]---------[]-----<>--[]-------------------------------S--SSS-------XX[]X--------------------------------XX--------------------------------------<>-------------------------------------------------------------------------
-[]------[]-----------[]------------XXXXXXXX--------E--E-E--[]-----E-E-[]-----[]--[]----------------------------------SS----------[]X------------------------------------------------------------------------[]-----------------------------EE---------E-----------E-EE------------E--E-
XXXXXXXXXXXXXXXXXXXXXXXXXXXXXXXXXXXXXXXXXXXXXXXXXXXXXXXXXXXXXXXXXXXX---XXXXXXXXXXXXXX---XX---XXXXXX--XXXXXXXXXXXXXXXXXXXXXXXXXXXXXXXXXXXXXXXXXXXXXXXXX-XXXXXXXXXX----XX-XXXX-XXXXXXXXXXXX----XXXXXXXXXXXXXXXXXXXXXXXXXXXXXXXXXXXXXXXXXXXXXXXXXXXXXXXXXXXXXXXXXXXXXXXXXXXXXXXXXXXXXXXXXXX
