------------------------------------------------------------------------------------------------------------------------------------------------------------------------------------------------------------------------------------------------------------X---------------------------
----------------------------------------------------------------------------------------------------------------------------------------------------------------------------------------------------------------------------------------------------------------------------------S-----
------------------------------------------------------------------------------------------------------------------------------------------------------------------------------------------------------------------------------------------------------------SSSSSSSSSSSSSSSSSSSSSSSSSSSS
------------------------------------------------------------------------------------------------------------------------------------------------------------------------------------------------------------------------------------------------------------SSSSSSSSSSSSSSSS----SSSSSSSS
------------------------------------------------------------------------------------------------------------------------------------------------------------------------------------------------------------------------------------------XX----------------SSSSSSSSSSSSSSSS----SSSSSSSS
--------------------------------------------------------------------------------XXXX---------------------------------------------E---------------------------------XXXXX-------------------------------------QSSSSS---------SSSS----------------------------SSSSSSSSSSSS-SSS--------S-SS
--------------------------------------------------------------------------------------------------------------------------------XXXXX-----------------------------------------------------------------------------------------------------------------------SS-S------------------------
----------------------------------------------------------------------------------------------------------------------------------------------------------------------------------------------------------------------------------------------------------------------S-----------------
-----------------------------------------------------------------------------------------------------------------------------------------------------------------------------------------------------XSSS-------------------------------------------------------E-----S------------??---
---------------QQ------------------------------------SSS---------------------S-SS------------------XX-------------------------------------SS-----------------------------------------------------QQ------------SSSSS---------------------------Q-------------SSSSSSSSSSS-------E------XX
---------------------------------------------------------------------------------------------------XX-------------------------------------------------------------------------------------------------------------------------------------E------------------SSSSSSSSSS-------<>--------
---------------------------------------------------------------------------------------------------XX-----------XXXX---------------------------------------------------------------------------------------------------------------------<>-----------------SSSSSSSSSSS-------[]--------
--------------------------E--------E-E-----------------------------------------------E-EE------E-XXXX--------------------------------------------------------------------------E-E-------------------------------------------------------[]-----------------SSSSSSSSSSS-------[]X-------
XXXXXXXXX--XXXXXXXXXXXXX-XXX---XXXXXXXXXXXXXXXX---XXXXXXXXXXXXXXXXXXXXXXXXXXXXXXXXXXXXXXXXXXXXXXXXXXXXXXXXXXXXXX-----XXXXXX-XXXXX----XXXXXXX-XXX---XXXXXXXXXXXXXX------XXXXXXXXXXXXXXXXXXX-----XXXXXXXXXXXXXXXXXXXXXXXXXXX-X----XXXXXXXXXXXXXXXXXXX----XXXXXXXXXXXXXXXXXXXXXXXXXXXXXXXXX
