----------------------------------------------------------------------------------------------------------------------------------------------------------------------------------------------------------------------------------------------------------------------------------------
----------------------------------------------------------------------------------------------------------------------------------------------------------------------------------------------------------------------------------------------------------------------------------------
----------------------------------------------------------------------------------------------------------------SSSSSSSSSSSSSSSSSSSSSSSSSSSS--------------------------------------------------------SSSSSSSSSSSSSSSSSSSSSSSSSSSS--------------------------------------------------------
----------------------------------------------------------------------------------------------------------------------------------------------------------------------------------------------------SSSS-SSSSSSS------------------------------------------------------------------------
----------------------------------------------------------------------------------------------------------------------------------------------------------------------------------------------------SSSS--SSSSS-------------------------------------------------------------------------
------------------------------------------------------------------------X-----------------SQQQQQQ--------------S----------------X---------------------------------------------SSSSSSS--------------S-SSS--SSSSS----------------------------XXX-----------------------------X------------
-------------------------------------------------XXXXX------------------X-------------------------------------------------------X--------------------------------------------------------------------S---------------------------------------------------------------------X------------
--------------------------------------------------------------------------------------------------------------------------------XS----------------------------------------------------------------------------S-----------------------------------------------------------XX------------
------------------------------------------------------------------------XX------------------------------------------------------XXXS-----------------------------------------------------------E--------E-----S------------S------------------------------XX------------XXXX------------
-------------------------------------------XXX-----------E--------------X-------------E--SSS-SQSQ---------------<>------Q---X----X----X-----------------------------------E--SSS-SSS----------<>-------SSSSSSSSS--------E------X-X--------------------------------------XXXX------------
----------------E---------E-----------------------------<>-------X------X------------<>--------------------E----[]--------------XX---XX----------------------------------<>-------------------[]-----SSSSS--SSS--------<>------X-X------------------------------------XXXXXX------------
---------------<>--------<>-----------------------------[]----------XXXXXX-----------[]-------------------<>-X--[]----------XXXXXX---XX----X-----------------------------[]-------------------[]----SSSSSSS-SSS--------[]------X-------------------------------------XXXXXXX------------
----EE---------[]--------[]-----------------------------[]-E--------XXXXXX-----------[]----------------EE-[]-X--[]----------XXXXXX---XX----X------------------E----------[]---------------EE--[]----SSSSS-SSSSS--------[]----XXX-X-----------------------------E----XXXXXXXX--------E--E
XXXXXXXXX-XXXX-XXX--XXXXXXXX---------X------------------XXXXXXXXXXXXXXXXX--XXXXXXXXXXXXXXXXXXXXXXXXXXXXXXXXXXXXXXXXXXXXXXXXXXXXXXX---XXXXXXXXXXXXXXXX--XXXXXXXXXXXXXXXXXXXXXXXXXXXXXXXXXXXXXXXXXXXXXXXXXXXXXXXXXXXXXXXXXXXXXXXXX------XXXXX---XX--XXXXXXXXXXXXXXXXXXXXXXXXXXXXXX-X--XXXX
