----------------------------------------------------------------------------------------------------------------------------------------------------------------------------------------------------------------------------------------------------------------------------------------
----------------------------------------------------------------------------------------------------------------------------------------------------------------------------------------------------------------------------------------------------------------------------------------
----------------------------SS-----------------SSSSSSSSS----------------------------SSSSSSSSSSSSSSSSSSSSSSSSSSSS---------------------------------SSSSSSSSSSSSSSSSSSSSSSS----------------------------------------------------------------------------------------------------------------
--------------------------------------------------------------------------------------S----SSS------------------------------------------------------------------------------------------------------------------------------------------------------------------------------------------
--------------------------------------------------------------------------------------SS---SSS?---------------S-------------------------------------------------------------------------------------------------------------------------------------------------------------------------
------------------------------------------------------------------------------XXXX--SSSSS--SSS---S------------S----------------------------------------------------SS---------------------------SS--------------------------XXX------------------------------X--------------------------
-----------------------------------------------------------XXX--------------------------------------------------------------------------------------------------------------------------------------------------------------------------------------------------------------------------
----------------------------------------------------------------------------------------------------------------------------------------------------------------------------------------------------------------------------------------------------------------------------------------
--------------------------------------E--------------------------------------------------------------------SS------------------------------------------------------SS-------------------------------------------------------------------------------------------------------------------
--------------------------SS-----S---<>-----E-------------------------XXXXXX--------SSSSS--SSSS--------E-------X-------------XXXXX----------SSSS------------------------------------XX----------------------------XX----------------------------------SSSSSS----------------------------
-------------------------------------[]----<>---E------X-------------------------------SS--SSS--------<>-------X-----------------------------------E---------XXXX-------------------------------------------------XX----------------------E----------------------------------------E----
-------------------------------------[]----[]--<>-----XX-------------------------------SS-SSSS------XX[]X------X----------------------------------<>--------XXXXX------------------------------------------------XXX---------------------<>---------------------------------------<>----
-------------------------------------[]----[]--[]----XXX-------------------------------SS-SSSS------XX[]X----XXX---------------------E------------[]-------XXXXXX----------------------------------------------EXXXX-------------------E-[]---------------------------------------[]----
XX---XXXXX----XXXXXXXXXXXXXXXXXXXXXXXXXXXXXXXXXXXXXXXXXX--------XXXX----------------XXXXXXXXXXXXXXXXXXXXX-XX-XXX--------XXXXXXX---XXXXXXXXXXXXXXXXXXXXXXXXXXXXXXX----XXX---X--XXXXXXXXXXXXXXXXXXXX-X-XXXX---XXXXXXXXXXXXXXX-XXXXXXXXXXXXXXXXXXXXXXXXXXXXXXXXXXXXXXXXXXXXXXXXXXXXXXXXXXXX
