----------------------------------------------------------------------------------------------------------------------------------------------------------------------------------------------------------------------------------------------------------------------------------------
----------------------------------------------------------------------------------------------------------------------------------------------------------------------------------------------------------------------------------------------------------------------------------------
----------------------------------------------------------------------------------------------------------------------------------------------------------------------------------------------------------------------------------------------------------------------------------------
----------------------------------------------------------------------------------------------------------------------------------------------------------------------------------------------------------------------------------------------------------------------------------------
----------------------------------------------------------------------------------------------------------------------------------------------------------------------------------------------------------------------------------------------------------------------------------------
--SSSSSSSS---SSS------SSSSSS-------------------------------------------------------------SSSSSSSS-----------SSSS--------------------------------------------------------------------------X----XXX--------------------------------------------------------------------------------------
------------------------------------------------------------------------XXXX-------------------------------------------------------------------------------------------------------------XX---------------------------------------------------------------------------------------------
------------------------------------------------------------------------------------------------------------------------------XX---------------------------------------------------------XX----------------------------------------------------X----------------------------------------
---E------------------------------------------------------------------------------E------------------------------------------XXXX---------------------------------------SS-------------XXXX----------------------------------------------------X----------------------------------------
--SSSSSSSS---------E-------------------------------------X------------------------SS-----SSSSSSS-----------------------------XXX------------SQQQ--------------XXX-------E-------------XXXXX--------------E----------E------------------------------------------------------X------------
-------S----------<>------------------E---------------E--X----------------------------------------------------------------XXXXXXX------------------E---------XXXX-------X------------XXXXXX-------------<>---------<>---E----------------------X----------------------------------------
-----X------------[]-----------------<>--------------<>-XXX--------------------------------------------------------------XXXXXXXX-----------------<>--------XXXXX--------------------XXXXXX-------------[]---------[]--<>----------------------X----------------------------------------
------------------[]-----------------[]--------------[]-XX--------------------------------------------EE----------------XXXXXXXXXX------E---------[]-------XXXXXX------X-----------XXXXXXXX-------------[]---------[]--[]--------E--------EE--EX----------------------------------------
XXXXXXXXXXXXXXXXXXXXXXXXXXXXXXXXXXXXXXXXXXXXX-------XXXX-----XXXXXX---XX------XXXXXXXXXXXXXXXXXXXXXXXXXXXXXXXXXXXXXXXXXXXXXXXXXXXXXXXXXXXXXXXXXXXXXXXXXXXXXXXXXXXXXXXXXXXXXXXX-XXXXXXXXXXXXX-------X-XXXXXXXXXXXXXXXXXXXXX-XXXXXXXXXXXXXXXXXXXXXXXXXXXXXXXXXXXXXXX--XXXXXXXX---XXXXXXXXX
