----------------------------------------------------------------------------------------------------------------------------------------------------------------------------------------------------------------------------------------------------------------------------------------
----------------------------------------------------------------------------------------------------------------------------------------------------------------------------------------------------------------------------------------------------------------------------------------
----------------------------------------------------------------------------------------------------------------SSSSSSSSSSSSSSSSSSSSSSSSSSSS--------------------------------------------------------------------------------------------------------------------------------------------
----------------------------------------------------------------------------------------------------------------------------------------------------------------------------------------------------------------------------------------------------------------------------------------
----------------------------------------------------------------------------------------------------------------------------------------------------------------------------------------------------------------------------------------------------------------------------------------
----------------------------------------------------X-XX--------------------------XX-XXX----------------------------------------XX------------SS---SS--------------------XXX-------------------------------------X------XXXXXXX---------------------------------SSSSSSSSS--S-----------S
-------------------------------------------------------------------------------------------------------------------------------XXX------------------------------------------------------------------------------------------------------------------------------------------------------
-------------------------------------------------------------------------------------------------------------------------------XXXX-----------------------------------------------------------------------------------------------------------------------------------------------------
----------------E-------------------------------------------------------E-----------------------------------------------------XXXXXS----------E-------------------------------------------------------------------------------------S-SSS-----------------------------------------------
---------------<>------------------------------------------------------<>----------------------------------------E------Q-XXXX--XX----X-----SSSSS-------------XX------X------------------------------X---------------?S-SS------------------S?S-----------E------SSSSSSS----------------
---------------[]---------E--------------------------------------------[]---------------------------------------<>--------X-XXX-XX---XX------------E----------X--------------------------------------X---------------------------------------------------<>------------------------E----
---------------[]--------<>--------------------------------------------[]---------------------------------------[]-------XXXXXXXXX---XX-----------XX--------X-XX-----------------------------------------------------------------------------------------[]-----------------------<>----
---------------[]--------[]---------------------------------E----------[]-------------------------------------E-[]-E--------XXXXXX---XX--------------------XX-X----------------EE------------------------------------------------------E-E---------------[]--------------------EE-[]----
XXXXXXXXX-XXXXXXXXXXXXXXXXXXXXXXXXXXXXXXXXXXXXXXXXXXXXXXXXXXXXXXX-XXXXXXXXXXX----XXXXXXXXXXXXXXXXXXXX--------XX-XXXXXXXXXXXXXXXXXX---XXXXXXXXXXX-XXXXXXXXX-XXXXXXXXXXXXXXXXXXXXXXXXXXXXXXX---XXXXXXX-------XXX----XXXXXXXXXXXXXXXXXXXXXXXXXXXXXXXXXXXXXXXXXXXXXXXXXXXXXXXXXXXXXXXXXXXXXX
