----------------------------------------------------------------------------------------------------------------------------------------------------------------------------------------------------------------------------------------------------------------------------------------
----------------------------------------------------------------------------------------------------------------------------------------------------------------------------------------------------------------------------------------------------------------------------------------
----------------------------------------------------------------------------------------------------------------------------------------------------------------------------------------------------------------------------------------------------------------------------------------
----------------------------------------------------------------------------------------------------------------------------------------------------------------------------------------------------------------------------------------------------------------------------------------
---------------------------------------------------------------------------------------------------------------------------------------------------------------------------------------------------------------------------------------------------------------------XXX----------------
SS--------------------------?-SS-------------SSS-----------------------------------X----------------S----------------------------------XXX------------------------SSS------S----------------------------------------------------------------------------XXXX----------------------------
----------------------------------------------------------------------------------------------------------------------------------------------------------------------------------------------------------------------------------------------------------------------------------------
----------------------------------------------------------------------------------------------------X-----------------------------------------------------------------------------------------------------------------------------------------------------------------------------------
-----------------X------------EX-------------------------------------------------------------------XX-------------------------------------------------------------------------------------------------------------------------------------------------------------S---------------------
--------Q-------XX------------XXX--------XX----------XX----------------Q-------S-----E-------------XX--------------------------XXXXSSS------XQQQ--------------EXXX------------------------------------------------QQ----------E----------------------S-SS-----------------QQ----------E-
----------------XX---------E-------E----X------------XX-----------------------------<>-------X----XXX----X-----------------------------------------------XXXXXXXX------------------------------------------------------------<>------------------------------------------------------<>-
--------------XXXXX-------XX-------X--------X--------XX-----------------------------[]------------XXX----X-----------------------------------------------------X--------------------------X----------------------------------[]------------------------------------------------------[]-
--------------XXXXX-------XX--------------------XXX--XX----------E------------------[]-EE------E-XXXX----X--------------------------------------------------------------------------------X------------------E---------------[]--------------------------------------E---------------[]-
XXXXXXXX-XXXXXXXXX----XXXXXXX-----XX-----------------XX-XXXXXXXXXXXXXXXXXXXXXXXXXXXXXXXXXXXXXXXXXXXXXXXX---XXXXXXXX-----XX--XXXXXXXXXXXXXXXXXXX-XX--XXXXX-------------XXXXXXXXXXXXXXXXXXXXXXXXXXXXXXXXXXXXXXXXXXXXXXXXX--XXXXXXXXXXXXXXXXXXXXXXXXXXXXXXXXXXXXXXXXXXXXXXXXXXXXXX-XXXXXXXX
