----------------------------------------------------------------------------------------------------------------------------------------------------------------------------------------------------------------------------------------------------------------------------------------
----------------------------------------------------------------------------------------------------------------------------------------------------------------------------------------------------------------------------------------------------------------------------------------
----------------------------------------------------------------------------------------------------------------------------------------------------------------------------------------------------------------------------------------------------------------------------------------
----------------------------------------------------------------------------------------------------------------------------------------------------------------------------------------------------------------------------------------------------------------------------------------
------------------------------------X---------------------------------------------------------------------------------------------------------------------------------------------------------------------------------------------------------------------------------------------------
------------------X--------------------------XXX------------------------------XXXXX-S---------------------------------------------SS------------------------------------------------------------S---------------------------------------------------------------------------------------
-----------------XX--------------------------------------------------------------------------------------------------------------------------------------------------------------------------------------------------------X-----------------------------------------------XXX----------
---------------XXXX-------------------------------------------------------------------------------------------------------------------------------------------------------------------------------------------------------------------------------------------------------XXXX----------
--------------XXXXX------------XXXX------------------------------------------------------------------------------XXXX---------------------E------------------------------------------------------------------------------------------------------------------------------XXXXX----------
-------------XXXXXX---------------------XX----------------------------XXX-----------QQQQ--------------XXXX----XX------------XXX----------<>-------Q---------Q------------------------------------------------------XX---------------------------------SSSSSS----------X--XXXXX----------
-------------XXXXXX----------------------------------EX------------------------------------E-----XXX-XXXX--------------------------------[]-----------------------------------------------X---------------------------------------------------------------------------XXXXXXXX----------
-----------XXXXXXXX----------------------------------XX-----------------------------------<>----------XX---------------------------------[]---------------------------------------------X-X--------------------------------------------------------------------------XXXXXXXXX----------
----------XXXXXXXXX-----E--X--------------------------------------------------------------[]-------X--XXX-----------------------------E--[]---------------------------------------------XXX----------------------E---------------------EE----------------------------XXXXXXXXX------E---
XXXXXXX--XXXXXX--XXXXXXXX-XX-------XXXX-----------------XXXXXXX---XXXXXXXXXXXXXXXXXXXXXXXXXXXXXXXXXXXXXXXXXXXXXX------XX-------------XX-XXXXXXXXXXXXXXXXXXXXXXXXXXXXXXXXXXXXXXXXXXXXXXXXXXXXXXX--XXXXX------XXXXXX--------------X--XXXXXXXXXXXXXXXXXXXXXXXXXXXXXX----XXXXXXXXXXXXXXXX-XX
