----------------------------------------------------------------------------------------------------------------------------------------------------------------------------------------------------------------------------------------------------------------------------------------
----------------------------------------------------------------------------------------------------------------------------------------------------------------------------------------------------------------------------------------------------------------------------------------
SSSSSSSSSSSSSSSSSSSSSSSSSSSS--------------------------------------------------------SSSSSSSSSSSSSSSSSSSSSSSSSSSS--------------------------------------------------------------------------------------------------------------------------------------------SSSSSSSSSSSSSSSSSSSSSSSSSSSS
----------------------------------------------------------------------------------------------------------------------------------------------------------------------------------------------------------------------------------------------------------------------------------------
---------S------------------------------------------------------------------------------------------------------------------------------------------------------------------------------------------------------------------------------------------------------------------------------
-SSS----S--------------------------QQQQQ------------SSSS----------------------------------------------------------------------------------------------------------------------------------------------------S--------SSSS--------SSS-------------------SS----SSS----S-------------------
----------------------------------------------------------------------------------------------------XX----------------------------------------------------------------------------------------------------------------------------------------------------------------------------------
-----------------------------------------------------------------------------------------------------XX---------------------------------------------------------------------------------------------------------------------------------------------------------------------------------
----------E-----------------------------------------------------------------------------------------XXXS----------------------------------------------------------------------------------------------XX--------------------------------------------------------------------------------
---SS---SSS---------E-------------Q---QQQ-------------------------------------------<>------Q-S------X-X--X---------------------------SSSSSS--------------------------------------------E-------------XXX-------XXX----------XX-----------------------------SSSS---SSSS---------E-------
--SSS---SSS--------<>------X------------------------------------------------------E-[]--------------XX---XX----------------------------------------------------------------------------<>------------------------------------XX----------------X-------------------------------<>-------
SS-SS---SSS--------[]------------------------------------------------------------<>-[]----------XXXXXX-X--X----------------------------------------------------------------------------[]------------------------------------XX---------------------------------------------<>-XX-------
S-SSS-ESSSS--------[]-------------------------E----------------------------------[]-[]-E--E-----XXXXXX-X--X------X-----EEE-------------E----------------E------------EE----------------[]-E-----------------------------E-E--X------------------------------E-----E---------[]-XX-------
XXXXXXXXXXXXXXXXXXXXXXXXXXXXXXXXXXXXXXXXXXXXXXXXXX---X--XXXXXXXXXXXXXXXXXXXXXXXXXXXXXXXXXXXXXXXXXXXXXX----XXXXXXXXXXXXXXXXXXXXXXXXXXXXXXXXXXXXXXXXXXXXXXXXXXXXXXXXXXXXXXXXXXXXXXXXXXXXXXXXXXX----XXXXXX---XXX----XXXXXXXXXXXXXXXXXXXXXXXXXXXX---------------XXXXXXXXXXXXXXXXXXXX--XXXXXX
