------------------------------------------------------------------------------------------------------------------------------------------------------------------------X---------------------------------------------------------------------------------------------------------------
----------------------------------------------------------------------------------------------------------------------------------------------------------------------------------------------------------------------------------------------------------------------------------------
------------------------------------------------------------------------------------------------------------------------------------------------------------------------SSSSSSSSSSSSSSSSSSSSSSSSSSSS------------------------------------------------------------------------------------
------------------------------------------------------------------------------------------------------------------------------------------------------------------------SSSSSSSSSSSSSS---------S--SS-------------------------------------------X----------------------------------------
------------------------------------------------------------------------------------------------------------------------------------------------------------------------SSSSSSSSSSSSSS------------S-------------------------------------------------------------------------------------
----------------------------------------------------------------------------------------------------------------X---SS--QQSS----------------X---SSSSSSSS------SS---------SSSSSSSSSS--S------------SS----------------------SSSSSS---------------X----------------------------------------
---------------------------------------------------------------------------------------------------------------------------------------------------------------------------S------------------------------------------------------------------XXX---------------------------------------
-------------------------------------------XXX------------------------------------------------------------------------------------------------------------------------------------S----------------------------------------------------------XXXX---------------------------------------
-------------------------------------------XXX-------------------------------------------E----------E-------------X-----------------------E-X-X-----------------------------?-----S------------SS-------------------------------------------XXXXXX--------------------------------------
----------------E-------------------------XXXX--------------------------E-----<>--------<>---------<>------------------S?S-SSSS----------<>--------SS---?SS----------<>-SSSSSSSSSSSS--------E------X------------Q--------------------------XXXXXX-----------------------X---------------
---------------<>------------------------XXXXX-------------------------<>-----[]--------[]---------[]------------------------------------[]--------------------------[]-SSSSSSSSSSS--------<>------X--------------------------------------XXXXXXX----X-----------------XXX--------------
---------------[]-----------------------XXXXXX-------------------------[]-----[]--------[]---------[]------------------------------------[]--------------------------[]-SSSSSSSSSSS--------[]------X-------------------------------------XXXXXXXX----X-----------------XXX--------------
---------------[]-E-------------------XXXXXXXX-------------------------[]-----[]--------[]---E-----[]------------------------------EE-E--[]--------------------EE-E--[]-SSSSSSSSSSS--------[]------X----------------------------EE-E----XXXXXXXXXX---X-----X--------EXXXXX----------EE-E
XXXXXXXXXXXXXXXXXXXXXXXXXXXXXXXXXXXXXXXXXXXXXXXX---XXXXXXXXXXXXXXXXXXXXXXXXXXXXXXXXX-XXXXXXXXXXXXXXXXXXXXX-XXXXXXXXXXXXXXXXXXXXXXXXXXXXXXXXX--XXXXXXX---XXXXXXXXXXXXXXXXXXXXXXXXXXXXXXXXXXXXXXXXXXXXXXXXXXXXXXXXXXXXXXXXXXXXXXXXXXXXXXXXXXXXXXXXXXXXXXXXXXXXXXXXXXXXXXXXXXXXXXXX-XXXXXXX
