----------------------------------------------------------------------------------------------------------------------------------------------------------------------------------------------------------------------------------------------------------------------------------------
----------------------------------------------------------------------------------------------------------------------------------------------------------------------------------------------------------------------------------------------------------------------------------------
--------------------------------------------------------------------------------------------------------------------------------------------SSSSSSSSSSSSSSSSSSSSSSSSSSSS----------------------------------------------------------------------------------------------------------------
---------------X------------------------------------------------------------------------------------------------------------------------------------------------------------------------------------------------------------------------------------------------------------------------
----------------------------------------------------------------------------------------------------------------------------------------------------------------------------------------------------------------------------------------------------------------------------------------
---------------X--------------------------------------XX----------------------------------------------X--------------------------------XX----------------------------------------------------------------------------------------------------Q------------------------------------------
--------------XX-------------------------------------------------------------------------------------XX----------------------------------------------------------------------------------XXX--------------------------------------------------------------------------------------------
--------------XX-----------------------------------------------------------------------------------XXXX------------------------------------------------------------------------------------------------------------X--------------------------------------------------------------------
------------XXXX----------------------------------------------------------------------------------XXXXX-------------------------------------------------------------------------------------------E----------------X------------------SSS----------------------XXX---------------------X
-----------XXXX-----------------------------------------------------------------------------------XXXXX-----------------------XXX--------------S----SQS------------------X-----------------------QQS-----------------------------------------?S---------S?SS----------------------------
----------XXXXXX---------------------------------------------------------------------------------XXXXXX--------------------------------------------------------X---------X-------------------------------------XXXXX-----------------------------------------X--------------------------
---------XXXXXXX--------------------------------------------------------------------------------XXXXXXX-----------------------------------------------------<>-XX-------XXXX----------------------------------XXXXXX--------------------------------------------------------------------
-E------XXXXXXXX--------E--E-------------------------------------E----------------------------XXXXXXXXX-------------------------------------E-----E---------[]-X--------XXXX--------------------------------XXXXXXXX--------E--E-------E-E------------------XXX-------------------------
XXXXXXXXXXXXXXXXXXXXXXXXXXXXXXXXXXXXXXXXXXXXXXXXXXXXXXXXXXXXXXXXXXXXXXXXXXXXXXXXXXXXXXXXXX-XXXXXXXXXXXXX----XXXXXXXXXX--XXXXXX-----X-----XXXXXXXXXXXXXXXXXXXXXXXXXXXXXXXXXXXXXXXXXX--XXXXXXXXXXXXXXXXXXX--XXXXXXXXXXXXXXXXXXXXXXXXXXXXXXXXXXXXXXXXXXXXXXXXXXXXXXXXXXXXX---XXXXXXXXXXX---
