----------------------------------------------------------------------------------------------------------------------------------------------------------------------------------------------------------------------------------------------------------------------------------------
----------------------------------------------------------------------------------------------------------------------------------------------------------------------------------------------------------------------------------------------------------------------------------------
----------------------------------------------------------------------------------------------------------------------------------------------------------------------------------------------------SSSSSSSSSSSSSSSSSSSSSSSSSSSS--------------------------------------------------------
----------------------------------------------------------------------------------------------------------------------------------------------------------------------------------------------------------------------------------------------------------------------------------------
----------------------------------------------------------------------------------------------------------------------------------------------------------------------------------------------------------------------------------------------------------------------------------------
----------------XX----------------------------------------------------------------------------------------------Q------------------------------------------------------------------------------------SS-----S---------------------------------------------------------------------------
---------------XXX-------------------------------------------------------------------------------------------------XX-------------------------------------------------------------------------------------------------------------------------------------------------------------------
---------------XXX----------------------------------------------------------------------------------------------------------------------------------------------------------------------------------------------------------------------------------------------------------------------
--------------XXXX----------------------------------------------------------------------------------------------------------------------------------------------------------------------------------------------------------------------------------------------------------------------
--------Q-X--XXXXX-------------------------QQ--------------------------------S--S--Q----------------E----------EX------------XXXXXX---------SQQQ--------------XX----------------------XXXX----------SSSSS---SQS--------------------------------X----------------------------------------
----------X-EXXXXX---------------------------------------------------------------------------------<>---------<>X-----------XXX-------------------------------XX-------------------------------------------------------XX----------------------------------------E----------E-----------
-----------XXXXXXX------------------------------------E--XXX---------------------------------------[]---------[]-----------XXX--------------------------------XX----------------------------------------------------<>-XX--------------------X------------------<>---E-----<>-----------
EE-E-------XXXXXXX------------------------------------E---------E----E-------E-E--------E------E---[]---------[]----------XXXX-------E--E------------------XX-XX------------------------------------------E---------[]-XX------------------EEX----------E-------[]---E-----[]-----------
XXXXXXXXXXXXXXXXXXXXX--XXXXXXXXXXXXXXXXXXXXXX--------XXXXX---XXXXXXXXXXXXXXXXXXXXXXXXXXXXXXXXXXXXXXXXXXXXXXXXXXXXXXXXX---XXXXX----XXXXXXXXXXXXXXXXXXXXXXXXXXXXXXXXX-XXXXX---XX---XXXXX-------XXXXXXXXXXXXXXXXXXXXXXXXXXXXXXXXXXXXXXXXXX-XXXXXXXXXXXXXXXXXXXXXXXXXXXXXXXXXXXXXXXXXXXXXXXX
