----------------------------------------------------------------------------------------------------------------------------------------------------------------------------------------------------------------------------------------------------------------------------------------
----------------------------------------------------------------------------------------------------------------------------------------------------------------------------------------------------------------------------------------------------------------------------------------
-------------------------------------------------------------------------------------------------------------------------------------------------------------------------------------------------------------------SSSSSS---------------------------------------------------------------
----------------------------------------------------------------------------------------------------------------------------------------------------------------------------------------------------------------------------------------------------------------------------------------
----------------------------------------------------------------------------------------------------------------------------------------------------------------------------------------------------------------------------------------------------------------------------------------
----------------------------SSS--------------------S----------------------E--------------------------------XX--------------------------------XX------------------------------------------------XXXX-----------------------------------------------------------X-------------------------
------X------------------------------------------------------------------<>-------------------------------------------------------------------------------------------------------------------------------------------------------------------------------------------------------------
------------------------------------------------------------------------XXX-------------------------------------------------------------------------------------------------------------------------------------------------------------------------------------------------------------
-----------------------------------------------------------------------XXXX------------------------------------------------------------------------------------------------------------------------------------------S------------------------------------------------------------------
--------------XXXXXX--------SQQQ--------------XXX---------------------XXXXX----------------------XXX------------QQQ---------------X--------------------------------------------------XXXX-------------------Q------------------------E----------E----------E----------------------------
-----------------------------------E---------XXXX--------------------XXXXXX--------E-------------XXXX--------------------------XXXXX-------------------------------------------------XX------------------------------X--------------<>---------<>---------<>----------------------------
----------------------------------<>---------XXXX------------------XXXXXXXX-------<>-----------XXXXXX--------------------------XXXXX-----------------------------------------------XXXX---------------------------XXXX--------------[]---------[]---------[]------------X---------------
---------------------E-E----------[]-------XXXXXX-----------------XXXXXXXXX-----E-[]----------XXXXXX---------------------------XXXXX----------------------------------------------XXXX----------E---------E------XXXXX--------------[]---------[]---------[]----------XXX------------EE-
XXX-XXX-----XXX---XXXXXXXXXXXXXXXXXXXXXXX--X------------XXXXXXX---XXXXX--XXXXXXXX-XXXXXXXX--XXXXXX---XXX--------XXXXXXXXXXXXXX-X---------------XXXXXXXXXX-XXXX------XXXXXXXXXX---XXXXXX--XXXXXXXXXXXXXXXXXXXXXXXXXXXXXXX--XXXXXXXXXXXXXXXXXXXX-XXXXXXXXXXXXXXXXXXXXXX-XXXXXXXXX--XXXXXXX
