----------------------------------------------------------------------------------------------------------------------------------------------------------------------------------------------------------------------------------------------------------------------------------------
----------------------------------------------------------------------------------------------------------------------------------------------------------------------------------------------------------------------------------------------------------------------------------------
----------------------------------------------------------------------------------------------------------------------------------------------------------------------------------------------------------------------------------------------------------------------------------------
----------------------------------------------------------------------------------------------------------------------------------------------------------------------------------------------------------------------------------------------------------------------------------------
------------------------------------------------------------XX--------------------------------------------------------------------------------------------------------------------------------------------------------------------------------------------------------------------------
------------------------------------------------------------------------------SXXX--------------------XXX----S--------------------------------------------------------XX-------------------------------------------------------------------------SSS---------XXX------------------------
---------------------------------------------------------------------------------------------------------------------------------------------------------------------------------------X------------------------------------------------------------------------------------------------
--------------------------------------------------------------------------------------------------------------------------------------------------------------------------------------XX------------------------------------------------------------------------------------------------
---------------------------------------------------------------------------------------XX--------------------------------------------------------------------------------------------XXX------------------------------------------------------------------------------------------------
---------------XX-------------------------XXX-----------XQQ---------------EXXX-------------------X-----------------------------------------------------------------------------------XXX-------------------------X-XX-----------SQQXX-------------XX--<>-----------------------------SSS
---------------XX----------------------------------------------------XXXXXXXX--------------------------------------------------XXX------------------------------------------------XXXXXX------------------------XX------------------------------------[]--------------------------------
---------------XX--------------------------------------------------------------------------------------------------------------XXX-----------------------------------------------XXXXXXX------------------------XX--------------------------------X---[]--------------------------------
---------------X---------------------------------------------------------------------------------------------------------------XXXX---------------------------------------------XXXXXXXX--------E--------------XXX-------E--E-------------------------[]-----------EE--------------E----
XXXXXXXXXXXXXXXXXXXX---XXXXX---X----XXXXX---------------XX-------XXXX------XXX---XXXXXX----XXX------------------XXXXX--XXXXXXXXXXXXXXX--XXXXXXXXXXXXXXXXXXXXXXXXXXXXXXXXXXXXX-XXXXXXXXXXXXXXXXXXXXXXXXXXXXX-XXXXXXXXXXXXXXXXXXXXXXXXXXXX---XX--XXXXXXXXXXXXXXX--XXXXXXXXXXXXX----XXXXXXX
